page_id	title	month	month_edits	month_reverts	month_mutual_reverts	month_mutual_reverts_2	month_users	month_users_reg	month_reverting_users	month_mutual_reverting_users	tot_edits	tot_users	n_reverts	tot_edits_reg	tot_users_reg	n_reverts_reg
23475353	5G	201006	1	0	0	0	1	1	0	0	1	1	0	1	1	0
23475353	5G	201007	52	1	0	0	10	5	1	0	53	11	1	48	6	0
23475353	5G	201008	14	2	1	0	10	5	2	1	67	18	3	54	8	1
23475353	5G	201009	9	1	0	0	6	2	1	0	76	23	4	58	9	1
23475353	5G	201010	2	1	0	0	2	1	1	0	78	24	5	59	9	1
23475353	5G	201011	4	1	0	0	4	2	1	0	82	27	6	61	10	1
23475353	5G	201012	6	0	0	0	4	2	0	0	88	29	6	65	10	1
23475353	5G	201101	11	0	0	0	5	2	0	0	99	33	6	68	11	1
23475353	5G	201102	9	4	0	0	6	4	3	0	108	37	10	73	13	1
23475353	5G	201103	8	5	0	0	8	4	5	0	116	44	15	77	16	2
23475353	5G	201104	9	1	0	0	4	2	1	0	125	47	16	83	17	2
23475353	5G	201105	30	4	0	0	8	5	1	0	155	52	20	109	19	3
23475353	5G	201106	9	1	0	0	5	3	1	0	164	55	21	116	20	3
23475353	5G	201107	15	2	0	0	7	4	2	0	179	60	23	127	22	3
23475353	5G	201108	3	0	0	0	3	2	0	0	182	63	23	129	24	3
23475353	5G	201109	6	1	0	0	4	4	1	0	188	66	24	135	27	4
23475353	5G	201110	10	0	0	0	4	3	0	0	198	69	24	144	29	4
23475353	5G	201111	15	2	0	0	8	4	2	0	213	75	26	155	31	4
23475353	5G	201201	8	0	0	0	4	2	0	0	221	78	26	161	32	4
23475353	5G	201202	15	4	0	0	13	7	2	0	236	88	30	170	36	5
23475353	5G	201203	5	2	0	0	4	2	2	0	241	91	32	172	37	6
23475353	5G	201204	10	4	0	0	8	5	4	0	251	97	36	177	40	6
23475353	5G	201205	2	0	0	0	1	0	0	0	253	98	36	177	40	6
23475353	5G	201206	5	0	0	0	5	4	0	0	258	101	36	181	42	6
23475353	5G	201207	11	1	0	0	9	6	1	0	269	107	37	189	45	6
23475353	5G	201208	5	0	0	0	2	1	0	0	274	109	37	193	46	6
23475353	5G	201209	1	0	0	0	1	0	0	0	275	110	37	193	46	6
23475353	5G	201210	8	2	0	0	7	6	2	0	283	115	39	200	49	7
23475353	5G	201211	13	3	0	0	9	6	3	0	296	121	42	208	52	7
23475353	5G	201212	8	2	0	0	7	4	2	0	304	125	44	212	53	7
23475353	5G	201301	2	0	0	0	2	1	0	0	306	127	44	213	54	7
23475353	5G	201302	8	2	0	0	6	4	2	0	314	132	46	219	57	8
23475353	5G	201303	4	0	0	0	2	1	0	0	318	134	46	220	58	8
23475353	5G	201304	2	0	0	0	2	1	0	0	320	135	46	221	58	8
23475353	5G	201305	8	2	0	0	7	2	2	0	328	141	48	224	59	8
23475353	5G	201306	22	1	0	0	14	9	1	0	350	154	49	241	66	8
23475353	5G	201307	3	0	0	0	3	2	0	0	353	157	49	243	68	8
23475353	5G	201308	16	2	0	0	9	6	1	0	369	164	51	254	72	8
23475353	5G	201309	13	0	0	0	7	3	0	0	382	170	51	259	74	8
23475353	5G	201310	13	1	0	0	9	3	1	0	395	177	52	264	75	8
23475353	5G	201311	7	0	0	0	4	2	0	0	402	180	52	266	76	8
23475353	5G	201312	9	1	0	0	8	5	1	0	411	187	53	271	80	8
23475353	5G	201401	10	1	0	0	7	4	1	0	421	194	54	277	84	8
23475353	5G	201402	11	1	0	0	8	3	1	0	432	200	55	283	85	8
23475353	5G	201403	24	0	0	0	10	8	0	0	456	209	55	305	91	8
23475353	5G	201404	5	1	0	0	5	2	1	0	461	214	56	307	93	8
23475353	5G	201405	2	0	0	0	2	2	0	0	463	214	56	309	93	8
23475353	5G	201406	14	1	0	0	8	6	1	0	477	220	57	319	97	8
23475353	5G	201407	12	3	0	0	10	6	3	0	489	229	60	325	102	8
23475353	5G	201408	12	1	0	0	9	4	1	0	501	238	61	329	106	8
23475353	5G	201409	5	1	0	0	5	1	1	0	506	242	62	330	106	8
23475353	5G	201410	12	3	0	0	10	5	3	0	518	248	65	335	107	8
23475353	5G	201411	14	3	0	0	9	6	3	0	532	254	68	346	110	8
23475353	5G	201412	28	2	0	0	22	13	2	0	560	272	70	363	119	8
23475353	5G	201501	16	2	0	0	8	5	2	0	576	280	72	368	124	9
23475353	5G	201502	17	5	0	0	10	5	3	0	593	288	77	375	127	9
23475353	5G	201503	9	1	0	0	5	3	1	0	602	291	78	378	128	9
23475353	5G	201504	16	1	0	0	12	10	1	0	618	301	79	389	135	10
23475353	5G	201505	10	4	0	0	10	6	4	0	628	309	83	395	139	10
23475353	5G	201506	10	0	0	0	10	6	0	0	638	317	83	401	143	10
23475353	5G	201507	5	0	0	0	4	3	0	0	643	320	83	405	145	10
23475353	5G	201508	8	0	0	0	6	5	0	0	651	325	83	410	148	10
23475353	5G	201509	18	2	0	0	14	6	2	0	669	339	85	418	154	10
23475353	5G	201510	12	2	0	0	9	4	2	0	681	347	87	423	157	10
23475353	5G	201511	12	0	0	0	8	5	0	0	693	352	87	430	159	10
23475353	5G	201512	15	2	0	0	10	5	1	0	708	361	89	440	163	10
23475353	5G	201601	4	0	0	0	3	2	0	0	712	362	89	442	163	10
23475353	5G	201602	27	3	0	0	17	10	3	0	739	377	92	454	171	10
23475353	5G	201603	13	2	0	0	13	11	2	0	752	388	94	465	180	10
23475353	5G	201604	20	3	0	0	11	7	2	0	772	395	97	475	183	10
23475353	5G	201605	15	1	0	0	11	9	1	0	787	403	98	488	188	10
23475353	5G	201606	13	1	0	0	8	7	1	0	800	407	99	499	191	10
23475353	5G	201607	13	2	0	0	11	7	2	0	813	413	101	507	193	10
23475353	5G	201608	37	3	1	0	13	10	3	1	850	422	104	539	199	12
23475353	5G	201609	19	4	0	0	16	10	3	0	869	436	108	551	207	14
23475353	5G	201610	3	0	0	0	2	2	0	0	872	437	108	554	208	14
23475353	5G	201611	37	3	0	0	16	9	3	0	909	450	111	569	214	14
23475353	5G	201612	6	3	2	1	3	2	2	2	915	453	114	573	216	15
23475353	5G	201701	24	2	0	0	14	11	1	0	939	464	116	591	224	15
23475353	5G	201702	19	3	0	0	15	10	3	0	958	477	119	603	230	15
23475353	5G	201703	15	2	0	0	15	10	2	0	973	489	121	613	236	16
23475353	5G	201704	17	1	0	0	12	6	1	0	990	500	122	620	240	17
23475353	5G	201705	12	4	0	0	9	6	2	0	1002	509	126	629	246	19
23475353	5G	201706	24	4	0	0	16	11	3	0	1026	522	130	647	253	19
23475353	5G	201707	9	0	0	0	6	2	0	0	1035	527	130	649	254	19
23475353	5G	201708	9	0	0	0	8	4	0	0	1044	535	130	654	258	19
23475353	5G	201709	26	1	0	0	14	11	1	0	1070	548	131	671	268	20
23475353	5G	201710	19	2	0	0	10	6	2	0	1089	555	133	684	271	20
23475353	5G	201711	5	0	0	0	4	2	0	0	1094	559	133	687	273	20
23475353	5G	201712	22	2	0	0	14	11	1	0	1116	571	135	706	281	21
23475353	5G	201801	14	1	0	0	13	9	1	0	1130	582	136	715	287	22
23475353	5G	201802	15	1	0	0	15	10	1	0	1145	595	137	725	293	23
23475353	5G	201803	26	0	0	0	17	9	0	0	1171	610	137	742	299	23
23475353	5G	201804	43	4	0	0	30	21	4	0	1214	634	141	773	311	25
23475353	5G	201805	37	9	2	0	22	18	7	1	1251	652	150	806	323	32
23475353	5G	201806	66	3	0	0	21	16	2	0	1317	669	153	866	335	34
23475353	5G	201807	224	6	2	1	37	31	5	2	1541	697	159	1083	356	39
464639	Ad_hoc_network	200710	1	0	0	0	1	1	0	0	1	1	0	1	1	0
464639	Ad_hoc_network	200802	1	0	0	0	1	1	0	0	2	2	0	2	2	0
464639	Ad_hoc_network	200906	1	0	0	0	1	1	0	0	3	3	0	3	3	0
464639	Ad_hoc_network	200912	5	2	0	0	3	3	2	0	8	6	2	8	6	2
464639	Ad_hoc_network	201012	2	1	1	0	1	1	1	1	10	6	3	10	6	3
464639	Ad_hoc_network	201109	1	1	0	0	1	0	1	0	11	7	4	10	6	4
464639	Ad_hoc_network	201301	1	1	0	0	1	1	1	0	12	8	5	11	7	5
464639	Ad_hoc_network	201708	1	1	0	0	1	1	1	0	13	9	6	12	8	6
464639	Ad_hoc_network	201710	5	0	0	0	2	2	0	0	18	11	6	17	10	6
1260	Advanced_Encryption_Standard	200112	1	0	0	0	1	1	0	0	1	1	0	1	1	0
1260	Advanced_Encryption_Standard	200202	3	0	0	0	2	2	0	0	4	3	0	4	3	0
1260	Advanced_Encryption_Standard	200203	1	0	0	0	1	1	0	0	5	4	0	5	3	0
1260	Advanced_Encryption_Standard	200205	1	0	0	0	1	0	0	0	6	5	0	5	3	0
1260	Advanced_Encryption_Standard	200207	2	0	0	0	2	1	0	0	8	7	0	6	4	0
1260	Advanced_Encryption_Standard	200208	1	0	0	0	1	0	0	0	9	8	0	6	4	0
1260	Advanced_Encryption_Standard	200209	1	0	0	0	1	0	0	0	10	9	0	6	4	0
1260	Advanced_Encryption_Standard	200210	5	0	0	0	1	1	0	0	15	9	0	11	4	0
1260	Advanced_Encryption_Standard	200211	3	0	0	0	2	1	0	0	18	11	0	13	5	0
1260	Advanced_Encryption_Standard	200212	2	0	0	0	2	0	0	0	20	13	0	13	5	0
1260	Advanced_Encryption_Standard	200304	1	0	0	0	1	0	0	0	21	14	0	13	5	0
1260	Advanced_Encryption_Standard	200306	2	0	0	0	2	0	0	0	23	15	0	13	5	0
1260	Advanced_Encryption_Standard	200308	1	0	0	0	1	0	0	0	24	15	0	13	5	0
1260	Advanced_Encryption_Standard	200309	1	0	0	0	1	1	0	0	25	16	0	14	6	0
1260	Advanced_Encryption_Standard	200311	2	0	0	0	1	1	0	0	27	17	0	16	7	0
1260	Advanced_Encryption_Standard	200312	1	0	0	0	1	1	0	0	28	18	0	17	8	0
1260	Advanced_Encryption_Standard	200401	2	0	0	0	2	2	0	0	30	20	0	19	10	0
1260	Advanced_Encryption_Standard	200402	1	0	0	0	1	1	0	0	31	21	0	20	11	0
1260	Advanced_Encryption_Standard	200403	2	0	0	0	2	1	0	0	33	23	0	21	12	0
1260	Advanced_Encryption_Standard	200404	12	0	0	0	6	4	0	0	45	28	0	29	15	0
1260	Advanced_Encryption_Standard	200405	1	0	0	0	1	1	0	0	46	28	0	30	15	0
1260	Advanced_Encryption_Standard	200406	7	0	0	0	6	6	0	0	53	32	0	37	19	0
1260	Advanced_Encryption_Standard	200407	8	1	0	0	8	7	1	0	61	39	1	44	24	1
1260	Advanced_Encryption_Standard	200408	12	1	0	0	5	4	1	0	73	43	2	55	27	2
1260	Advanced_Encryption_Standard	200409	7	0	0	0	7	3	0	0	80	49	2	58	29	2
1260	Advanced_Encryption_Standard	200410	1	0	0	0	1	1	0	0	81	50	2	59	30	2
1260	Advanced_Encryption_Standard	200411	21	2	0	0	9	6	2	0	102	58	4	76	35	2
1260	Advanced_Encryption_Standard	200412	11	0	0	0	6	5	0	0	113	63	4	85	39	2
1260	Advanced_Encryption_Standard	200501	19	2	0	0	8	4	2	0	132	69	6	99	41	2
1260	Advanced_Encryption_Standard	200502	7	0	0	0	7	5	0	0	139	76	6	104	46	2
1260	Advanced_Encryption_Standard	200503	11	1	0	0	6	2	1	0	150	81	7	108	47	2
1260	Advanced_Encryption_Standard	200504	10	5	4	3	5	1	2	2	160	85	12	112	47	4
1260	Advanced_Encryption_Standard	200505	15	0	0	0	6	3	0	0	175	91	12	124	50	4
1260	Advanced_Encryption_Standard	200506	31	0	0	0	6	4	0	0	206	95	12	153	52	4
1260	Advanced_Encryption_Standard	200507	20	2	0	0	9	4	2	0	226	101	14	168	53	4
1260	Advanced_Encryption_Standard	200509	10	0	0	0	8	2	0	0	236	108	14	170	54	4
1260	Advanced_Encryption_Standard	200510	9	1	0	0	6	4	1	0	245	113	15	177	57	4
1260	Advanced_Encryption_Standard	200511	8	2	0	0	4	3	1	0	253	115	17	184	58	5
1260	Advanced_Encryption_Standard	200512	12	3	0	0	11	6	3	0	265	124	20	191	62	5
1260	Advanced_Encryption_Standard	200601	14	2	0	0	12	6	2	0	279	133	22	197	65	5
1260	Advanced_Encryption_Standard	200602	27	16	8	5	13	4	5	4	306	145	38	211	68	10
1260	Advanced_Encryption_Standard	200603	9	1	0	0	8	4	1	0	315	152	39	216	71	11
1260	Advanced_Encryption_Standard	200604	5	1	0	0	5	3	1	0	320	156	40	219	73	11
1260	Advanced_Encryption_Standard	200605	9	3	0	0	8	4	3	0	329	163	43	223	76	11
1260	Advanced_Encryption_Standard	200606	18	3	0	0	11	4	3	0	347	172	46	229	78	11
1260	Advanced_Encryption_Standard	200607	23	3	0	0	16	6	2	0	370	185	49	240	81	11
1260	Advanced_Encryption_Standard	200608	6	0	0	0	5	3	0	0	376	190	49	243	84	11
1260	Advanced_Encryption_Standard	200609	10	1	0	0	10	6	1	0	386	198	50	249	88	12
1260	Advanced_Encryption_Standard	200610	14	0	0	0	9	6	0	0	400	205	50	257	92	12
1260	Advanced_Encryption_Standard	200611	17	1	0	0	13	6	1	0	417	217	51	265	97	12
1260	Advanced_Encryption_Standard	200612	15	0	0	0	11	7	0	0	432	226	51	276	102	12
1260	Advanced_Encryption_Standard	200701	13	2	0	0	9	5	1	0	445	233	53	285	106	13
1260	Advanced_Encryption_Standard	200702	22	3	0	0	16	10	2	0	467	244	56	301	112	14
1260	Advanced_Encryption_Standard	200703	16	1	0	0	11	4	1	0	483	253	57	308	114	14
1260	Advanced_Encryption_Standard	200704	13	0	0	0	10	6	0	0	496	262	57	315	119	14
1260	Advanced_Encryption_Standard	200705	11	1	0	0	9	3	1	0	507	271	58	319	122	14
1260	Advanced_Encryption_Standard	200706	11	2	0	0	8	5	1	0	518	279	60	325	127	14
1260	Advanced_Encryption_Standard	200707	21	1	0	0	15	6	1	0	539	293	61	333	132	15
1260	Advanced_Encryption_Standard	200708	29	2	0	0	13	6	2	0	568	302	63	349	134	15
1260	Advanced_Encryption_Standard	200709	18	3	0	0	15	6	3	0	586	314	66	358	137	15
1260	Advanced_Encryption_Standard	200710	10	0	0	0	8	7	0	0	596	322	66	366	144	15
1260	Advanced_Encryption_Standard	200711	15	3	0	0	12	6	3	0	611	332	69	373	148	16
1260	Advanced_Encryption_Standard	200712	19	1	0	0	16	9	1	0	630	346	70	384	156	16
1260	Advanced_Encryption_Standard	200801	20	0	0	0	13	8	0	0	650	357	70	398	163	16
1260	Advanced_Encryption_Standard	200802	11	2	0	0	11	6	2	0	661	368	72	404	169	16
1260	Advanced_Encryption_Standard	200803	15	0	0	0	13	10	0	0	676	379	72	415	177	16
1260	Advanced_Encryption_Standard	200804	11	0	0	0	10	4	0	0	687	388	72	419	180	16
1260	Advanced_Encryption_Standard	200805	14	1	0	0	12	6	1	0	701	399	73	425	185	16
1260	Advanced_Encryption_Standard	200806	37	2	0	0	24	14	1	0	738	416	75	449	192	16
1260	Advanced_Encryption_Standard	200807	14	0	0	0	12	5	0	0	752	426	75	454	195	16
1260	Advanced_Encryption_Standard	200808	18	1	0	0	13	7	1	0	770	438	76	463	201	16
1260	Advanced_Encryption_Standard	200809	24	2	0	0	19	10	2	0	794	456	78	475	210	16
1260	Advanced_Encryption_Standard	200810	14	1	0	0	12	8	1	0	808	467	79	483	217	16
1260	Advanced_Encryption_Standard	200811	13	2	0	0	13	7	2	0	821	476	81	490	220	16
1260	Advanced_Encryption_Standard	200812	19	5	1	0	15	4	4	1	840	490	86	495	223	17
1260	Advanced_Encryption_Standard	200901	17	0	0	0	11	5	0	0	857	499	86	504	226	17
1260	Advanced_Encryption_Standard	200902	19	3	0	0	17	7	2	0	876	514	89	513	232	17
1260	Advanced_Encryption_Standard	200903	20	0	0	0	14	7	0	0	896	524	89	523	236	17
1260	Advanced_Encryption_Standard	200904	37	8	0	0	27	15	4	0	933	546	97	543	246	18
1260	Advanced_Encryption_Standard	200905	18	5	0	0	16	11	5	0	951	558	102	556	253	20
1260	Advanced_Encryption_Standard	200906	12	0	0	0	9	5	0	0	963	566	102	563	257	20
1260	Advanced_Encryption_Standard	200907	27	4	0	0	23	9	4	0	990	585	106	573	262	22
1260	Advanced_Encryption_Standard	200908	37	3	0	0	25	13	3	0	1027	605	109	590	270	22
1260	Advanced_Encryption_Standard	200909	12	3	0	0	11	4	2	0	1039	615	112	595	273	23
1260	Advanced_Encryption_Standard	200910	14	3	0	0	13	7	3	0	1053	623	115	603	276	24
1260	Advanced_Encryption_Standard	200911	8	1	0	0	8	5	1	0	1061	630	116	608	280	25
1260	Advanced_Encryption_Standard	200912	26	9	2	1	11	8	4	2	1087	637	125	628	284	31
1260	Advanced_Encryption_Standard	201001	7	0	0	0	6	5	0	0	1094	642	125	634	288	31
1260	Advanced_Encryption_Standard	201002	7	3	0	0	6	2	2	0	1101	647	128	637	289	31
1260	Advanced_Encryption_Standard	201003	22	0	0	0	14	6	0	0	1123	658	128	648	293	31
1260	Advanced_Encryption_Standard	201004	8	0	0	0	8	4	0	0	1131	665	128	652	296	31
1260	Advanced_Encryption_Standard	201005	13	3	0	0	13	7	3	0	1144	675	131	659	300	32
1260	Advanced_Encryption_Standard	201006	6	0	0	0	6	4	0	0	1150	680	131	663	303	32
1260	Advanced_Encryption_Standard	201007	6	1	0	0	5	4	1	0	1156	684	132	668	306	32
1260	Advanced_Encryption_Standard	201008	10	1	0	0	8	5	1	0	1166	689	133	674	308	32
1260	Advanced_Encryption_Standard	201009	8	1	0	0	7	4	1	0	1174	695	134	678	311	32
1260	Advanced_Encryption_Standard	201010	6	1	0	0	6	4	1	0	1180	699	135	682	313	32
1260	Advanced_Encryption_Standard	201011	8	1	0	0	5	1	1	0	1188	703	136	683	313	32
1260	Advanced_Encryption_Standard	201012	9	1	0	0	7	4	1	0	1197	710	137	688	317	32
1260	Advanced_Encryption_Standard	201101	11	1	0	0	9	5	1	0	1208	718	138	694	321	32
1260	Advanced_Encryption_Standard	201102	10	0	0	0	6	3	0	0	1218	722	138	699	322	32
1260	Advanced_Encryption_Standard	201103	14	2	0	0	11	6	2	0	1232	731	140	707	326	33
1260	Advanced_Encryption_Standard	201104	16	3	0	0	14	8	3	0	1248	742	143	715	332	34
1260	Advanced_Encryption_Standard	201105	10	3	0	0	8	4	2	0	1258	748	146	720	334	34
1260	Advanced_Encryption_Standard	201106	8	3	1	0	3	2	2	1	1266	749	149	726	334	36
1260	Advanced_Encryption_Standard	201107	4	0	0	0	3	3	0	0	1270	752	149	730	337	36
1260	Advanced_Encryption_Standard	201108	5	0	0	0	4	2	0	0	1275	756	149	733	339	36
1260	Advanced_Encryption_Standard	201109	16	0	0	0	8	4	0	0	1291	763	149	742	342	36
1260	Advanced_Encryption_Standard	201110	13	1	0	0	7	3	1	0	1304	768	150	745	343	36
1260	Advanced_Encryption_Standard	201111	12	3	0	0	9	4	3	0	1316	775	153	749	345	37
1260	Advanced_Encryption_Standard	201112	11	3	1	0	8	4	2	1	1327	781	156	756	347	38
1260	Advanced_Encryption_Standard	201201	11	1	0	0	9	7	1	0	1338	788	157	764	352	38
1260	Advanced_Encryption_Standard	201202	8	2	0	0	7	5	2	0	1346	794	159	770	356	39
1260	Advanced_Encryption_Standard	201203	2	0	0	0	2	1	0	0	1348	796	159	771	357	39
1260	Advanced_Encryption_Standard	201204	15	1	0	0	10	7	1	0	1363	802	160	783	360	39
1260	Advanced_Encryption_Standard	201205	17	2	0	0	11	4	2	0	1380	811	162	788	362	39
1260	Advanced_Encryption_Standard	201206	7	0	0	0	6	5	0	0	1387	817	162	794	367	39
1260	Advanced_Encryption_Standard	201207	9	2	0	0	8	3	2	0	1396	824	164	798	369	39
1260	Advanced_Encryption_Standard	201208	9	1	0	0	8	3	1	0	1405	831	165	801	371	39
1260	Advanced_Encryption_Standard	201209	9	1	0	0	7	4	1	0	1414	837	166	806	375	40
1260	Advanced_Encryption_Standard	201210	3	0	0	0	3	2	0	0	1417	839	166	808	376	40
1260	Advanced_Encryption_Standard	201211	8	2	0	0	7	5	2	0	1425	843	168	814	379	42
1260	Advanced_Encryption_Standard	201212	5	0	0	0	4	4	0	0	1430	847	168	819	383	42
1260	Advanced_Encryption_Standard	201301	10	1	0	0	9	7	1	0	1440	855	169	827	389	42
1260	Advanced_Encryption_Standard	201302	7	2	0	0	5	2	2	0	1447	858	171	829	389	42
1260	Advanced_Encryption_Standard	201303	17	2	0	0	15	9	2	0	1464	872	173	838	397	42
1260	Advanced_Encryption_Standard	201304	7	0	0	0	6	3	0	0	1471	878	173	841	400	42
1260	Advanced_Encryption_Standard	201305	5	1	0	0	4	2	1	0	1476	882	174	843	402	42
1260	Advanced_Encryption_Standard	201306	9	0	0	0	6	2	0	0	1485	888	174	845	403	42
1260	Advanced_Encryption_Standard	201307	8	1	0	0	5	2	1	0	1493	892	175	847	404	42
1260	Advanced_Encryption_Standard	201308	8	1	0	0	7	6	1	0	1501	898	176	854	409	43
1260	Advanced_Encryption_Standard	201309	4	0	0	0	4	2	0	0	1505	902	176	856	410	43
1260	Advanced_Encryption_Standard	201310	9	1	0	0	8	5	1	0	1514	908	177	862	412	44
1260	Advanced_Encryption_Standard	201311	11	0	0	0	5	1	0	0	1525	912	177	867	412	44
1260	Advanced_Encryption_Standard	201312	8	1	0	0	6	2	1	0	1533	917	178	869	413	44
1260	Advanced_Encryption_Standard	201401	3	1	0	0	3	1	1	0	1536	919	179	870	413	44
1260	Advanced_Encryption_Standard	201402	36	13	7	5	11	6	5	3	1572	927	192	889	418	50
1260	Advanced_Encryption_Standard	201403	5	2	0	0	5	3	2	0	1577	930	194	892	419	50
1260	Advanced_Encryption_Standard	201404	8	2	0	0	6	4	1	0	1585	934	196	897	422	50
1260	Advanced_Encryption_Standard	201405	5	2	0	0	4	3	2	0	1590	937	198	901	424	52
1260	Advanced_Encryption_Standard	201406	6	2	0	0	5	3	2	0	1596	940	200	904	426	52
1260	Advanced_Encryption_Standard	201407	4	0	0	0	4	1	0	0	1600	943	200	905	426	52
1260	Advanced_Encryption_Standard	201408	4	1	0	0	4	2	1	0	1604	946	201	907	427	52
1260	Advanced_Encryption_Standard	201409	8	0	0	0	2	1	0	0	1612	948	201	914	428	52
1260	Advanced_Encryption_Standard	201410	10	3	0	0	7	2	2	0	1622	953	204	917	428	52
1260	Advanced_Encryption_Standard	201411	24	11	2	1	9	6	6	2	1646	960	215	928	431	53
1260	Advanced_Encryption_Standard	201412	6	1	0	0	6	5	1	0	1652	964	216	933	434	53
1260	Advanced_Encryption_Standard	201501	8	0	0	0	4	3	0	0	1660	966	216	939	435	53
1260	Advanced_Encryption_Standard	201502	7	2	0	0	5	3	2	0	1667	970	218	942	437	53
1260	Advanced_Encryption_Standard	201503	1	0	0	0	1	0	0	0	1668	971	218	942	437	53
1260	Advanced_Encryption_Standard	201504	16	2	0	0	10	7	2	0	1684	978	220	952	440	54
1260	Advanced_Encryption_Standard	201505	4	0	0	0	2	0	0	0	1688	980	220	952	440	54
1260	Advanced_Encryption_Standard	201506	10	2	0	0	7	5	2	0	1698	986	222	958	444	56
1260	Advanced_Encryption_Standard	201507	3	1	0	0	3	2	1	0	1701	988	223	960	445	56
1260	Advanced_Encryption_Standard	201508	8	0	0	0	7	6	0	0	1709	994	223	967	449	56
1260	Advanced_Encryption_Standard	201509	1	0	0	0	1	1	0	0	1710	995	223	968	450	56
1260	Advanced_Encryption_Standard	201510	4	0	0	0	3	3	0	0	1714	998	223	972	452	56
1260	Advanced_Encryption_Standard	201511	5	0	0	0	3	3	0	0	1719	1000	223	977	454	56
1260	Advanced_Encryption_Standard	201512	7	1	0	0	7	5	1	0	1726	1005	224	982	457	56
1260	Advanced_Encryption_Standard	201601	1	0	0	0	1	1	0	0	1727	1005	224	983	457	56
1260	Advanced_Encryption_Standard	201602	1	0	0	0	1	1	0	0	1728	1006	224	984	458	56
1260	Advanced_Encryption_Standard	201603	6	2	0	0	6	4	2	0	1734	1008	226	988	458	56
1260	Advanced_Encryption_Standard	201605	6	3	0	0	5	3	3	0	1740	1011	229	991	459	57
1260	Advanced_Encryption_Standard	201606	7	1	0	0	5	2	1	0	1747	1015	230	994	460	57
1260	Advanced_Encryption_Standard	201607	7	1	0	0	5	4	1	0	1754	1019	231	998	462	58
1260	Advanced_Encryption_Standard	201608	5	0	0	0	4	2	0	0	1759	1021	231	1001	462	58
1260	Advanced_Encryption_Standard	201609	5	0	0	0	5	5	0	0	1764	1025	231	1006	466	58
1260	Advanced_Encryption_Standard	201610	1	0	0	0	1	1	0	0	1765	1026	231	1007	467	58
1260	Advanced_Encryption_Standard	201611	6	2	0	0	6	4	2	0	1771	1030	233	1011	469	58
1260	Advanced_Encryption_Standard	201612	8	3	0	0	8	5	3	0	1779	1035	236	1016	471	59
1260	Advanced_Encryption_Standard	201701	9	0	0	0	5	5	0	0	1788	1039	236	1025	475	59
1260	Advanced_Encryption_Standard	201702	9	0	0	0	9	8	0	0	1797	1045	236	1033	480	59
1260	Advanced_Encryption_Standard	201703	20	2	0	0	7	5	2	0	1817	1050	238	1051	483	60
1260	Advanced_Encryption_Standard	201704	15	2	0	0	13	9	2	0	1832	1059	240	1060	488	60
1260	Advanced_Encryption_Standard	201705	9	2	0	0	8	7	2	0	1841	1064	242	1068	492	61
1260	Advanced_Encryption_Standard	201706	7	0	0	0	6	4	0	0	1848	1068	242	1072	494	61
1260	Advanced_Encryption_Standard	201707	12	1	0	0	7	6	1	0	1860	1071	243	1082	495	62
1260	Advanced_Encryption_Standard	201708	6	0	0	0	5	4	0	0	1866	1073	243	1087	496	62
1260	Advanced_Encryption_Standard	201709	8	0	0	0	6	4	0	0	1874	1077	243	1092	498	62
1260	Advanced_Encryption_Standard	201710	8	0	0	0	4	4	0	0	1882	1080	243	1100	501	62
1260	Advanced_Encryption_Standard	201711	12	3	0	0	11	7	3	0	1894	1086	246	1107	503	62
1260	Advanced_Encryption_Standard	201712	4	1	0	0	3	2	1	0	1898	1088	247	1109	504	63
1260	Advanced_Encryption_Standard	201801	2	1	0	0	2	1	1	0	1900	1089	248	1110	504	63
1260	Advanced_Encryption_Standard	201802	2	0	0	0	2	1	0	0	1902	1091	248	1111	505	63
1260	Advanced_Encryption_Standard	201803	6	2	0	0	5	4	2	0	1908	1094	250	1115	507	63
1260	Advanced_Encryption_Standard	201804	3	0	0	0	3	3	0	0	1911	1096	250	1118	509	63
1260	Advanced_Encryption_Standard	201805	4	1	0	0	4	2	1	0	1915	1099	251	1120	510	63
1260	Advanced_Encryption_Standard	201806	3	0	0	0	1	0	0	0	1918	1100	251	1120	510	63
1260	Advanced_Encryption_Standard	201807	2	0	0	0	1	0	0	0	1920	1101	251	1120	510	63
775	Algorithm	200111	1	0	0	0	1	1	0	0	1	1	0	1	1	0
775	Algorithm	200112	7	1	0	0	5	5	1	0	8	6	1	8	5	1
775	Algorithm	200201	7	0	0	0	4	4	0	0	15	9	1	15	7	1
775	Algorithm	200202	4	0	0	0	4	4	0	0	19	13	1	19	8	1
775	Algorithm	200203	1	0	0	0	1	1	0	0	20	14	1	20	8	1
775	Algorithm	200204	2	1	0	0	2	1	1	0	22	16	2	21	9	1
775	Algorithm	200207	4	0	0	0	4	3	0	0	26	20	2	24	11	1
775	Algorithm	200208	1	0	0	0	1	1	0	0	27	21	2	25	12	1
775	Algorithm	200209	2	0	0	0	2	1	0	0	29	23	2	26	13	1
775	Algorithm	200210	3	0	0	0	2	2	0	0	32	25	2	29	15	1
775	Algorithm	200211	14	2	1	0	3	3	2	1	46	27	4	43	17	3
775	Algorithm	200212	1	0	0	0	1	1	0	0	47	28	4	44	18	3
775	Algorithm	200301	13	0	0	0	6	4	0	0	60	32	4	55	20	3
775	Algorithm	200302	5	1	0	0	5	3	1	0	65	36	5	58	22	3
775	Algorithm	200303	1	0	0	0	1	1	0	0	66	37	5	59	23	3
775	Algorithm	200305	2	0	0	0	1	0	0	0	68	38	5	59	23	3
775	Algorithm	200306	4	0	0	0	3	2	0	0	72	41	5	62	25	3
775	Algorithm	200307	7	0	0	0	3	2	0	0	79	43	5	67	26	3
775	Algorithm	200308	5	0	0	0	5	3	0	0	84	48	5	70	29	3
775	Algorithm	200309	9	0	0	0	3	2	0	0	93	51	5	78	31	3
775	Algorithm	200310	13	1	0	0	11	5	1	0	106	61	6	84	35	3
775	Algorithm	200311	8	1	0	0	6	2	1	0	114	67	7	87	37	3
775	Algorithm	200312	3	0	0	0	3	1	0	0	117	70	7	88	38	3
775	Algorithm	200401	5	0	0	0	5	2	0	0	122	75	7	90	40	3
775	Algorithm	200402	4	0	0	0	4	2	0	0	126	79	7	92	42	3
775	Algorithm	200403	5	0	0	0	3	2	0	0	131	82	7	96	44	3
775	Algorithm	200404	12	1	0	0	9	5	1	0	143	90	8	102	48	3
775	Algorithm	200405	5	0	0	0	5	4	0	0	148	95	8	106	52	3
775	Algorithm	200406	11	0	0	0	7	7	0	0	159	100	8	117	57	3
775	Algorithm	200407	9	0	0	0	7	5	0	0	168	106	8	122	61	3
775	Algorithm	200408	58	6	1	0	45	30	6	1	226	149	14	162	89	3
775	Algorithm	200409	8	0	0	0	5	5	0	0	234	154	14	170	94	3
775	Algorithm	200410	10	1	0	0	10	7	1	0	244	161	15	177	98	3
775	Algorithm	200411	13	0	0	0	5	3	0	0	257	164	15	184	99	3
775	Algorithm	200412	9	3	0	0	9	5	3	0	266	171	18	189	102	3
775	Algorithm	200501	14	3	0	0	11	7	3	0	280	181	21	197	108	3
775	Algorithm	200502	6	2	0	0	5	2	2	0	286	184	23	199	108	3
775	Algorithm	200503	8	2	0	0	8	6	2	0	294	189	25	205	111	3
775	Algorithm	200504	18	1	0	0	14	4	1	0	312	201	26	210	113	3
775	Algorithm	200505	13	3	0	0	12	8	3	0	325	210	29	218	118	3
775	Algorithm	200506	7	2	0	0	7	5	2	0	332	215	31	223	121	3
775	Algorithm	200507	19	2	0	0	16	10	2	0	351	228	33	235	128	3
775	Algorithm	200508	52	2	0	0	17	10	2	0	403	241	35	262	134	3
775	Algorithm	200509	24	2	0	0	14	7	1	0	427	251	37	276	138	3
775	Algorithm	200510	13	2	0	0	12	10	2	0	440	259	39	287	144	4
775	Algorithm	200511	15	4	0	0	15	9	4	0	455	272	43	296	151	4
775	Algorithm	200512	15	8	2	1	11	3	5	2	470	281	51	302	152	5
775	Algorithm	200601	89	10	0	0	35	21	9	0	559	306	61	369	165	7
775	Algorithm	200602	110	17	3	1	33	23	8	2	669	326	78	465	177	18
775	Algorithm	200603	44	7	0	0	20	12	4	0	713	339	85	496	182	18
775	Algorithm	200604	33	9	0	0	22	14	7	0	746	354	94	516	189	22
775	Algorithm	200605	33	2	0	0	21	9	2	0	779	373	96	530	196	22
775	Algorithm	200606	74	12	0	0	31	19	8	0	853	398	108	590	209	25
775	Algorithm	200607	41	11	0	0	24	15	8	0	894	417	119	618	219	29
775	Algorithm	200608	101	1	0	0	14	12	1	0	995	424	120	713	224	29
775	Algorithm	200609	38	3	0	0	14	6	3	0	1033	434	123	741	226	29
775	Algorithm	200610	38	6	0	0	19	11	6	0	1071	446	129	769	230	31
775	Algorithm	200611	48	6	0	0	30	15	5	0	1119	470	135	796	239	32
775	Algorithm	200612	32	7	0	0	22	16	7	0	1151	488	142	820	251	32
775	Algorithm	200701	22	5	0	0	19	13	5	0	1173	502	147	835	259	33
775	Algorithm	200702	36	7	0	0	25	14	6	0	1209	520	154	859	267	33
775	Algorithm	200703	41	12	0	0	25	15	7	0	1250	539	166	886	276	34
775	Algorithm	200704	14	5	0	0	13	9	5	0	1264	550	171	895	283	34
775	Algorithm	200705	15	2	0	0	12	5	2	0	1279	561	173	901	287	34
775	Algorithm	200706	37	13	0	0	26	14	10	0	1316	584	186	925	298	36
775	Algorithm	200707	52	13	0	0	25	11	6	0	1368	603	199	951	304	36
775	Algorithm	200708	43	9	0	0	22	10	7	0	1411	623	208	974	312	36
775	Algorithm	200709	33	7	0	0	19	10	7	0	1444	638	215	994	318	37
775	Algorithm	200710	28	7	0	0	16	9	4	0	1472	652	222	1013	325	37
775	Algorithm	200711	48	12	0	0	27	14	8	0	1520	676	234	1043	336	38
775	Algorithm	200712	40	15	0	0	26	16	12	0	1560	698	249	1065	348	41
775	Algorithm	200801	11	2	0	0	9	5	2	0	1571	703	251	1072	349	41
775	Algorithm	200802	38	15	0	0	26	13	11	0	1609	723	266	1092	356	43
775	Algorithm	200803	55	18	1	0	37	25	15	1	1664	752	284	1125	373	46
775	Algorithm	200804	39	10	0	0	28	11	7	0	1703	776	294	1144	380	47
775	Algorithm	200805	20	11	2	0	13	7	8	2	1723	785	305	1156	383	51
775	Algorithm	200806	23	8	0	0	21	11	8	0	1746	798	313	1167	387	52
775	Algorithm	200807	20	4	0	0	16	12	3	0	1766	808	317	1181	393	53
775	Algorithm	200808	32	7	0	0	29	19	7	0	1798	830	324	1202	405	57
775	Algorithm	200809	33	12	0	0	24	13	7	0	1831	847	336	1223	412	61
775	Algorithm	200810	31	8	0	0	24	12	6	0	1862	864	344	1240	417	63
775	Algorithm	200811	37	11	0	0	24	13	10	0	1899	880	355	1255	422	64
775	Algorithm	200812	24	8	0	0	19	10	8	0	1923	897	363	1265	430	64
775	Algorithm	200901	24	9	0	0	17	7	6	0	1947	910	372	1277	433	66
775	Algorithm	200902	28	8	0	0	18	12	5	0	1975	920	380	1293	437	67
775	Algorithm	200903	36	12	0	0	25	12	9	0	2011	939	392	1308	443	67
775	Algorithm	200904	31	8	0	0	25	13	8	0	2042	961	400	1323	453	67
775	Algorithm	200905	30	9	0	0	25	15	7	0	2072	983	409	1342	465	68
775	Algorithm	200906	22	3	0	0	15	11	2	0	2094	998	412	1360	476	68
775	Algorithm	200907	27	10	0	0	25	17	10	0	2121	1016	422	1378	486	71
775	Algorithm	200908	27	4	0	0	11	8	3	0	2148	1023	426	1393	490	73
775	Algorithm	200909	39	7	0	0	20	10	5	0	2187	1037	433	1419	494	74
775	Algorithm	200910	59	8	0	0	26	15	6	0	2246	1057	441	1464	503	74
775	Algorithm	200911	25	7	0	0	19	9	7	0	2271	1071	448	1473	508	74
775	Algorithm	200912	25	4	0	0	20	12	3	0	2296	1088	452	1489	517	74
775	Algorithm	201001	25	10	0	0	20	15	9	0	2321	1102	462	1508	526	80
775	Algorithm	201002	20	6	0	0	13	7	6	0	2341	1110	468	1518	528	80
775	Algorithm	201003	18	7	0	0	17	12	6	0	2359	1120	475	1531	533	81
775	Algorithm	201004	19	4	0	0	12	7	2	0	2378	1128	479	1542	536	81
775	Algorithm	201005	21	6	0	0	18	9	5	0	2399	1140	485	1553	539	81
775	Algorithm	201006	20	2	0	0	13	5	2	0	2419	1151	487	1560	542	81
775	Algorithm	201007	43	14	0	0	33	18	11	0	2462	1172	501	1584	548	83
775	Algorithm	201008	30	9	0	0	26	16	9	0	2492	1188	510	1600	554	83
775	Algorithm	201009	20	4	1	0	15	10	3	1	2512	1198	514	1614	559	85
775	Algorithm	201010	25	8	0	0	21	13	8	0	2537	1214	522	1628	567	85
775	Algorithm	201011	35	9	0	0	21	14	7	0	2572	1229	531	1648	575	87
775	Algorithm	201012	12	2	0	0	10	7	2	0	2584	1236	533	1657	579	88
775	Algorithm	201101	29	12	0	0	17	7	5	0	2613	1249	545	1671	582	88
775	Algorithm	201102	61	13	2	1	17	8	9	2	2674	1261	558	1721	585	92
775	Algorithm	201103	16	2	0	0	12	10	2	0	2690	1268	560	1734	590	93
775	Algorithm	201104	35	9	0	0	28	19	8	0	2725	1288	569	1759	601	96
775	Algorithm	201105	12	2	0	0	11	9	2	0	2737	1295	571	1769	606	96
775	Algorithm	201106	9	2	0	0	9	7	2	0	2746	1301	573	1776	610	97
775	Algorithm	201107	11	5	1	0	10	7	5	1	2757	1307	578	1783	613	98
775	Algorithm	201108	28	5	0	0	20	16	5	0	2785	1320	583	1807	622	100
775	Algorithm	201109	26	8	0	0	18	10	6	0	2811	1331	591	1824	625	101
775	Algorithm	201110	11	2	0	0	10	7	2	0	2822	1337	593	1832	628	101
775	Algorithm	201111	9	2	0	0	9	8	2	0	2831	1342	595	1840	632	102
775	Algorithm	201112	22	6	0	0	16	10	4	0	2853	1354	601	1856	638	103
775	Algorithm	201201	23	6	0	0	16	9	5	0	2876	1364	607	1867	641	105
775	Algorithm	201202	39	10	1	0	19	12	8	1	2915	1376	617	1885	646	109
775	Algorithm	201203	15	2	0	0	10	6	2	0	2930	1383	619	1893	649	110
775	Algorithm	201204	10	0	0	0	9	8	0	0	2940	1389	619	1902	654	110
775	Algorithm	201205	18	6	0	0	13	6	3	0	2958	1397	625	1911	655	111
775	Algorithm	201206	35	7	0	0	25	16	6	0	2993	1418	632	1933	667	112
775	Algorithm	201207	12	4	0	0	11	8	4	0	3005	1425	636	1941	672	114
775	Algorithm	201208	11	2	0	0	8	7	2	0	3016	1432	638	1951	678	115
775	Algorithm	201209	11	4	0	0	9	7	4	0	3027	1437	642	1958	680	116
775	Algorithm	201210	13	6	0	0	9	4	4	0	3040	1443	648	1964	681	116
775	Algorithm	201211	12	3	0	0	11	6	3	0	3052	1451	651	1971	684	116
775	Algorithm	201212	27	11	1	0	21	11	7	1	3079	1467	662	1987	690	118
775	Algorithm	201301	19	6	0	0	17	12	6	0	3098	1478	668	2000	696	119
775	Algorithm	201302	14	6	0	0	12	8	5	0	3112	1487	674	2009	701	120
775	Algorithm	201303	21	7	0	0	17	11	7	0	3133	1500	681	2020	708	122
775	Algorithm	201304	20	6	0	0	14	10	6	0	3153	1510	687	2030	714	122
775	Algorithm	201305	9	1	0	0	8	6	1	0	3162	1516	688	2037	718	122
775	Algorithm	201306	22	7	0	0	19	6	6	0	3184	1530	695	2045	720	122
775	Algorithm	201307	25	7	0	0	24	13	7	0	3209	1552	702	2058	731	122
775	Algorithm	201308	16	3	0	0	11	6	3	0	3225	1558	705	2065	732	122
775	Algorithm	201309	19	6	0	0	13	8	6	0	3244	1568	711	2076	737	124
775	Algorithm	201310	25	7	0	0	16	10	6	0	3269	1582	718	2090	745	125
775	Algorithm	201311	34	7	0	0	15	8	4	0	3303	1594	725	2105	750	126
775	Algorithm	201312	19	4	0	0	11	6	4	0	3322	1601	729	2111	752	127
775	Algorithm	201401	16	6	0	0	14	9	5	0	3338	1610	735	2121	756	128
775	Algorithm	201402	32	6	1	0	10	7	4	1	3370	1618	741	2147	761	129
775	Algorithm	201403	5	2	0	0	5	4	2	0	3375	1621	743	2151	763	130
775	Algorithm	201404	12	2	0	0	8	5	2	0	3387	1626	745	2158	765	130
775	Algorithm	201405	23	5	0	0	17	13	5	0	3410	1637	750	2175	772	132
775	Algorithm	201406	14	3	0	0	11	8	3	0	3424	1643	753	2185	775	134
775	Algorithm	201407	11	2	0	0	9	7	2	0	3435	1650	755	2194	780	134
775	Algorithm	201408	5	2	0	0	5	2	2	0	3440	1654	757	2196	781	134
775	Algorithm	201409	7	2	0	0	7	5	2	0	3447	1660	759	2201	785	134
775	Algorithm	201410	16	7	1	0	12	7	5	1	3463	1667	766	2212	787	137
775	Algorithm	201411	25	6	0	0	18	10	4	0	3488	1678	772	2228	790	137
775	Algorithm	201412	19	5	0	0	13	8	4	0	3507	1687	777	2239	794	138
775	Algorithm	201501	15	6	0	0	12	5	4	0	3522	1695	783	2246	795	138
775	Algorithm	201502	13	3	0	0	11	8	3	0	3535	1702	786	2255	798	138
775	Algorithm	201503	37	9	1	0	13	10	6	1	3572	1708	795	2280	801	140
775	Algorithm	201504	6	2	0	0	6	4	2	0	3578	1713	797	2284	804	140
775	Algorithm	201505	13	4	0	0	10	5	4	0	3591	1720	801	2289	806	141
775	Algorithm	201506	3	1	0	0	3	2	1	0	3594	1723	802	2291	808	141
775	Algorithm	201507	18	5	0	0	15	7	5	0	3612	1736	807	2298	813	141
775	Algorithm	201508	16	4	0	0	12	9	3	0	3628	1743	811	2310	817	141
775	Algorithm	201509	7	1	0	0	7	6	1	0	3635	1747	812	2316	820	141
775	Algorithm	201510	11	4	0	0	10	7	4	0	3646	1755	816	2323	825	142
775	Algorithm	201511	28	8	0	0	18	11	6	0	3674	1768	824	2339	831	145
775	Algorithm	201512	21	7	0	0	14	9	4	0	3695	1779	831	2355	836	148
775	Algorithm	201601	28	2	0	0	11	8	2	0	3723	1787	833	2367	841	148
775	Algorithm	201602	23	8	0	0	15	8	5	0	3746	1798	841	2379	843	149
775	Algorithm	201603	8	2	0	0	6	5	2	0	3754	1801	843	2386	845	150
775	Algorithm	201604	6	1	0	0	6	5	1	0	3760	1805	844	2391	848	150
775	Algorithm	201605	20	6	0	0	15	12	6	0	3780	1816	850	2406	855	154
775	Algorithm	201606	15	2	0	0	10	6	2	0	3795	1823	852	2415	857	154
775	Algorithm	201607	19	6	0	0	15	12	5	0	3814	1832	858	2431	862	157
775	Algorithm	201608	8	3	0	0	7	5	3	0	3822	1837	861	2437	864	158
775	Algorithm	201609	27	3	0	0	11	7	3	0	3849	1844	864	2460	867	158
775	Algorithm	201610	35	10	0	0	24	15	9	0	3884	1860	874	2478	872	162
775	Algorithm	201611	19	6	0	0	16	8	5	0	3903	1872	880	2489	875	162
775	Algorithm	201612	8	4	0	0	8	5	4	0	3911	1877	884	2494	876	163
775	Algorithm	201701	29	8	0	0	19	13	5	0	3940	1889	892	2514	880	166
775	Algorithm	201702	11	2	0	0	9	8	2	0	3951	1896	894	2523	883	168
775	Algorithm	201703	10	3	0	0	7	4	3	0	3961	1900	897	2527	884	168
775	Algorithm	201704	24	5	0	0	16	14	5	0	3985	1912	902	2549	893	171
775	Algorithm	201705	9	2	0	0	7	4	2	0	3994	1918	904	2555	895	171
775	Algorithm	201706	18	6	0	0	15	9	5	0	4012	1927	910	2566	898	171
775	Algorithm	201707	18	7	0	0	14	10	6	0	4030	1935	917	2577	901	173
775	Algorithm	201708	13	2	0	0	11	7	2	0	4043	1942	919	2585	904	173
775	Algorithm	201709	8	2	0	0	8	6	2	0	4051	1946	921	2591	906	173
775	Algorithm	201710	31	11	1	0	20	14	9	1	4082	1959	932	2608	913	176
775	Algorithm	201711	21	10	2	1	16	9	7	2	4103	1969	942	2621	916	179
775	Algorithm	201712	21	9	0	0	18	11	7	0	4124	1981	951	2635	921	181
775	Algorithm	201801	7	2	0	0	7	6	2	0	4131	1986	953	2641	924	182
775	Algorithm	201802	6	2	0	0	5	2	2	0	4137	1990	955	2643	925	182
775	Algorithm	201803	13	4	0	0	7	5	3	0	4150	1994	959	2652	926	183
775	Algorithm	201804	22	3	0	0	12	10	3	0	4172	2002	962	2672	931	185
775	Algorithm	201805	10	0	0	0	7	6	0	0	4182	2006	962	2681	934	185
775	Algorithm	201806	13	4	0	0	10	6	3	0	4195	2013	966	2690	936	185
775	Algorithm	201807	13	2	0	0	8	6	2	0	4208	2018	968	2701	939	185
90451	Amazon_(company)	200210	3	0	0	0	3	2	0	0	3	3	0	2	2	0
90451	Amazon_(company)	200211	5	0	0	0	2	1	0	0	8	5	0	6	3	0
90451	Amazon_(company)	200301	3	0	0	0	2	2	0	0	11	6	0	9	4	0
90451	Amazon_(company)	200302	1	0	0	0	1	0	0	0	12	7	0	9	4	0
90451	Amazon_(company)	200304	1	0	0	0	1	1	0	0	13	8	0	10	5	0
90451	Amazon_(company)	200305	3	0	0	0	2	1	0	0	16	10	0	12	6	0
90451	Amazon_(company)	200306	2	0	0	0	2	1	0	0	18	12	0	13	7	0
90451	Amazon_(company)	200307	2	0	0	0	2	2	0	0	20	14	0	15	9	0
90451	Amazon_(company)	200309	3	1	0	0	3	2	1	0	23	16	1	17	10	0
90451	Amazon_(company)	200310	2	0	0	0	2	2	0	0	25	16	1	19	10	0
90451	Amazon_(company)	200311	10	0	0	0	5	4	0	0	35	19	1	28	12	0
90451	Amazon_(company)	200312	5	0	0	0	4	4	0	0	40	20	1	33	13	0
90451	Amazon_(company)	200401	6	0	0	0	5	5	0	0	46	24	1	39	17	0
90451	Amazon_(company)	200402	7	0	0	0	7	5	0	0	53	29	1	44	20	0
90451	Amazon_(company)	200403	8	0	0	0	6	5	0	0	61	33	1	50	23	0
90451	Amazon_(company)	200404	3	0	0	0	3	1	0	0	64	36	1	51	24	0
90451	Amazon_(company)	200405	7	1	0	0	6	3	1	0	71	40	2	55	25	0
90451	Amazon_(company)	200406	5	0	0	0	5	5	0	0	76	45	2	60	30	0
90451	Amazon_(company)	200407	8	0	0	0	3	3	0	0	84	47	2	68	32	0
90451	Amazon_(company)	200408	9	0	0	0	9	8	0	0	93	54	2	76	38	0
90451	Amazon_(company)	200409	12	2	0	0	8	5	2	0	105	60	4	84	41	0
90451	Amazon_(company)	200410	17	0	0	0	8	4	0	0	122	66	4	90	43	0
90451	Amazon_(company)	200411	5	0	0	0	4	4	0	0	127	69	4	95	46	0
90451	Amazon_(company)	200412	3	0	0	0	3	3	0	0	130	71	4	98	48	0
90451	Amazon_(company)	200501	19	1	0	0	12	7	1	0	149	80	5	112	53	0
90451	Amazon_(company)	200502	18	1	0	0	11	6	1	0	167	90	6	124	58	0
90451	Amazon_(company)	200503	5	1	0	0	5	2	1	0	172	94	7	126	59	0
90451	Amazon_(company)	200504	12	2	0	0	11	6	2	0	184	103	9	133	63	0
90451	Amazon_(company)	200505	20	1	0	0	14	9	1	0	204	116	10	146	72	0
90451	Amazon_(company)	200506	4	0	0	0	4	4	0	0	208	120	10	150	76	0
90451	Amazon_(company)	200507	2	0	0	0	2	2	0	0	210	122	10	152	78	0
90451	Amazon_(company)	200508	13	0	0	0	12	7	0	0	223	133	10	160	85	0
90451	Amazon_(company)	200509	2	0	0	0	2	2	0	0	225	135	10	162	87	0
90451	Amazon_(company)	200510	19	3	0	0	14	7	2	0	244	146	13	171	92	0
90451	Amazon_(company)	200511	15	1	0	0	14	9	1	0	259	159	14	180	100	0
90451	Amazon_(company)	200512	15	0	0	0	11	6	0	0	274	169	14	188	105	0
90451	Amazon_(company)	200601	42	2	0	0	29	14	2	0	316	196	16	209	117	0
90451	Amazon_(company)	200602	19	3	0	0	15	8	2	0	335	210	19	220	124	0
90451	Amazon_(company)	200603	37	2	0	0	26	13	2	0	372	233	21	237	135	0
90451	Amazon_(company)	200604	25	2	0	0	21	15	2	0	397	252	23	255	148	1
90451	Amazon_(company)	200605	27	1	0	0	17	10	1	0	424	269	24	272	158	1
90451	Amazon_(company)	200606	74	14	0	0	37	21	8	0	498	301	38	313	175	6
90451	Amazon_(company)	200607	28	2	0	0	23	12	2	0	526	320	40	327	184	6
90451	Amazon_(company)	200608	38	4	0	0	28	15	4	0	564	346	44	347	197	6
90451	Amazon_(company)	200609	47	4	0	0	39	21	3	0	611	380	48	374	215	7
90451	Amazon_(company)	200610	43	8	1	0	26	13	5	1	654	404	56	399	227	8
90451	Amazon_(company)	200611	46	11	1	0	30	11	7	1	700	429	67	416	234	11
90451	Amazon_(company)	200612	57	7	0	0	43	19	5	0	757	469	74	443	251	12
90451	Amazon_(company)	200701	51	1	0	0	35	21	1	0	808	500	75	475	268	12
90451	Amazon_(company)	200702	69	16	1	0	48	29	12	1	877	541	91	513	291	15
90451	Amazon_(company)	200703	62	15	3	1	45	22	10	2	939	580	106	541	307	19
90451	Amazon_(company)	200704	49	8	1	0	33	19	6	1	988	607	114	567	320	21
90451	Amazon_(company)	200705	93	11	0	0	43	21	9	0	1081	646	125	626	337	26
90451	Amazon_(company)	200706	54	11	1	0	32	17	6	1	1135	673	136	658	349	29
90451	Amazon_(company)	200707	46	8	0	0	32	18	7	0	1181	698	144	686	360	30
90451	Amazon_(company)	200708	59	7	0	0	37	18	7	0	1240	732	151	717	376	32
90451	Amazon_(company)	200709	62	5	0	0	31	18	3	0	1302	759	156	755	390	33
90451	Amazon_(company)	200710	48	5	0	0	29	19	3	0	1350	781	161	793	402	34
90451	Amazon_(company)	200711	78	11	0	0	46	23	9	0	1428	821	172	831	421	37
90451	Amazon_(company)	200712	82	9	0	0	41	25	5	0	1510	855	181	897	439	39
90451	Amazon_(company)	200801	56	10	0	0	38	23	8	0	1566	885	191	931	455	40
90451	Amazon_(company)	200802	58	10	0	0	38	26	7	0	1624	914	201	973	472	42
90451	Amazon_(company)	200803	65	7	0	0	38	23	6	0	1689	944	208	1009	489	42
90451	Amazon_(company)	200804	59	15	0	0	42	22	10	0	1748	977	223	1045	503	46
90451	Amazon_(company)	200805	68	13	1	0	42	21	9	1	1816	1011	236	1088	518	52
90451	Amazon_(company)	200806	36	5	0	0	29	17	4	0	1852	1032	241	1107	530	52
90451	Amazon_(company)	200807	66	13	1	0	50	26	12	1	1918	1072	254	1141	548	57
90451	Amazon_(company)	200808	23	7	0	0	21	13	7	0	1941	1091	261	1155	559	57
90451	Amazon_(company)	200809	56	10	0	0	36	23	10	0	1997	1119	271	1189	575	62
90451	Amazon_(company)	200810	61	12	0	0	38	18	10	0	2058	1149	283	1221	585	62
90451	Amazon_(company)	200811	74	22	0	0	45	30	12	0	2132	1184	305	1269	605	64
90451	Amazon_(company)	200812	78	21	2	1	44	24	14	2	2210	1220	326	1315	622	66
90451	Amazon_(company)	200901	66	17	0	0	41	22	11	0	2276	1253	343	1351	636	68
90451	Amazon_(company)	200902	49	11	2	0	30	18	11	2	2325	1277	354	1384	648	74
90451	Amazon_(company)	200903	36	10	0	0	25	9	6	0	2361	1298	364	1400	653	76
90451	Amazon_(company)	200904	29	5	0	0	22	11	5	0	2390	1319	369	1417	663	76
90451	Amazon_(company)	200905	98	22	2	1	54	31	13	2	2488	1365	391	1485	687	83
90451	Amazon_(company)	200906	21	7	0	0	16	7	4	0	2509	1376	398	1495	691	84
90451	Amazon_(company)	200907	40	7	0	0	30	17	5	0	2549	1398	405	1516	700	85
90451	Amazon_(company)	200908	41	6	0	0	31	18	6	0	2590	1425	411	1538	714	88
90451	Amazon_(company)	200909	26	5	0	0	20	12	4	0	2616	1439	416	1553	720	88
90451	Amazon_(company)	200910	27	6	1	0	21	14	6	1	2643	1454	422	1573	728	91
90451	Amazon_(company)	200911	36	12	0	0	25	18	10	0	2679	1473	434	1596	740	93
90451	Amazon_(company)	200912	24	2	0	0	16	6	2	0	2703	1487	436	1607	744	93
90451	Amazon_(company)	201001	33	1	0	0	18	11	1	0	2736	1502	437	1633	753	93
90451	Amazon_(company)	201002	45	8	0	0	36	18	7	0	2781	1531	445	1657	764	96
90451	Amazon_(company)	201003	46	11	1	0	30	20	9	1	2827	1555	456	1685	779	102
90451	Amazon_(company)	201004	44	10	0	0	37	26	9	0	2871	1582	466	1712	796	104
90451	Amazon_(company)	201005	64	10	0	0	41	27	10	0	2935	1616	476	1751	817	108
90451	Amazon_(company)	201006	30	5	0	0	20	12	5	0	2965	1634	481	1767	827	109
90451	Amazon_(company)	201007	77	3	0	0	25	10	2	0	3042	1657	484	1822	836	109
90451	Amazon_(company)	201008	106	52	21	10	46	28	24	8	3148	1695	536	1882	858	131
90451	Amazon_(company)	201009	29	2	0	0	24	16	2	0	3177	1713	538	1901	868	132
90451	Amazon_(company)	201010	24	2	0	0	21	13	2	0	3201	1732	540	1917	879	132
90451	Amazon_(company)	201011	32	4	0	0	26	17	3	0	3233	1753	544	1939	892	132
90451	Amazon_(company)	201012	40	4	0	0	32	14	4	0	3273	1780	548	1959	903	133
90451	Amazon_(company)	201101	73	19	0	0	48	23	15	0	3346	1821	567	1994	919	138
90451	Amazon_(company)	201102	72	13	0	0	44	23	11	0	3418	1856	580	2032	934	140
90451	Amazon_(company)	201103	73	6	0	0	44	24	5	0	3491	1892	586	2080	950	141
90451	Amazon_(company)	201104	59	5	0	0	33	22	4	0	3550	1916	591	2124	963	142
90451	Amazon_(company)	201105	59	8	0	0	37	21	6	0	3609	1943	599	2152	975	146
90451	Amazon_(company)	201106	56	8	0	0	32	17	5	0	3665	1965	607	2185	982	148
90451	Amazon_(company)	201107	62	7	0	0	35	19	7	0	3727	1993	614	2228	994	152
90451	Amazon_(company)	201108	58	4	0	0	35	25	3	0	3785	2021	618	2272	1012	155
90451	Amazon_(company)	201109	65	14	1	0	42	23	10	1	3850	2056	632	2314	1028	159
90451	Amazon_(company)	201110	91	12	1	0	48	30	11	1	3941	2090	644	2378	1045	162
90451	Amazon_(company)	201111	55	6	0	0	37	16	6	0	3996	2116	650	2405	1051	164
90451	Amazon_(company)	201112	54	4	0	0	37	20	4	0	4050	2144	654	2437	1064	165
90451	Amazon_(company)	201201	62	7	0	0	42	21	6	0	4112	2172	661	2470	1073	166
90451	Amazon_(company)	201202	59	6	0	0	41	24	5	0	4171	2204	667	2506	1090	168
90451	Amazon_(company)	201203	76	13	0	0	45	25	9	0	4247	2241	680	2552	1107	170
90451	Amazon_(company)	201204	77	6	0	0	36	21	5	0	4324	2269	686	2611	1120	173
90451	Amazon_(company)	201205	51	3	0	0	29	18	3	0	4375	2287	689	2649	1128	174
90451	Amazon_(company)	201206	46	9	0	0	35	21	7	0	4421	2311	698	2680	1139	177
90451	Amazon_(company)	201207	46	10	0	0	36	23	7	0	4467	2337	708	2711	1152	181
90451	Amazon_(company)	201208	49	7	0	0	36	25	7	0	4516	2364	715	2744	1168	184
90451	Amazon_(company)	201209	30	8	0	0	26	12	4	0	4546	2383	723	2760	1174	185
90451	Amazon_(company)	201210	41	4	0	0	27	15	4	0	4587	2402	727	2785	1182	188
90451	Amazon_(company)	201211	43	4	0	0	30	12	4	0	4630	2425	731	2805	1187	188
90451	Amazon_(company)	201212	63	14	0	0	40	21	7	0	4693	2460	745	2843	1203	190
90451	Amazon_(company)	201301	53	7	0	0	47	21	7	0	4746	2502	752	2866	1219	190
90451	Amazon_(company)	201302	72	8	0	0	47	32	8	0	4818	2537	760	2920	1239	194
90451	Amazon_(company)	201303	81	7	0	0	48	32	7	0	4899	2572	767	2979	1259	196
90451	Amazon_(company)	201304	65	19	1	0	41	21	12	1	4964	2603	786	3016	1269	200
90451	Amazon_(company)	201305	45	12	1	0	28	19	10	1	5009	2622	798	3044	1280	206
90451	Amazon_(company)	201306	47	10	1	0	38	27	8	1	5056	2652	808	3077	1300	209
90451	Amazon_(company)	201307	38	8	0	0	35	16	8	0	5094	2679	816	3093	1310	211
90451	Amazon_(company)	201308	38	10	0	0	33	19	8	0	5132	2702	826	3114	1321	212
90451	Amazon_(company)	201309	83	14	0	0	53	30	12	0	5215	2742	840	3170	1338	217
90451	Amazon_(company)	201310	44	8	0	0	35	23	8	0	5259	2763	848	3202	1348	217
90451	Amazon_(company)	201311	42	8	0	0	31	16	7	0	5301	2783	856	3224	1354	217
90451	Amazon_(company)	201312	52	9	1	0	39	19	7	1	5353	2810	865	3252	1362	218
90451	Amazon_(company)	201401	69	11	0	0	52	35	9	0	5422	2850	876	3300	1385	222
90451	Amazon_(company)	201402	69	20	0	0	52	29	14	0	5491	2890	896	3338	1401	229
90451	Amazon_(company)	201403	96	19	1	0	46	34	15	1	5587	2921	915	3410	1420	238
90451	Amazon_(company)	201404	48	15	1	0	40	24	14	1	5635	2945	930	3440	1429	241
90451	Amazon_(company)	201405	81	15	0	0	54	32	8	0	5716	2985	945	3495	1448	244
90451	Amazon_(company)	201406	63	14	0	0	44	32	9	0	5779	3017	959	3543	1468	250
90451	Amazon_(company)	201407	56	15	2	1	40	24	11	2	5835	3047	974	3578	1482	257
90451	Amazon_(company)	201408	75	18	3	1	43	25	10	2	5910	3082	992	3620	1499	263
90451	Amazon_(company)	201409	44	11	2	1	35	24	8	2	5954	3110	1003	3652	1516	269
90451	Amazon_(company)	201410	36	7	0	0	29	18	5	0	5990	3131	1010	3675	1527	270
90451	Amazon_(company)	201411	51	8	0	0	45	30	7	0	6041	3165	1018	3710	1547	274
90451	Amazon_(company)	201412	65	15	1	0	41	23	11	1	6106	3195	1033	3751	1560	280
90451	Amazon_(company)	201501	61	11	0	0	41	30	7	0	6167	3222	1044	3799	1575	289
90451	Amazon_(company)	201502	38	9	0	0	23	18	8	0	6205	3236	1053	3826	1582	292
90451	Amazon_(company)	201503	63	14	0	0	41	25	11	0	6268	3266	1067	3861	1595	297
90451	Amazon_(company)	201504	61	15	3	1	31	19	10	3	6329	3288	1082	3906	1605	304
90451	Amazon_(company)	201505	68	16	1	0	46	27	10	1	6397	3321	1098	3952	1618	310
90451	Amazon_(company)	201506	59	19	1	0	42	22	13	1	6456	3351	1117	3989	1628	313
90451	Amazon_(company)	201507	46	8	1	0	35	25	7	1	6502	3377	1125	4020	1644	315
90451	Amazon_(company)	201508	52	10	0	0	37	22	7	0	6554	3404	1135	4051	1653	320
90451	Amazon_(company)	201509	55	7	0	0	45	29	6	0	6609	3436	1142	4086	1667	324
90451	Amazon_(company)	201510	61	13	1	0	37	22	11	1	6670	3463	1155	4122	1678	328
90451	Amazon_(company)	201511	61	19	0	0	44	28	13	0	6731	3495	1174	4162	1692	334
90451	Amazon_(company)	201512	46	14	2	1	32	22	8	2	6777	3518	1188	4196	1704	340
90451	Amazon_(company)	201601	22	0	0	0	11	11	0	0	6799	3526	1188	4218	1712	340
90451	Amazon_(company)	201602	31	0	0	0	18	18	0	0	6830	3535	1188	4249	1721	340
90451	Amazon_(company)	201603	41	4	0	0	26	20	3	0	6871	3556	1192	4282	1736	340
90451	Amazon_(company)	201604	50	9	0	0	36	17	5	0	6921	3580	1201	4310	1741	342
90451	Amazon_(company)	201605	49	17	1	0	37	21	14	1	6970	3609	1218	4338	1754	345
90451	Amazon_(company)	201606	36	2	0	0	22	13	2	0	7006	3626	1220	4359	1762	345
90451	Amazon_(company)	201607	49	9	0	0	38	27	8	0	7055	3654	1229	4395	1776	348
90451	Amazon_(company)	201608	71	11	0	0	49	35	9	0	7126	3687	1240	4449	1795	353
90451	Amazon_(company)	201609	58	8	0	0	41	25	7	0	7184	3720	1248	4491	1810	357
90451	Amazon_(company)	201610	71	20	0	0	41	29	12	0	7255	3752	1268	4544	1828	369
90451	Amazon_(company)	201611	47	10	0	0	32	21	8	0	7302	3774	1278	4575	1839	373
90451	Amazon_(company)	201612	78	25	0	0	43	31	16	0	7380	3803	1303	4621	1853	377
90451	Amazon_(company)	201701	18	2	0	0	13	13	2	0	7398	3810	1305	4639	1860	379
90451	Amazon_(company)	201702	23	1	0	0	16	16	1	0	7421	3819	1306	4662	1869	380
90451	Amazon_(company)	201703	18	2	0	0	9	9	1	0	7439	3823	1308	4680	1873	382
90451	Amazon_(company)	201704	25	1	0	0	11	11	1	0	7464	3827	1309	4705	1877	383
90451	Amazon_(company)	201705	15	1	0	0	12	12	1	0	7479	3834	1310	4720	1884	384
90451	Amazon_(company)	201706	35	4	0	0	20	20	4	0	7514	3846	1314	4755	1896	388
90451	Amazon_(company)	201707	66	14	0	0	52	41	12	0	7580	3881	1328	4809	1916	397
90451	Amazon_(company)	201708	88	18	3	1	47	36	15	2	7668	3917	1346	4883	1938	405
90451	Amazon_(company)	201709	83	15	1	0	54	38	11	1	7751	3953	1361	4937	1956	409
90451	Amazon_(company)	201710	52	15	0	0	30	19	8	0	7803	3976	1376	4974	1965	411
90451	Amazon_(company)	201711	35	9	5	3	15	15	3	3	7838	3985	1385	5009	1974	420
90451	Amazon_(company)	201712	28	2	0	0	16	16	1	0	7866	3990	1387	5037	1979	422
90451	Amazon_(company)	201801	19	1	0	0	14	14	1	0	7885	4000	1388	5056	1989	423
90451	Amazon_(company)	201802	29	5	2	1	13	13	3	2	7914	4005	1393	5085	1994	428
90451	Amazon_(company)	201803	37	4	1	1	18	18	1	1	7951	4017	1397	5122	2006	432
90451	Amazon_(company)	201804	18	2	0	0	12	12	2	0	7969	4023	1399	5140	2012	434
90451	Amazon_(company)	201805	37	5	0	0	22	22	4	0	8006	4036	1404	5177	2025	439
90451	Amazon_(company)	201806	9	0	0	0	7	7	0	0	8015	4042	1404	5186	2031	439
90451	Amazon_(company)	201807	26	2	0	0	12	12	1	0	8041	4051	1406	5212	2040	441
856	Apple_Inc.	200202	2	0	0	0	2	2	0	0	2	2	0	2	1	0
856	Apple_Inc.	200203	4	0	0	0	4	2	0	0	6	6	0	4	2	0
856	Apple_Inc.	200205	4	0	0	0	4	0	0	0	10	10	0	4	2	0
856	Apple_Inc.	200206	3	0	0	0	1	1	0	0	13	11	0	7	3	0
856	Apple_Inc.	200207	10	0	0	0	4	3	0	0	23	15	0	11	6	0
856	Apple_Inc.	200208	2	0	0	0	2	1	0	0	25	16	0	12	6	0
856	Apple_Inc.	200209	2	0	0	0	2	1	0	0	27	18	0	13	7	0
856	Apple_Inc.	200210	3	0	0	0	3	2	0	0	30	21	0	15	9	0
856	Apple_Inc.	200212	5	0	0	0	4	4	0	0	35	25	0	20	13	0
856	Apple_Inc.	200301	1	0	0	0	1	0	0	0	36	26	0	20	13	0
856	Apple_Inc.	200302	1	0	0	0	1	1	0	0	37	27	0	21	14	0
856	Apple_Inc.	200303	3	0	0	0	3	3	0	0	40	30	0	24	17	0
856	Apple_Inc.	200304	3	0	0	0	3	2	0	0	43	33	0	26	19	0
856	Apple_Inc.	200305	4	1	0	0	4	2	1	0	47	37	1	28	21	1
856	Apple_Inc.	200306	5	0	0	0	2	2	0	0	52	39	1	33	23	1
856	Apple_Inc.	200307	4	0	0	0	4	2	0	0	56	43	1	35	25	1
856	Apple_Inc.	200308	5	0	0	0	2	1	0	0	61	45	1	36	26	1
856	Apple_Inc.	200309	27	0	0	0	13	9	0	0	88	56	1	52	33	1
856	Apple_Inc.	200310	5	0	0	0	4	4	0	0	93	57	1	57	34	1
856	Apple_Inc.	200311	13	0	0	0	6	3	0	0	106	62	1	67	36	1
856	Apple_Inc.	200312	10	0	0	0	9	7	0	0	116	68	1	74	40	1
856	Apple_Inc.	200401	14	1	0	0	9	6	1	0	130	76	2	85	45	1
856	Apple_Inc.	200402	20	1	0	0	12	6	1	0	150	86	3	97	49	1
856	Apple_Inc.	200403	11	0	0	0	9	6	0	0	161	94	3	105	54	1
856	Apple_Inc.	200404	28	1	0	0	24	16	1	0	189	114	4	124	66	1
856	Apple_Inc.	200405	10	0	0	0	10	6	0	0	199	121	4	130	69	1
856	Apple_Inc.	200406	12	0	0	0	11	9	0	0	211	128	4	140	74	1
856	Apple_Inc.	200407	26	1	0	0	17	10	1	0	237	144	5	153	83	1
856	Apple_Inc.	200408	22	0	0	0	19	8	0	0	259	161	5	162	89	1
856	Apple_Inc.	200409	58	4	0	0	24	14	4	0	317	180	9	198	99	1
856	Apple_Inc.	200410	32	1	0	0	22	14	1	0	349	197	10	218	108	1
856	Apple_Inc.	200411	33	1	0	0	22	14	1	0	382	214	11	238	118	1
856	Apple_Inc.	200412	68	5	0	0	32	15	2	0	450	241	16	287	128	1
856	Apple_Inc.	200501	97	9	0	0	44	24	6	0	547	278	25	337	146	2
856	Apple_Inc.	200502	66	2	0	0	47	25	2	0	613	319	27	376	165	2
856	Apple_Inc.	200503	45	3	0	0	32	16	2	0	658	347	30	399	177	2
856	Apple_Inc.	200504	46	0	0	0	34	15	0	0	704	374	30	420	187	2
856	Apple_Inc.	200505	83	3	0	0	51	33	2	0	787	417	33	482	212	2
856	Apple_Inc.	200506	67	1	0	0	37	19	1	0	854	450	34	527	227	2
856	Apple_Inc.	200507	141	11	0	0	89	48	7	0	995	528	45	604	264	2
856	Apple_Inc.	200508	71	6	0	0	42	24	4	0	1066	563	51	648	281	4
856	Apple_Inc.	200509	84	9	0	0	59	32	6	0	1150	609	60	701	300	6
856	Apple_Inc.	200510	50	4	0	0	37	14	4	0	1200	641	64	723	309	6
856	Apple_Inc.	200511	84	18	0	0	56	27	13	0	1284	689	82	764	328	7
856	Apple_Inc.	200512	75	11	0	0	55	25	8	0	1359	734	93	799	345	7
856	Apple_Inc.	200601	206	26	6	4	84	53	16	3	1565	806	119	959	387	19
856	Apple_Inc.	200602	218	41	1	0	120	68	26	1	1783	907	160	1108	437	31
856	Apple_Inc.	200603	154	34	0	0	88	45	23	0	1937	977	194	1208	467	37
856	Apple_Inc.	200604	165	29	0	0	103	53	21	0	2102	1067	223	1303	508	41
856	Apple_Inc.	200605	174	31	4	0	91	52	23	2	2276	1142	254	1405	544	48
856	Apple_Inc.	200606	294	50	4	2	133	76	31	4	2570	1250	304	1618	595	55
856	Apple_Inc.	200607	161	36	2	0	84	49	24	2	2731	1314	340	1701	625	60
856	Apple_Inc.	200608	97	16	0	0	60	33	12	0	2828	1356	356	1764	642	62
856	Apple_Inc.	200609	178	26	0	0	108	61	18	0	3006	1441	382	1877	680	69
856	Apple_Inc.	200610	124	31	0	0	88	46	21	0	3130	1508	413	1943	707	73
856	Apple_Inc.	200611	186	51	2	1	101	57	32	2	3316	1585	464	2062	742	88
856	Apple_Inc.	200612	205	41	0	0	109	59	28	0	3521	1669	505	2180	778	94
856	Apple_Inc.	200701	191	64	9	4	115	55	39	6	3712	1762	569	2274	812	108
856	Apple_Inc.	200702	412	73	0	0	249	140	45	0	4124	1968	642	2532	911	125
856	Apple_Inc.	200703	302	69	1	0	175	92	47	1	4426	2119	711	2712	980	132
856	Apple_Inc.	200704	267	86	1	0	170	84	50	1	4693	2255	797	2863	1032	150
856	Apple_Inc.	200705	272	68	9	4	134	85	42	7	4965	2361	865	3049	1089	177
856	Apple_Inc.	200706	304	72	4	1	131	76	45	4	5269	2458	937	3271	1133	200
856	Apple_Inc.	200707	208	47	1	0	127	69	34	1	5477	2554	984	3388	1174	217
856	Apple_Inc.	200708	151	47	0	0	107	64	34	0	5628	2636	1031	3482	1213	231
856	Apple_Inc.	200709	143	35	1	0	86	47	18	1	5771	2700	1066	3564	1238	239
856	Apple_Inc.	200710	139	47	3	0	94	57	34	3	5910	2776	1113	3647	1278	251
856	Apple_Inc.	200711	290	87	0	0	174	77	41	0	6200	2925	1200	3814	1332	277
856	Apple_Inc.	200712	222	68	2	0	125	64	38	1	6422	3027	1268	3961	1374	300
856	Apple_Inc.	200801	176	51	1	0	102	48	29	1	6598	3108	1319	4054	1401	309
856	Apple_Inc.	200802	51	8	0	0	39	39	8	0	6649	3135	1327	4105	1428	317
856	Apple_Inc.	200803	40	5	0	0	29	29	3	0	6689	3157	1332	4145	1450	322
856	Apple_Inc.	200804	89	10	0	0	37	37	6	0	6778	3184	1342	4234	1477	332
856	Apple_Inc.	200805	29	2	0	0	23	23	2	0	6807	3201	1344	4263	1494	334
856	Apple_Inc.	200806	57	9	0	0	37	37	6	0	6864	3228	1353	4320	1521	343
856	Apple_Inc.	200807	37	1	0	0	21	21	1	0	6901	3242	1354	4357	1535	344
856	Apple_Inc.	200808	31	5	2	1	15	15	4	2	6932	3252	1359	4388	1545	349
856	Apple_Inc.	200809	175	3	0	0	35	35	3	0	7107	3274	1362	4563	1567	352
856	Apple_Inc.	200810	51	8	0	0	24	24	6	0	7158	3289	1370	4614	1582	360
856	Apple_Inc.	200811	40	2	0	0	28	28	2	0	7198	3308	1372	4654	1601	362
856	Apple_Inc.	200812	19	0	0	0	14	14	0	0	7217	3318	1372	4673	1611	362
856	Apple_Inc.	200901	166	60	2	1	108	62	37	2	7383	3409	1432	4778	1656	380
856	Apple_Inc.	200902	227	77	0	0	138	71	43	0	7610	3518	1509	4909	1699	394
856	Apple_Inc.	200903	30	3	0	0	20	20	3	0	7640	3529	1512	4939	1710	397
856	Apple_Inc.	200904	54	7	1	0	26	26	4	1	7694	3548	1519	4993	1729	404
856	Apple_Inc.	200905	53	11	0	0	37	27	8	0	7747	3573	1530	5033	1744	407
856	Apple_Inc.	200906	178	70	0	0	107	59	34	0	7925	3667	1600	5131	1790	426
856	Apple_Inc.	200907	186	55	0	0	113	66	31	0	8111	3760	1655	5248	1836	444
856	Apple_Inc.	200908	149	48	5	1	88	54	28	4	8260	3827	1703	5346	1869	463
856	Apple_Inc.	200909	129	34	0	0	79	41	24	0	8389	3891	1737	5424	1895	473
856	Apple_Inc.	200910	81	17	0	0	58	32	16	0	8470	3936	1754	5469	1914	474
856	Apple_Inc.	200911	18	1	0	0	13	13	1	0	8488	3945	1755	5487	1923	475
856	Apple_Inc.	200912	23	4	0	0	20	20	2	0	8511	3959	1759	5510	1937	479
856	Apple_Inc.	201001	11	0	0	0	9	9	0	0	8522	3964	1759	5521	1942	479
856	Apple_Inc.	201002	39	3	0	0	20	20	3	0	8561	3977	1762	5560	1955	482
856	Apple_Inc.	201003	37	3	0	0	24	24	3	0	8598	3989	1765	5597	1967	485
856	Apple_Inc.	201004	63	12	0	0	46	39	9	0	8661	4023	1777	5652	1994	491
856	Apple_Inc.	201005	59	7	0	0	38	33	6	0	8720	4051	1784	5705	2017	497
856	Apple_Inc.	201006	47	0	0	0	28	28	0	0	8767	4068	1784	5752	2034	497
856	Apple_Inc.	201007	29	2	0	0	19	19	2	0	8796	4082	1786	5781	2048	499
856	Apple_Inc.	201008	168	53	2	0	113	64	36	2	8964	4175	1839	5890	2092	506
856	Apple_Inc.	201009	147	39	0	0	92	58	26	0	9111	4245	1878	5987	2128	516
856	Apple_Inc.	201010	45	5	0	0	24	21	3	0	9156	4261	1883	6029	2141	519
856	Apple_Inc.	201011	49	5	0	0	27	27	5	0	9205	4277	1888	6078	2157	524
856	Apple_Inc.	201012	95	3	0	0	23	23	2	0	9300	4292	1891	6173	2172	527
856	Apple_Inc.	201101	23	3	0	0	13	13	2	0	9323	4299	1894	6196	2179	530
856	Apple_Inc.	201102	40	7	0	0	27	27	7	0	9363	4312	1901	6236	2192	537
856	Apple_Inc.	201103	15	3	0	0	13	13	3	0	9378	4318	1904	6251	2198	540
856	Apple_Inc.	201104	26	6	1	0	19	19	6	1	9404	4328	1910	6277	2208	546
856	Apple_Inc.	201105	35	3	0	0	17	17	2	0	9439	4337	1913	6312	2217	549
856	Apple_Inc.	201106	15	0	0	0	13	13	0	0	9454	4344	1913	6327	2224	549
856	Apple_Inc.	201107	16	1	0	0	12	12	1	0	9470	4353	1914	6343	2233	550
856	Apple_Inc.	201108	26	2	0	0	19	19	2	0	9496	4365	1916	6369	2245	552
856	Apple_Inc.	201109	58	0	0	0	36	36	0	0	9554	4392	1916	6427	2272	552
856	Apple_Inc.	201110	20	2	0	0	19	19	2	0	9574	4402	1918	6447	2282	554
856	Apple_Inc.	201111	111	3	0	0	68	68	3	0	9685	4451	1921	6558	2331	557
856	Apple_Inc.	201112	53	1	0	0	24	24	1	0	9738	4468	1922	6611	2348	558
856	Apple_Inc.	201201	31	5	0	0	28	26	5	0	9769	4487	1927	6640	2365	561
856	Apple_Inc.	201202	66	16	4	1	39	34	11	3	9835	4509	1943	6697	2382	572
856	Apple_Inc.	201203	45	2	0	0	21	21	2	0	9880	4521	1945	6742	2394	574
856	Apple_Inc.	201204	40	3	0	0	31	31	3	0	9920	4540	1948	6782	2413	577
856	Apple_Inc.	201205	83	18	0	0	48	35	8	0	10003	4571	1966	6842	2431	581
856	Apple_Inc.	201206	24	0	0	0	11	11	0	0	10027	4578	1966	6866	2438	581
856	Apple_Inc.	201207	29	7	3	0	17	17	5	1	10056	4588	1973	6895	2448	588
856	Apple_Inc.	201208	17	1	0	0	15	15	1	0	10073	4598	1974	6912	2458	589
856	Apple_Inc.	201209	26	2	0	0	18	18	2	0	10099	4611	1976	6938	2471	591
856	Apple_Inc.	201210	71	7	0	0	36	36	6	0	10170	4638	1983	7009	2498	598
856	Apple_Inc.	201211	115	31	2	0	63	42	19	2	10285	4686	2014	7089	2525	611
856	Apple_Inc.	201212	140	39	2	1	85	51	17	2	10425	4744	2053	7189	2549	624
856	Apple_Inc.	201301	41	2	0	0	31	31	2	0	10466	4763	2055	7230	2568	626
856	Apple_Inc.	201302	39	3	0	0	24	24	3	0	10505	4772	2058	7269	2577	629
856	Apple_Inc.	201303	44	2	0	0	20	20	2	0	10549	4782	2060	7313	2587	631
856	Apple_Inc.	201304	16	1	0	0	15	15	1	0	10565	4790	2061	7329	2595	632
856	Apple_Inc.	201305	15	1	0	0	9	9	1	0	10580	4796	2062	7344	2601	633
856	Apple_Inc.	201306	21	1	0	0	12	12	1	0	10601	4806	2063	7365	2611	634
856	Apple_Inc.	201307	22	0	0	0	15	15	0	0	10623	4817	2063	7387	2622	634
856	Apple_Inc.	201308	42	5	1	0	28	28	5	1	10665	4837	2068	7429	2642	639
856	Apple_Inc.	201309	34	3	0	0	24	24	3	0	10699	4848	2071	7463	2653	642
856	Apple_Inc.	201310	19	0	0	0	15	15	0	0	10718	4857	2071	7482	2662	642
856	Apple_Inc.	201311	29	1	0	0	15	15	1	0	10747	4866	2072	7511	2671	643
856	Apple_Inc.	201312	37	3	0	0	19	19	3	0	10784	4872	2075	7548	2677	646
856	Apple_Inc.	201401	46	5	0	0	27	27	4	0	10830	4887	2080	7594	2692	651
856	Apple_Inc.	201402	18	2	0	0	15	15	2	0	10848	4898	2082	7612	2703	653
856	Apple_Inc.	201403	17	1	0	0	10	10	1	0	10865	4902	2083	7629	2707	654
856	Apple_Inc.	201404	21	0	0	0	12	12	0	0	10886	4909	2083	7650	2714	654
856	Apple_Inc.	201405	17	2	0	0	10	10	2	0	10903	4915	2085	7667	2720	656
856	Apple_Inc.	201406	25	2	0	0	13	13	2	0	10928	4923	2087	7692	2728	658
856	Apple_Inc.	201407	21	0	0	0	13	13	0	0	10949	4930	2087	7713	2735	658
856	Apple_Inc.	201408	15	4	2	0	11	11	3	1	10964	4934	2091	7728	2739	662
856	Apple_Inc.	201409	11	1	0	0	7	7	1	0	10975	4938	2092	7739	2743	663
856	Apple_Inc.	201410	25	2	0	0	16	16	2	0	11000	4945	2094	7764	2750	665
856	Apple_Inc.	201411	24	1	0	0	13	13	1	0	11024	4950	2095	7788	2755	666
856	Apple_Inc.	201412	72	2	0	0	20	20	2	0	11096	4960	2097	7860	2765	668
856	Apple_Inc.	201501	23	1	0	0	12	12	1	0	11119	4965	2098	7883	2770	669
856	Apple_Inc.	201502	17	1	0	0	8	8	1	0	11136	4970	2099	7900	2775	670
856	Apple_Inc.	201503	36	3	0	0	20	20	3	0	11172	4981	2102	7936	2786	673
856	Apple_Inc.	201504	36	1	0	0	27	27	1	0	11208	5000	2103	7972	2805	674
856	Apple_Inc.	201505	77	2	0	0	20	20	2	0	11285	5011	2105	8049	2816	676
856	Apple_Inc.	201506	30	2	0	0	16	16	1	0	11315	5021	2107	8079	2826	678
856	Apple_Inc.	201507	23	2	0	0	12	12	2	0	11338	5030	2109	8102	2835	680
856	Apple_Inc.	201508	10	0	0	0	8	8	0	0	11348	5034	2109	8112	2839	680
856	Apple_Inc.	201509	6	0	0	0	4	4	0	0	11354	5036	2109	8118	2841	680
856	Apple_Inc.	201510	31	1	0	0	15	15	1	0	11385	5041	2110	8149	2846	681
856	Apple_Inc.	201511	16	2	0	0	10	10	1	0	11401	5047	2112	8165	2852	683
856	Apple_Inc.	201512	28	3	1	0	14	14	3	1	11429	5057	2115	8193	2862	686
856	Apple_Inc.	201601	27	2	0	0	17	17	2	0	11456	5068	2117	8220	2873	688
856	Apple_Inc.	201602	15	1	0	0	9	9	1	0	11471	5074	2118	8235	2879	689
856	Apple_Inc.	201603	24	3	0	0	13	13	1	0	11495	5083	2121	8259	2888	692
856	Apple_Inc.	201604	49	1	0	0	18	18	1	0	11544	5093	2122	8308	2898	693
856	Apple_Inc.	201605	59	2	0	0	14	14	2	0	11603	5100	2124	8367	2905	695
856	Apple_Inc.	201606	21	4	2	1	10	10	3	2	11624	5107	2128	8388	2912	699
856	Apple_Inc.	201607	24	0	0	0	12	12	0	0	11648	5113	2128	8412	2918	699
856	Apple_Inc.	201608	16	2	0	0	10	10	2	0	11664	5119	2130	8428	2924	701
856	Apple_Inc.	201609	20	2	0	0	14	14	2	0	11684	5126	2132	8448	2931	703
856	Apple_Inc.	201610	35	2	0	0	23	23	2	0	11719	5143	2134	8483	2948	705
856	Apple_Inc.	201611	41	8	2	1	23	23	4	2	11760	5158	2142	8524	2963	713
856	Apple_Inc.	201612	19	3	0	0	13	13	3	0	11779	5167	2145	8543	2972	716
856	Apple_Inc.	201701	21	1	0	0	14	14	1	0	11800	5174	2146	8564	2979	717
856	Apple_Inc.	201702	26	0	0	0	15	15	0	0	11826	5182	2146	8590	2987	717
856	Apple_Inc.	201703	32	0	0	0	9	9	0	0	11858	5188	2146	8622	2993	717
856	Apple_Inc.	201704	27	2	0	0	17	17	2	0	11885	5197	2148	8649	3002	719
856	Apple_Inc.	201705	28	6	0	0	22	22	5	0	11913	5211	2154	8677	3016	725
856	Apple_Inc.	201706	62	3	0	0	22	22	3	0	11975	5225	2157	8739	3030	728
856	Apple_Inc.	201707	43	2	0	0	16	16	1	0	12018	5232	2159	8782	3037	730
856	Apple_Inc.	201708	35	1	0	0	15	15	1	0	12053	5238	2160	8817	3043	731
856	Apple_Inc.	201709	24	0	0	0	11	11	0	0	12077	5245	2160	8841	3050	731
856	Apple_Inc.	201710	34	3	0	0	19	19	1	0	12111	5256	2163	8875	3061	734
856	Apple_Inc.	201711	21	2	0	0	14	14	2	0	12132	5267	2165	8896	3072	736
856	Apple_Inc.	201712	53	8	2	1	23	23	5	2	12185	5278	2173	8949	3083	744
856	Apple_Inc.	201801	26	1	0	0	8	8	1	0	12211	5281	2174	8975	3086	745
856	Apple_Inc.	201802	23	0	0	0	14	14	0	0	12234	5287	2174	8998	3092	745
856	Apple_Inc.	201803	18	0	0	0	10	10	0	0	12252	5293	2174	9016	3098	745
856	Apple_Inc.	201804	17	2	0	0	16	16	2	0	12269	5300	2176	9033	3105	747
856	Apple_Inc.	201805	29	3	0	0	22	22	3	0	12298	5311	2179	9062	3116	750
856	Apple_Inc.	201806	18	3	0	0	13	13	2	0	12316	5317	2182	9080	3122	753
856	Apple_Inc.	201807	25	2	0	0	15	15	1	0	12341	5326	2184	9105	3131	755
147845	Application-specific_integrated_circuit	200301	4	0	0	0	1	0	0	0	4	1	0	0	0	0
147845	Application-specific_integrated_circuit	200303	2	0	0	0	1	1	0	0	6	2	0	2	1	0
147845	Application-specific_integrated_circuit	200309	1	0	0	0	1	1	0	0	7	3	0	3	2	0
147845	Application-specific_integrated_circuit	200310	3	1	0	0	3	2	1	0	10	6	1	5	4	0
147845	Application-specific_integrated_circuit	200312	1	0	0	0	1	1	0	0	11	7	1	6	5	0
147845	Application-specific_integrated_circuit	200401	1	0	0	0	1	1	0	0	12	8	1	7	6	0
147845	Application-specific_integrated_circuit	200402	2	0	0	0	2	1	0	0	14	10	1	8	7	0
147845	Application-specific_integrated_circuit	200405	1	0	0	0	1	1	0	0	15	11	1	9	8	0
147845	Application-specific_integrated_circuit	200407	1	0	0	0	1	0	0	0	16	12	1	9	8	0
147845	Application-specific_integrated_circuit	200408	1	0	0	0	1	1	0	0	17	13	1	10	9	0
147845	Application-specific_integrated_circuit	200409	1	0	0	0	1	0	0	0	18	14	1	10	9	0
147845	Application-specific_integrated_circuit	200410	3	0	0	0	2	2	0	0	21	16	1	13	11	0
147845	Application-specific_integrated_circuit	200411	3	0	0	0	3	3	0	0	24	19	1	16	14	0
147845	Application-specific_integrated_circuit	200412	1	0	0	0	1	1	0	0	25	20	1	17	15	0
147845	Application-specific_integrated_circuit	200502	2	0	0	0	2	2	0	0	27	21	1	19	16	0
147845	Application-specific_integrated_circuit	200503	3	0	0	0	3	3	0	0	30	24	1	22	19	0
147845	Application-specific_integrated_circuit	200504	1	0	0	0	1	0	0	0	31	25	1	22	19	0
147845	Application-specific_integrated_circuit	200505	2	0	0	0	1	1	0	0	33	26	1	24	20	0
147845	Application-specific_integrated_circuit	200506	9	0	0	0	7	4	0	0	42	32	1	29	23	0
147845	Application-specific_integrated_circuit	200507	23	0	0	0	5	3	0	0	65	36	1	32	25	0
147845	Application-specific_integrated_circuit	200508	4	0	0	0	4	1	0	0	69	40	1	33	26	0
147845	Application-specific_integrated_circuit	200509	7	0	0	0	4	1	0	0	76	44	1	34	27	0
147845	Application-specific_integrated_circuit	200510	4	0	0	0	3	3	0	0	80	47	1	38	30	0
147845	Application-specific_integrated_circuit	200511	8	0	0	0	4	3	0	0	88	51	1	45	33	0
147845	Application-specific_integrated_circuit	200512	7	0	0	0	6	2	0	0	95	57	1	47	35	0
147845	Application-specific_integrated_circuit	200601	8	0	0	0	6	4	0	0	103	63	1	51	39	0
147845	Application-specific_integrated_circuit	200602	1	0	0	0	1	0	0	0	104	64	1	51	39	0
147845	Application-specific_integrated_circuit	200603	21	0	0	0	8	5	0	0	125	72	1	68	44	0
147845	Application-specific_integrated_circuit	200604	9	1	0	0	8	4	1	0	134	80	2	72	48	0
147845	Application-specific_integrated_circuit	200605	20	0	0	0	8	4	0	0	154	88	2	77	52	0
147845	Application-specific_integrated_circuit	200606	9	0	0	0	8	4	0	0	163	96	2	81	56	0
147845	Application-specific_integrated_circuit	200607	7	1	0	0	7	6	1	0	170	101	3	87	60	1
147845	Application-specific_integrated_circuit	200608	8	0	0	0	5	2	0	0	178	106	3	92	62	1
147845	Application-specific_integrated_circuit	200609	10	1	0	0	7	2	1	0	188	112	4	95	63	1
147845	Application-specific_integrated_circuit	200610	1	0	0	0	1	0	0	0	189	113	4	95	63	1
147845	Application-specific_integrated_circuit	200611	20	1	0	0	12	3	1	0	209	123	5	98	65	1
147845	Application-specific_integrated_circuit	200612	1	0	0	0	1	1	0	0	210	123	5	99	65	1
147845	Application-specific_integrated_circuit	200701	14	0	0	0	11	6	0	0	224	133	5	108	71	1
147845	Application-specific_integrated_circuit	200702	9	3	0	0	7	3	2	0	233	140	8	113	74	2
147845	Application-specific_integrated_circuit	200703	4	1	0	0	4	2	1	0	237	143	9	115	75	2
147845	Application-specific_integrated_circuit	200704	3	0	0	0	2	0	0	0	240	144	9	115	75	2
147845	Application-specific_integrated_circuit	200705	8	1	0	0	7	4	1	0	248	151	10	120	79	3
147845	Application-specific_integrated_circuit	200706	9	1	0	0	8	4	1	0	257	157	11	125	83	3
147845	Application-specific_integrated_circuit	200707	5	0	0	0	5	2	0	0	262	161	11	127	85	3
147845	Application-specific_integrated_circuit	200708	4	1	0	0	4	4	1	0	266	165	12	131	89	4
147845	Application-specific_integrated_circuit	200709	11	1	0	0	10	6	1	0	277	173	13	138	93	5
147845	Application-specific_integrated_circuit	200710	15	2	0	0	11	4	2	0	292	182	15	142	95	5
147845	Application-specific_integrated_circuit	200712	4	0	0	0	4	2	0	0	296	185	15	144	96	5
147845	Application-specific_integrated_circuit	200801	1	0	0	0	1	1	0	0	297	186	15	145	97	5
147845	Application-specific_integrated_circuit	200802	4	0	0	0	2	1	0	0	301	187	15	146	97	5
147845	Application-specific_integrated_circuit	200803	9	1	0	0	5	3	1	0	310	190	16	153	99	6
147845	Application-specific_integrated_circuit	200804	6	0	0	0	4	1	0	0	316	193	16	155	99	6
147845	Application-specific_integrated_circuit	200805	2	0	0	0	2	1	0	0	318	195	16	156	100	6
147845	Application-specific_integrated_circuit	200806	6	0	0	0	5	1	0	0	324	200	16	158	101	6
147845	Application-specific_integrated_circuit	200807	19	2	0	0	10	6	2	0	343	208	18	164	105	6
147845	Application-specific_integrated_circuit	200808	11	2	0	0	9	4	2	0	354	215	20	168	108	6
147845	Application-specific_integrated_circuit	200809	21	8	5	3	10	7	4	3	375	222	28	181	112	11
147845	Application-specific_integrated_circuit	200810	2	1	0	0	2	1	1	0	377	223	29	182	112	11
147845	Application-specific_integrated_circuit	200811	36	4	0	0	14	10	3	0	413	235	33	212	120	15
147845	Application-specific_integrated_circuit	200812	4	0	0	0	4	0	0	0	417	239	33	212	120	15
147845	Application-specific_integrated_circuit	200901	11	2	0	0	10	5	2	0	428	247	35	217	124	15
147845	Application-specific_integrated_circuit	200902	10	3	1	0	9	5	2	1	438	256	38	223	129	17
147845	Application-specific_integrated_circuit	200903	6	3	1	1	5	2	3	1	444	259	41	225	130	18
147845	Application-specific_integrated_circuit	200904	1	0	0	0	1	0	0	0	445	260	41	225	130	18
147845	Application-specific_integrated_circuit	200905	3	0	0	0	2	1	0	0	448	262	41	227	131	18
147845	Application-specific_integrated_circuit	200907	1	0	0	0	1	1	0	0	449	263	41	228	132	18
147845	Application-specific_integrated_circuit	200908	12	2	0	0	10	5	2	0	461	273	43	233	137	18
147845	Application-specific_integrated_circuit	200910	4	0	0	0	4	2	0	0	465	276	43	235	138	18
147845	Application-specific_integrated_circuit	200911	2	1	0	0	2	1	1	0	467	278	44	236	139	18
147845	Application-specific_integrated_circuit	200912	2	0	0	0	2	1	0	0	469	280	44	237	140	18
147845	Application-specific_integrated_circuit	201001	3	0	0	0	3	2	0	0	472	283	44	239	142	18
147845	Application-specific_integrated_circuit	201002	6	2	0	0	6	3	2	0	478	288	46	242	144	18
147845	Application-specific_integrated_circuit	201003	3	0	0	0	3	2	0	0	481	291	46	244	146	18
147845	Application-specific_integrated_circuit	201004	2	0	0	0	2	0	0	0	483	293	46	244	146	18
147845	Application-specific_integrated_circuit	201005	3	0	0	0	2	2	0	0	486	295	46	247	148	18
147845	Application-specific_integrated_circuit	201006	3	0	0	0	3	2	0	0	489	298	46	249	150	18
147845	Application-specific_integrated_circuit	201007	2	0	0	0	2	0	0	0	491	300	46	249	150	18
147845	Application-specific_integrated_circuit	201008	1	0	0	0	1	1	0	0	492	301	46	250	151	18
147845	Application-specific_integrated_circuit	201009	2	0	0	0	1	0	0	0	494	302	46	250	151	18
147845	Application-specific_integrated_circuit	201010	5	1	0	0	4	3	1	0	499	306	47	254	154	19
147845	Application-specific_integrated_circuit	201011	5	0	0	0	4	3	0	0	504	309	47	257	156	19
147845	Application-specific_integrated_circuit	201012	3	0	0	0	3	3	0	0	507	312	47	260	159	19
147845	Application-specific_integrated_circuit	201101	1	0	0	0	1	1	0	0	508	313	47	261	160	19
147845	Application-specific_integrated_circuit	201102	9	1	0	0	5	4	1	0	517	317	48	269	163	19
147845	Application-specific_integrated_circuit	201103	6	0	0	0	4	3	0	0	523	320	48	274	165	19
147845	Application-specific_integrated_circuit	201104	4	0	0	0	3	1	0	0	527	323	48	275	166	19
147845	Application-specific_integrated_circuit	201105	4	0	0	0	3	2	0	0	531	325	48	277	167	19
147845	Application-specific_integrated_circuit	201106	2	0	0	0	2	2	0	0	533	327	48	279	169	19
147845	Application-specific_integrated_circuit	201107	2	0	0	0	2	0	0	0	535	329	48	279	169	19
147845	Application-specific_integrated_circuit	201108	11	2	0	0	7	3	2	0	546	335	50	284	171	20
147845	Application-specific_integrated_circuit	201109	3	1	0	0	3	3	1	0	549	338	51	287	174	21
147845	Application-specific_integrated_circuit	201110	3	1	0	0	3	1	1	0	552	340	52	288	174	21
147845	Application-specific_integrated_circuit	201111	4	1	0	0	4	3	1	0	556	344	53	291	177	22
147845	Application-specific_integrated_circuit	201112	16	4	0	0	14	8	3	0	572	356	57	300	183	23
147845	Application-specific_integrated_circuit	201201	11	0	0	0	4	1	0	0	583	358	57	307	183	23
147845	Application-specific_integrated_circuit	201202	4	0	0	0	3	2	0	0	587	360	57	310	184	23
147845	Application-specific_integrated_circuit	201203	5	1	0	0	5	4	1	0	592	364	58	314	187	24
147845	Application-specific_integrated_circuit	201204	3	0	0	0	3	1	0	0	595	367	58	315	188	24
147845	Application-specific_integrated_circuit	201205	1	0	0	0	1	0	0	0	596	368	58	315	188	24
147845	Application-specific_integrated_circuit	201206	3	0	0	0	2	1	0	0	599	370	58	317	189	24
147845	Application-specific_integrated_circuit	201207	1	0	0	0	1	1	0	0	600	371	58	318	190	24
147845	Application-specific_integrated_circuit	201208	1	0	0	0	1	1	0	0	601	372	58	319	191	24
147845	Application-specific_integrated_circuit	201209	3	0	0	0	1	1	0	0	604	373	58	322	192	24
147845	Application-specific_integrated_circuit	201210	4	0	0	0	3	1	0	0	608	375	58	323	192	24
147845	Application-specific_integrated_circuit	201212	1	0	0	0	1	0	0	0	609	376	58	323	192	24
147845	Application-specific_integrated_circuit	201301	4	1	0	0	3	1	1	0	613	379	59	324	193	24
147845	Application-specific_integrated_circuit	201302	2	0	0	0	2	2	0	0	615	380	59	326	194	24
147845	Application-specific_integrated_circuit	201303	3	0	0	0	3	2	0	0	618	383	59	328	196	24
147845	Application-specific_integrated_circuit	201304	1	0	0	0	1	1	0	0	619	383	59	329	196	24
147845	Application-specific_integrated_circuit	201305	3	1	0	0	3	2	1	0	622	386	60	331	198	24
147845	Application-specific_integrated_circuit	201306	1	0	0	0	1	0	0	0	623	387	60	331	198	24
147845	Application-specific_integrated_circuit	201307	2	0	0	0	2	0	0	0	625	389	60	331	198	24
147845	Application-specific_integrated_circuit	201308	4	0	0	0	3	2	0	0	629	392	60	334	200	24
147845	Application-specific_integrated_circuit	201309	2	0	0	0	2	2	0	0	631	394	60	336	202	24
147845	Application-specific_integrated_circuit	201310	1	0	0	0	1	1	0	0	632	394	60	337	202	24
147845	Application-specific_integrated_circuit	201311	8	0	0	0	5	3	0	0	640	398	60	343	204	24
147845	Application-specific_integrated_circuit	201312	1	0	0	0	1	0	0	0	641	399	60	343	204	24
147845	Application-specific_integrated_circuit	201401	2	0	0	0	2	1	0	0	643	401	60	344	205	24
147845	Application-specific_integrated_circuit	201402	3	0	0	0	3	2	0	0	646	404	60	346	207	24
147845	Application-specific_integrated_circuit	201403	2	0	0	0	2	1	0	0	648	406	60	347	208	24
147845	Application-specific_integrated_circuit	201404	3	0	0	0	3	1	0	0	651	409	60	348	209	24
147845	Application-specific_integrated_circuit	201405	4	0	0	0	3	3	0	0	655	412	60	352	212	24
147845	Application-specific_integrated_circuit	201406	2	0	0	0	1	0	0	0	657	413	60	352	212	24
147845	Application-specific_integrated_circuit	201408	1	0	0	0	1	0	0	0	658	414	60	352	212	24
147845	Application-specific_integrated_circuit	201501	8	1	0	0	6	5	1	0	666	420	61	359	217	25
147845	Application-specific_integrated_circuit	201505	1	0	0	0	1	1	0	0	667	421	61	360	218	25
147845	Application-specific_integrated_circuit	201508	2	0	0	0	2	2	0	0	669	423	61	362	220	25
147845	Application-specific_integrated_circuit	201510	1	0	0	0	1	1	0	0	670	424	61	363	221	25
147845	Application-specific_integrated_circuit	201512	3	0	0	0	2	2	0	0	673	425	61	366	222	25
147845	Application-specific_integrated_circuit	201601	1	0	0	0	1	1	0	0	674	426	61	367	223	25
147845	Application-specific_integrated_circuit	201603	2	1	0	0	2	1	1	0	676	428	62	368	224	25
147845	Application-specific_integrated_circuit	201608	1	0	0	0	1	1	0	0	677	429	62	369	225	25
147845	Application-specific_integrated_circuit	201610	2	1	0	0	2	1	1	0	679	430	63	370	225	25
147845	Application-specific_integrated_circuit	201611	1	0	0	0	1	1	0	0	680	431	63	371	226	25
147845	Application-specific_integrated_circuit	201701	3	0	0	0	2	2	0	0	683	433	63	374	228	25
147845	Application-specific_integrated_circuit	201702	14	4	2	1	5	4	3	2	697	435	67	387	229	28
147845	Application-specific_integrated_circuit	201705	3	1	0	0	3	3	1	0	700	436	68	390	230	29
147845	Application-specific_integrated_circuit	201707	1	0	0	0	1	1	0	0	701	437	68	391	231	29
147845	Application-specific_integrated_circuit	201710	2	0	0	0	1	1	0	0	703	438	68	393	232	29
147845	Application-specific_integrated_circuit	201711	1	0	0	0	1	1	0	0	704	439	68	394	233	29
147845	Application-specific_integrated_circuit	201712	1	0	0	0	1	1	0	0	705	440	68	395	234	29
147845	Application-specific_integrated_circuit	201801	6	0	0	0	5	5	0	0	711	444	68	401	238	29
147845	Application-specific_integrated_circuit	201802	1	0	0	0	1	1	0	0	712	445	68	402	239	29
147845	Application-specific_integrated_circuit	201804	1	0	0	0	1	1	0	0	713	446	68	403	240	29
147845	Application-specific_integrated_circuit	201805	1	0	0	0	1	0	0	0	714	447	68	403	240	29
147845	Application-specific_integrated_circuit	201807	1	0	0	0	1	0	0	0	715	448	68	403	240	29
27697009	Application_programming_interface	200112	1	0	0	0	1	1	0	0	1	1	0	1	1	0
27697009	Application_programming_interface	200201	5	0	0	0	2	2	0	0	6	3	0	6	3	0
27697009	Application_programming_interface	200202	9	0	0	0	5	5	0	0	15	7	0	15	4	0
27697009	Application_programming_interface	200203	12	0	0	0	5	4	0	0	27	11	0	26	6	0
27697009	Application_programming_interface	200205	1	0	0	0	1	1	0	0	28	12	0	27	7	0
27697009	Application_programming_interface	200206	1	0	0	0	1	1	0	0	29	13	0	28	8	0
27697009	Application_programming_interface	200207	2	0	0	0	2	2	0	0	31	15	0	30	10	0
27697009	Application_programming_interface	200210	1	0	0	0	1	1	0	0	32	16	0	31	11	0
27697009	Application_programming_interface	200301	2	0	0	0	2	1	0	0	34	17	0	32	11	0
27697009	Application_programming_interface	200302	3	0	0	0	2	2	0	0	37	19	0	35	13	0
27697009	Application_programming_interface	200303	1	0	0	0	1	1	0	0	38	20	0	36	14	0
27697009	Application_programming_interface	200306	4	0	0	0	3	3	0	0	42	23	0	40	17	0
27697009	Application_programming_interface	200307	4	0	0	0	2	1	0	0	46	25	0	43	18	0
27697009	Application_programming_interface	200308	1	0	0	0	1	1	0	0	47	26	0	44	19	0
27697009	Application_programming_interface	200309	1	0	0	0	1	1	0	0	48	27	0	45	20	0
27697009	Application_programming_interface	200310	3	0	0	0	1	0	0	0	51	28	0	45	20	0
27697009	Application_programming_interface	200312	1	0	0	0	1	1	0	0	52	29	0	46	21	0
27697009	Application_programming_interface	200401	4	0	0	0	4	3	0	0	56	33	0	49	24	0
27697009	Application_programming_interface	200402	3	0	0	0	3	2	0	0	59	36	0	51	26	0
27697009	Application_programming_interface	200403	8	0	0	0	8	4	0	0	67	44	0	55	30	0
27697009	Application_programming_interface	200404	8	1	0	0	7	4	1	0	75	50	1	60	33	1
27697009	Application_programming_interface	200405	5	1	0	0	5	2	1	0	80	55	2	62	35	1
27697009	Application_programming_interface	200406	5	0	0	0	3	2	0	0	85	57	2	65	36	1
27697009	Application_programming_interface	200407	5	0	0	0	4	4	0	0	90	60	2	70	39	1
27697009	Application_programming_interface	200408	6	0	0	0	6	6	0	0	96	65	2	76	44	1
27697009	Application_programming_interface	200409	1	0	0	0	1	0	0	0	97	66	2	76	44	1
27697009	Application_programming_interface	200410	6	0	0	0	4	2	0	0	103	70	2	78	46	1
27697009	Application_programming_interface	200411	3	0	0	0	3	2	0	0	106	73	2	80	48	1
27697009	Application_programming_interface	200412	5	0	0	0	3	2	0	0	111	76	2	84	50	1
27697009	Application_programming_interface	200501	11	0	0	0	9	5	0	0	122	84	2	91	54	1
27697009	Application_programming_interface	200502	2	0	0	0	2	2	0	0	124	85	2	93	55	1
27697009	Application_programming_interface	200503	7	0	0	0	7	3	0	0	131	92	2	96	58	1
27697009	Application_programming_interface	200504	6	0	0	0	5	5	0	0	137	97	2	102	63	1
27697009	Application_programming_interface	200505	3	0	0	0	3	2	0	0	140	99	2	104	64	1
27697009	Application_programming_interface	200506	6	0	0	0	4	1	0	0	146	102	2	105	64	1
27697009	Application_programming_interface	200507	15	1	0	0	7	3	1	0	161	107	3	113	65	1
27697009	Application_programming_interface	200508	13	0	0	0	12	6	0	0	174	118	3	119	70	1
27697009	Application_programming_interface	200509	8	0	0	0	7	5	0	0	182	124	3	125	74	1
27697009	Application_programming_interface	200510	10	0	0	0	8	5	0	0	192	131	3	132	78	1
27697009	Application_programming_interface	200511	6	1	0	0	5	2	1	0	198	135	4	134	79	1
27697009	Application_programming_interface	200512	19	1	0	0	12	3	1	0	217	147	5	137	82	2
27697009	Application_programming_interface	200601	8	0	0	0	7	5	0	0	225	154	5	142	87	2
27697009	Application_programming_interface	200602	15	3	0	0	13	4	3	0	240	166	8	147	90	2
27697009	Application_programming_interface	200603	14	0	0	0	7	5	0	0	254	173	8	159	95	2
27697009	Application_programming_interface	200604	21	4	0	0	14	7	4	0	275	184	12	167	99	2
27697009	Application_programming_interface	200605	5	0	0	0	5	5	0	0	280	188	12	172	103	2
27697009	Application_programming_interface	200606	12	3	1	0	11	9	3	1	292	199	15	182	112	4
27697009	Application_programming_interface	200607	10	0	0	0	9	6	0	0	302	206	15	189	116	4
27697009	Application_programming_interface	200608	13	2	0	0	12	3	2	0	315	218	17	193	119	4
27697009	Application_programming_interface	200609	8	4	0	0	7	2	3	0	323	224	21	196	120	4
27697009	Application_programming_interface	200610	15	2	0	0	12	9	2	0	338	233	23	206	126	4
27697009	Application_programming_interface	200611	23	3	0	0	16	5	2	0	361	247	26	212	129	4
27697009	Application_programming_interface	200612	25	2	0	0	13	6	1	0	386	258	28	222	133	4
27697009	Application_programming_interface	200701	28	5	0	0	21	12	5	0	414	276	33	236	142	4
27697009	Application_programming_interface	200702	9	0	0	0	7	5	0	0	423	281	33	242	145	4
27697009	Application_programming_interface	200703	10	3	0	0	8	3	2	0	433	288	36	247	147	4
27697009	Application_programming_interface	200704	7	1	0	0	6	3	1	0	440	294	37	250	150	4
27697009	Application_programming_interface	200705	7	0	0	0	5	4	0	0	447	299	37	256	154	4
27697009	Application_programming_interface	200706	22	5	0	0	15	5	3	0	469	312	42	264	157	4
27697009	Application_programming_interface	200707	10	3	0	0	9	3	3	0	479	320	45	267	159	4
27697009	Application_programming_interface	200708	5	1	0	0	5	3	1	0	484	325	46	270	162	4
27697009	Application_programming_interface	200709	20	5	2	0	12	6	4	1	504	334	51	281	165	7
27697009	Application_programming_interface	200710	10	3	0	0	10	4	3	0	514	342	54	285	167	7
27697009	Application_programming_interface	200711	19	3	0	0	13	8	2	0	533	353	57	296	173	7
27697009	Application_programming_interface	200712	14	4	0	0	12	5	4	0	547	363	61	301	176	7
27697009	Application_programming_interface	200801	7	1	0	0	7	6	1	0	554	369	62	307	181	7
27697009	Application_programming_interface	200802	9	3	0	0	7	4	3	0	563	376	65	312	185	7
27697009	Application_programming_interface	200803	12	1	0	0	10	6	1	0	575	384	66	319	189	7
27697009	Application_programming_interface	200804	24	5	0	0	16	11	3	0	599	398	71	338	198	9
27697009	Application_programming_interface	200805	29	5	0	0	21	11	3	0	628	417	76	352	207	10
27697009	Application_programming_interface	200806	9	2	0	0	9	4	2	0	637	425	78	356	210	10
27697009	Application_programming_interface	200807	17	4	0	0	12	2	2	0	654	435	82	360	210	10
27697009	Application_programming_interface	200808	9	2	0	0	9	5	2	0	663	443	84	365	214	10
27697009	Application_programming_interface	200809	11	3	0	0	10	4	3	0	674	450	87	369	215	10
27697009	Application_programming_interface	200810	1	0	0	0	1	0	0	0	675	451	87	369	215	10
27697009	Application_programming_interface	200811	12	1	0	0	11	5	1	0	687	460	88	374	218	10
27697009	Application_programming_interface	200812	22	8	0	0	15	6	8	0	709	474	96	381	223	11
27697009	Application_programming_interface	200901	17	4	0	0	16	9	4	0	726	488	100	390	230	12
27697009	Application_programming_interface	200902	25	8	0	0	18	12	7	0	751	502	108	407	238	14
27697009	Application_programming_interface	200903	34	8	1	0	20	7	5	1	785	517	116	418	240	16
27697009	Application_programming_interface	200904	12	4	0	0	7	6	2	0	797	522	120	429	244	20
27697009	Application_programming_interface	200905	21	1	0	0	10	4	1	0	818	529	121	444	245	20
27697009	Application_programming_interface	200906	24	7	0	0	18	9	6	0	842	545	128	458	252	21
27697009	Application_programming_interface	200907	40	1	0	0	18	4	1	0	882	562	129	474	255	21
27697009	Application_programming_interface	200908	31	4	0	0	19	11	4	0	913	579	133	494	264	21
27697009	Application_programming_interface	200909	8	2	0	0	8	6	2	0	921	587	135	500	270	21
27697009	Application_programming_interface	200910	20	3	0	0	15	8	2	0	941	602	138	511	278	22
27697009	Application_programming_interface	200911	64	10	1	0	30	15	7	1	1005	627	148	542	288	23
27697009	Application_programming_interface	200912	15	2	0	0	11	4	2	0	1020	636	150	547	290	23
27697009	Application_programming_interface	201001	23	5	0	0	15	7	4	0	1043	650	155	559	296	23
27697009	Application_programming_interface	201002	44	4	0	0	25	13	4	0	1087	672	159	572	306	25
27697009	Application_programming_interface	201003	19	1	0	0	14	9	1	0	1106	684	160	585	313	25
27697009	Application_programming_interface	201004	25	5	0	0	22	9	5	0	1131	704	165	595	320	26
27697009	Application_programming_interface	201005	29	3	0	0	23	6	2	0	1160	725	168	602	326	26
27697009	Application_programming_interface	201006	24	2	0	0	10	4	2	0	1184	732	170	618	327	26
27697009	Application_programming_interface	201007	14	2	0	0	8	4	2	0	1198	738	172	627	329	26
27697009	Application_programming_interface	201008	7	0	0	0	3	1	0	0	1205	741	172	630	330	26
27697009	Application_programming_interface	201009	20	5	0	0	18	7	5	0	1225	758	177	637	336	26
27697009	Application_programming_interface	201010	9	0	0	0	8	2	0	0	1234	766	177	639	338	26
27697009	Application_programming_interface	201011	9	2	0	0	8	3	2	0	1243	773	179	642	340	26
27697009	Application_programming_interface	201012	18	0	0	0	10	4	0	0	1261	781	179	648	342	26
27697009	Application_programming_interface	201101	12	3	0	0	11	4	3	0	1273	792	182	653	346	26
27697009	Application_programming_interface	201102	21	2	0	0	9	3	2	0	1294	799	184	658	348	26
27697009	Application_programming_interface	201103	22	1	0	0	16	7	1	0	1316	811	185	665	353	26
27697009	Application_programming_interface	201104	13	3	0	0	12	7	3	0	1329	821	188	672	358	27
27697009	Application_programming_interface	201105	11	1	0	0	10	9	1	0	1340	830	189	682	366	28
27697009	Application_programming_interface	201106	15	3	0	0	11	6	3	0	1355	839	192	689	370	29
27697009	Application_programming_interface	201107	10	3	0	0	9	5	3	0	1365	845	195	695	372	30
27697009	Application_programming_interface	201108	7	2	0	0	6	4	1	0	1372	851	197	700	376	30
27697009	Application_programming_interface	201109	25	0	0	0	12	4	0	0	1397	858	197	704	379	30
27697009	Application_programming_interface	201110	19	5	0	0	15	8	5	0	1416	872	202	714	386	31
27697009	Application_programming_interface	201111	8	3	0	0	8	4	3	0	1424	877	205	718	387	31
27697009	Application_programming_interface	201112	18	2	0	0	10	3	2	0	1442	882	207	722	389	31
27697009	Application_programming_interface	201201	13	3	0	0	12	8	3	0	1455	892	210	731	395	31
27697009	Application_programming_interface	201202	11	3	0	0	11	3	3	0	1466	902	213	734	397	31
27697009	Application_programming_interface	201203	6	2	0	0	6	3	2	0	1472	906	215	737	398	31
27697009	Application_programming_interface	201204	11	4	0	0	10	4	4	0	1483	914	219	741	400	32
27697009	Application_programming_interface	201205	22	4	0	0	11	8	3	0	1505	922	223	755	406	35
27697009	Application_programming_interface	201206	26	3	0	0	14	8	2	0	1531	932	226	767	412	37
27697009	Application_programming_interface	201207	16	5	0	0	13	6	4	0	1547	942	231	776	415	39
27697009	Application_programming_interface	201208	10	2	0	0	9	5	2	0	1557	950	233	782	419	39
27697009	Application_programming_interface	201209	11	2	0	0	10	7	2	0	1568	957	235	789	423	40
27697009	Application_programming_interface	201210	7	2	0	0	6	1	2	0	1575	962	237	790	423	40
27697009	Application_programming_interface	201211	16	4	0	0	14	7	4	0	1591	973	241	797	427	40
27697009	Application_programming_interface	201212	10	2	0	0	7	4	2	0	1601	979	243	802	430	40
27697009	Application_programming_interface	201301	24	8	1	0	18	12	6	1	1625	995	251	819	440	42
27697009	Application_programming_interface	201302	15	6	0	0	14	5	6	0	1640	1006	257	824	443	44
27697009	Application_programming_interface	201303	23	4	0	0	19	6	3	0	1663	1023	261	831	447	45
27697009	Application_programming_interface	201304	9	3	0	0	9	5	3	0	1672	1029	264	836	448	46
27697009	Application_programming_interface	201305	18	3	0	0	13	5	3	0	1690	1041	267	843	453	47
27697009	Application_programming_interface	201306	15	1	0	0	9	3	1	0	1705	1048	268	848	456	47
27697009	Application_programming_interface	201307	8	0	0	0	8	3	0	0	1713	1054	268	851	459	47
27697009	Application_programming_interface	201308	22	5	0	0	15	7	4	0	1735	1067	273	860	464	47
27697009	Application_programming_interface	201309	17	2	0	0	9	6	2	0	1752	1075	275	873	469	48
27697009	Application_programming_interface	201310	22	2	0	0	13	7	2	0	1774	1086	277	885	474	48
27697009	Application_programming_interface	201311	12	3	0	0	8	3	2	0	1786	1092	280	890	476	48
27697009	Application_programming_interface	201312	20	6	0	0	14	6	5	0	1806	1103	286	902	480	48
27697009	Application_programming_interface	201401	24	5	0	0	13	6	3	0	1830	1112	291	916	483	48
27697009	Application_programming_interface	201402	6	1	0	0	6	4	1	0	1836	1117	292	920	486	48
27697009	Application_programming_interface	201403	33	5	0	0	17	7	4	0	1869	1130	297	936	489	48
27697009	Application_programming_interface	201404	14	2	0	0	8	6	1	0	1883	1136	299	947	493	49
27697009	Application_programming_interface	201405	33	5	0	0	15	5	3	0	1916	1148	304	957	495	49
27697009	Application_programming_interface	201406	9	2	1	0	5	3	2	1	1925	1151	306	961	496	51
27697009	Application_programming_interface	201407	3	0	0	0	1	1	0	0	1928	1152	306	964	497	51
27697009	Application_programming_interface	201408	5	1	0	0	4	1	1	0	1933	1156	307	965	498	51
27697009	Application_programming_interface	201409	12	1	0	0	9	6	1	0	1945	1164	308	973	503	51
27697009	Application_programming_interface	201410	1	0	0	0	1	1	0	0	1946	1165	308	974	504	51
27697009	Application_programming_interface	201411	6	0	0	0	6	3	0	0	1952	1170	308	977	506	51
27697009	Application_programming_interface	201412	18	0	0	0	7	3	0	0	1970	1175	308	980	508	51
27697009	Application_programming_interface	201501	1	0	0	0	1	1	0	0	1971	1176	308	981	509	51
27697009	Application_programming_interface	201502	10	2	0	0	7	2	2	0	1981	1181	310	983	510	51
27697009	Application_programming_interface	201503	3	1	0	0	3	2	1	0	1984	1184	311	985	512	51
27697009	Application_programming_interface	201504	7	0	0	0	5	1	0	0	1991	1189	311	987	513	51
27697009	Application_programming_interface	201505	13	0	0	0	9	5	0	0	2004	1195	311	996	516	51
27697009	Application_programming_interface	201506	7	2	0	0	6	5	2	0	2011	1201	313	1002	520	53
27697009	Application_programming_interface	201507	11	0	0	0	9	4	0	0	2022	1208	313	1006	523	53
27697009	Application_programming_interface	201508	10	2	0	0	7	6	1	0	2032	1214	315	1014	527	55
27697009	Application_programming_interface	201509	3	0	0	0	3	3	0	0	2035	1216	315	1017	529	55
27697009	Application_programming_interface	201510	2	0	0	0	2	2	0	0	2037	1217	315	1019	530	55
27697009	Application_programming_interface	201511	6	1	0	0	6	3	1	0	2043	1223	316	1022	533	55
27697009	Application_programming_interface	201512	17	4	0	0	14	6	4	0	2060	1235	320	1029	537	55
27697009	Application_programming_interface	201601	7	1	0	0	6	3	1	0	2067	1240	321	1032	539	55
27697009	Application_programming_interface	201602	7	0	0	0	5	3	0	0	2074	1245	321	1035	542	55
27697009	Application_programming_interface	201603	15	2	0	0	9	5	2	0	2089	1253	323	1041	544	56
27697009	Application_programming_interface	201604	8	1	0	0	7	5	1	0	2097	1258	324	1047	547	56
27697009	Application_programming_interface	201605	12	2	0	0	9	5	2	0	2109	1266	326	1054	551	56
27697009	Application_programming_interface	201606	4	0	0	0	4	0	0	0	2113	1270	326	1054	551	56
27697009	Application_programming_interface	201607	9	1	0	0	8	2	1	0	2122	1277	327	1056	552	56
27697009	Application_programming_interface	201608	50	4	0	0	13	7	4	0	2172	1288	331	1100	556	57
27697009	Application_programming_interface	201609	16	1	0	0	9	6	1	0	2188	1293	332	1113	558	57
27697009	Application_programming_interface	201610	10	4	0	0	10	5	4	0	2198	1302	336	1118	562	57
27697009	Application_programming_interface	201611	15	2	0	0	12	8	2	0	2213	1311	338	1127	565	58
27697009	Application_programming_interface	201612	19	6	0	0	15	7	5	0	2232	1324	344	1136	570	58
27697009	Application_programming_interface	201701	6	0	0	0	6	3	0	0	2238	1329	344	1139	572	58
27697009	Application_programming_interface	201702	40	14	0	0	16	10	10	0	2278	1342	358	1161	579	63
27697009	Application_programming_interface	201703	9	3	0	0	7	7	3	0	2287	1345	361	1170	582	66
27697009	Application_programming_interface	201704	33	4	0	0	18	12	4	0	2320	1360	365	1194	589	69
27697009	Application_programming_interface	201705	9	3	0	0	7	4	3	0	2329	1365	368	1198	591	69
27697009	Application_programming_interface	201706	9	3	0	0	8	5	3	0	2338	1369	371	1204	592	69
27697009	Application_programming_interface	201707	8	0	0	0	5	4	0	0	2346	1373	371	1209	595	69
27697009	Application_programming_interface	201708	8	3	0	0	8	4	3	0	2354	1379	374	1213	595	70
27697009	Application_programming_interface	201709	3	1	0	0	3	2	1	0	2357	1381	375	1215	596	70
27697009	Application_programming_interface	201710	12	2	0	0	12	7	2	0	2369	1392	377	1222	602	70
27697009	Application_programming_interface	201711	6	3	0	0	6	2	3	0	2375	1396	380	1224	602	70
27697009	Application_programming_interface	201712	17	6	0	0	12	7	5	0	2392	1407	386	1234	606	74
27697009	Application_programming_interface	201801	3	1	0	0	3	1	1	0	2395	1409	387	1235	606	74
27697009	Application_programming_interface	201802	15	5	0	0	10	7	2	0	2410	1417	392	1246	609	77
27697009	Application_programming_interface	201803	17	6	0	0	11	9	5	0	2427	1425	398	1260	614	81
27697009	Application_programming_interface	201804	8	2	0	0	6	5	2	0	2435	1430	400	1267	618	83
27697009	Application_programming_interface	201805	12	2	0	0	9	4	2	0	2447	1439	402	1271	620	84
27697009	Application_programming_interface	201806	26	4	0	0	16	4	3	0	2473	1452	406	1277	621	84
27697009	Application_programming_interface	201807	9	2	0	0	9	8	2	0	2482	1458	408	1285	624	86
1164	Artificial_intelligence	200112	1	0	0	0	1	1	0	0	1	1	0	1	1	0
1164	Artificial_intelligence	200202	8	0	0	0	7	7	0	0	9	8	0	9	6	0
1164	Artificial_intelligence	200203	5	0	0	0	4	2	0	0	14	12	0	12	7	0
1164	Artificial_intelligence	200204	5	0	0	0	3	1	0	0	19	15	0	15	8	0
1164	Artificial_intelligence	200205	16	0	0	0	7	5	0	0	35	20	0	27	12	0
1164	Artificial_intelligence	200206	1	0	0	0	1	1	0	0	36	20	0	28	12	0
1164	Artificial_intelligence	200207	9	0	0	0	5	2	0	0	45	25	0	30	14	0
1164	Artificial_intelligence	200208	3	0	0	0	2	2	0	0	48	27	0	33	16	0
1164	Artificial_intelligence	200209	5	0	0	0	5	3	0	0	53	32	0	36	19	0
1164	Artificial_intelligence	200210	4	0	0	0	3	2	0	0	57	35	0	39	21	0
1164	Artificial_intelligence	200211	17	0	0	0	7	4	0	0	74	41	0	43	24	0
1164	Artificial_intelligence	200212	4	0	0	0	2	1	0	0	78	43	0	44	25	0
1164	Artificial_intelligence	200301	2	0	0	0	2	1	0	0	80	45	0	45	26	0
1164	Artificial_intelligence	200302	8	0	0	0	7	5	0	0	88	51	0	50	30	0
1164	Artificial_intelligence	200303	1	0	0	0	1	1	0	0	89	52	0	51	31	0
1164	Artificial_intelligence	200304	18	0	0	0	8	7	0	0	107	58	0	68	36	0
1164	Artificial_intelligence	200305	6	0	0	0	5	3	0	0	113	62	0	72	38	0
1164	Artificial_intelligence	200306	7	0	0	0	7	2	0	0	120	69	0	74	40	0
1164	Artificial_intelligence	200307	12	2	0	0	12	8	2	0	132	78	2	82	45	1
1164	Artificial_intelligence	200308	4	0	0	0	3	2	0	0	136	81	2	85	47	1
1164	Artificial_intelligence	200309	20	0	0	0	13	9	0	0	156	92	2	97	54	1
1164	Artificial_intelligence	200310	12	1	0	0	7	2	1	0	168	98	3	102	56	1
1164	Artificial_intelligence	200311	6	0	0	0	5	2	0	0	174	103	3	104	58	1
1164	Artificial_intelligence	200312	17	0	0	0	11	6	0	0	191	113	3	113	63	1
1164	Artificial_intelligence	200401	8	0	0	0	8	5	0	0	199	121	3	118	68	1
1164	Artificial_intelligence	200402	32	0	0	0	10	7	0	0	231	130	3	142	74	1
1164	Artificial_intelligence	200403	49	10	1	0	22	8	6	1	280	148	13	172	78	3
1164	Artificial_intelligence	200404	37	0	0	0	24	16	0	0	317	166	13	198	88	3
1164	Artificial_intelligence	200405	38	5	2	1	20	10	4	2	355	182	18	223	94	4
1164	Artificial_intelligence	200406	28	1	0	0	17	11	1	0	383	194	19	244	100	5
1164	Artificial_intelligence	200407	19	0	0	0	14	7	0	0	402	207	19	254	106	5
1164	Artificial_intelligence	200408	44	7	0	0	31	20	6	0	446	235	26	281	123	5
1164	Artificial_intelligence	200409	23	2	0	0	19	15	2	0	469	253	28	300	137	5
1164	Artificial_intelligence	200410	31	2	0	0	20	11	1	0	500	266	30	313	142	5
1164	Artificial_intelligence	200411	11	0	0	0	7	3	0	0	511	272	30	318	144	5
1164	Artificial_intelligence	200412	34	4	0	0	21	9	3	0	545	289	34	331	150	5
1164	Artificial_intelligence	200501	10	1	0	0	9	6	1	0	555	297	35	337	155	5
1164	Artificial_intelligence	200502	24	5	0	0	17	7	3	0	579	312	40	348	160	5
1164	Artificial_intelligence	200503	15	0	0	0	9	6	0	0	594	320	40	359	165	5
1164	Artificial_intelligence	200504	45	1	0	0	22	10	1	0	639	339	41	384	173	5
1164	Artificial_intelligence	200505	26	1	0	0	21	13	1	0	665	357	42	399	184	6
1164	Artificial_intelligence	200506	81	6	0	0	36	13	4	0	746	387	48	418	192	6
1164	Artificial_intelligence	200507	37	3	0	0	31	12	3	0	783	410	51	435	198	6
1164	Artificial_intelligence	200508	37	5	0	0	30	13	5	0	820	436	56	453	208	6
1164	Artificial_intelligence	200509	49	5	0	0	32	14	5	0	869	463	61	471	217	7
1164	Artificial_intelligence	200510	43	9	0	0	33	17	8	0	912	490	70	492	228	7
1164	Artificial_intelligence	200511	147	9	0	0	43	21	7	0	1059	527	79	604	243	8
1164	Artificial_intelligence	200512	100	5	0	0	35	15	4	0	1159	556	84	673	253	8
1164	Artificial_intelligence	200601	23	3	0	0	20	8	3	0	1182	575	87	682	260	9
1164	Artificial_intelligence	200602	95	25	7	5	51	33	15	3	1277	618	112	729	286	15
1164	Artificial_intelligence	200603	33	4	0	0	25	15	4	0	1310	638	116	748	297	15
1164	Artificial_intelligence	200604	27	6	0	0	20	13	6	0	1337	656	122	767	308	16
1164	Artificial_intelligence	200605	67	15	0	0	34	22	10	0	1404	684	137	810	324	18
1164	Artificial_intelligence	200606	42	8	0	0	27	13	6	0	1446	706	145	832	332	18
1164	Artificial_intelligence	200607	62	7	0	0	40	20	7	0	1508	742	152	857	348	19
1164	Artificial_intelligence	200608	58	13	0	0	44	27	8	0	1566	780	165	894	369	22
1164	Artificial_intelligence	200609	82	18	1	0	50	27	9	1	1648	822	183	944	388	29
1164	Artificial_intelligence	200610	84	22	1	0	53	28	13	1	1732	867	205	985	409	33
1164	Artificial_intelligence	200611	84	19	0	0	58	30	18	0	1816	918	224	1023	433	35
1164	Artificial_intelligence	200612	72	15	0	0	53	26	11	0	1888	965	239	1060	453	37
1164	Artificial_intelligence	200701	45	9	0	0	33	16	7	0	1933	991	248	1082	462	37
1164	Artificial_intelligence	200702	89	20	0	0	60	27	16	0	2022	1040	268	1119	478	40
1164	Artificial_intelligence	200703	88	18	2	1	51	29	10	2	2110	1081	286	1169	497	42
1164	Artificial_intelligence	200704	162	29	5	3	69	33	20	3	2272	1141	315	1265	521	47
1164	Artificial_intelligence	200705	39	2	0	0	26	13	2	0	2311	1163	317	1284	530	47
1164	Artificial_intelligence	200706	69	6	0	0	42	21	5	0	2380	1198	323	1327	544	49
1164	Artificial_intelligence	200707	47	4	0	0	35	19	4	0	2427	1229	327	1355	559	51
1164	Artificial_intelligence	200708	43	5	0	0	33	14	5	0	2470	1258	332	1374	569	51
1164	Artificial_intelligence	200709	52	9	0	0	40	20	9	0	2522	1289	341	1395	582	51
1164	Artificial_intelligence	200710	61	19	0	0	39	22	17	0	2583	1324	360	1428	600	52
1164	Artificial_intelligence	200711	69	13	0	0	38	21	9	0	2652	1356	373	1477	615	54
1164	Artificial_intelligence	200712	105	24	1	0	66	32	22	1	2757	1411	397	1536	637	59
1164	Artificial_intelligence	200801	111	14	0	0	42	20	10	0	2868	1443	411	1612	648	62
1164	Artificial_intelligence	200802	51	8	0	0	33	18	5	0	2919	1469	419	1644	659	64
1164	Artificial_intelligence	200803	109	14	0	0	40	19	11	0	3028	1498	433	1726	667	66
1164	Artificial_intelligence	200804	63	13	0	0	32	16	7	0	3091	1523	446	1770	677	70
1164	Artificial_intelligence	200805	81	19	0	0	48	26	12	0	3172	1561	465	1816	695	73
1164	Artificial_intelligence	200806	52	15	0	0	27	16	9	0	3224	1580	480	1838	703	75
1164	Artificial_intelligence	200807	35	10	0	0	23	9	5	0	3259	1599	490	1856	708	76
1164	Artificial_intelligence	200808	38	11	1	0	24	18	10	1	3297	1618	501	1883	721	80
1164	Artificial_intelligence	200809	81	10	1	0	26	17	9	1	3378	1639	511	1953	733	83
1164	Artificial_intelligence	200810	66	19	0	0	46	24	14	0	3444	1679	530	1990	751	85
1164	Artificial_intelligence	200811	73	9	0	0	29	10	6	0	3517	1707	539	2034	760	85
1164	Artificial_intelligence	200812	51	16	0	0	35	20	14	0	3568	1736	555	2067	774	88
1164	Artificial_intelligence	200901	35	8	0	0	23	15	7	0	3603	1754	563	2092	784	90
1164	Artificial_intelligence	200902	29	5	0	0	20	10	5	0	3632	1768	568	2105	789	90
1164	Artificial_intelligence	200903	52	22	1	0	39	23	16	1	3684	1798	590	2137	803	96
1164	Artificial_intelligence	200904	51	11	1	0	24	15	9	1	3735	1816	601	2177	812	98
1164	Artificial_intelligence	200905	35	8	0	0	28	17	8	0	3770	1837	609	2200	823	99
1164	Artificial_intelligence	200906	76	17	0	0	40	23	11	0	3846	1867	626	2247	837	101
1164	Artificial_intelligence	200907	37	8	0	0	31	21	7	0	3883	1892	634	2274	852	101
1164	Artificial_intelligence	200908	58	2	0	0	24	17	2	0	3941	1910	636	2325	863	102
1164	Artificial_intelligence	200909	99	7	0	0	29	17	6	0	4040	1930	643	2406	872	102
1164	Artificial_intelligence	200910	41	11	0	0	32	13	9	0	4081	1955	654	2427	879	103
1164	Artificial_intelligence	200911	61	12	0	0	35	21	9	0	4142	1981	666	2464	891	103
1164	Artificial_intelligence	200912	34	11	0	0	26	14	8	0	4176	1999	677	2484	897	104
1164	Artificial_intelligence	201001	26	4	0	0	19	13	3	0	4202	2013	681	2503	906	105
1164	Artificial_intelligence	201002	39	8	0	0	31	18	8	0	4241	2038	689	2526	918	105
1164	Artificial_intelligence	201003	45	7	0	0	20	14	5	0	4286	2053	696	2565	927	107
1164	Artificial_intelligence	201004	44	13	0	0	27	16	9	0	4330	2071	709	2595	934	109
1164	Artificial_intelligence	201005	24	7	0	0	17	9	7	0	4354	2083	716	2606	938	110
1164	Artificial_intelligence	201006	29	8	1	0	19	12	5	1	4383	2097	724	2628	945	113
1164	Artificial_intelligence	201007	33	11	0	0	27	12	8	0	4416	2118	735	2643	951	113
1164	Artificial_intelligence	201008	44	15	0	0	32	16	10	0	4460	2143	750	2666	960	115
1164	Artificial_intelligence	201009	23	8	0	0	20	13	8	0	4483	2159	758	2682	969	117
1164	Artificial_intelligence	201010	33	10	0	0	24	11	9	0	4516	2176	768	2697	973	118
1164	Artificial_intelligence	201011	40	10	0	0	26	15	6	0	4556	2193	778	2721	979	119
1164	Artificial_intelligence	201012	16	3	0	0	12	7	2	0	4572	2202	781	2731	983	119
1164	Artificial_intelligence	201101	25	11	1	0	21	12	10	1	4597	2215	792	2744	987	121
1164	Artificial_intelligence	201102	91	7	0	0	19	13	7	0	4688	2229	799	2826	995	125
1164	Artificial_intelligence	201103	77	11	0	0	33	19	8	0	4765	2253	810	2887	1005	126
1164	Artificial_intelligence	201104	46	9	0	0	27	19	7	0	4811	2272	819	2921	1016	127
1164	Artificial_intelligence	201105	27	4	0	0	19	17	4	0	4838	2281	823	2945	1023	131
1164	Artificial_intelligence	201106	28	4	0	0	18	13	4	0	4866	2290	827	2964	1027	131
1164	Artificial_intelligence	201107	21	3	0	0	16	9	3	0	4887	2301	830	2976	1031	132
1164	Artificial_intelligence	201108	16	5	0	0	13	5	3	0	4903	2311	835	2983	1033	133
1164	Artificial_intelligence	201109	32	6	0	0	23	15	3	0	4935	2325	841	3007	1040	134
1164	Artificial_intelligence	201110	24	7	0	0	18	11	6	0	4959	2337	848	3021	1045	136
1164	Artificial_intelligence	201111	14	1	0	0	12	10	1	0	4973	2347	849	3033	1053	136
1164	Artificial_intelligence	201112	63	13	0	0	36	25	11	0	5036	2370	862	3076	1065	139
1164	Artificial_intelligence	201201	25	4	0	0	17	10	4	0	5061	2382	866	3090	1070	140
1164	Artificial_intelligence	201202	43	12	0	0	35	19	11	0	5104	2409	878	3111	1081	140
1164	Artificial_intelligence	201203	25	7	0	0	21	12	6	0	5129	2423	885	3125	1086	141
1164	Artificial_intelligence	201204	22	6	0	0	18	13	5	0	5151	2436	891	3142	1094	143
1164	Artificial_intelligence	201205	38	5	0	0	22	15	4	0	5189	2452	896	3173	1103	145
1164	Artificial_intelligence	201206	32	6	1	0	21	11	4	1	5221	2468	902	3191	1109	146
1164	Artificial_intelligence	201207	12	2	0	0	10	6	2	0	5233	2475	904	3197	1112	146
1164	Artificial_intelligence	201208	17	2	0	0	15	12	2	0	5250	2487	906	3210	1121	147
1164	Artificial_intelligence	201209	20	6	0	0	15	9	5	0	5270	2499	912	3222	1127	150
1164	Artificial_intelligence	201210	27	9	0	0	19	9	5	0	5297	2516	921	3236	1134	150
1164	Artificial_intelligence	201211	8	2	0	0	7	4	1	0	5305	2522	923	3241	1137	150
1164	Artificial_intelligence	201212	15	4	0	0	13	8	3	0	5320	2533	927	3250	1143	151
1164	Artificial_intelligence	201301	24	5	0	0	17	8	4	0	5344	2547	932	3261	1148	151
1164	Artificial_intelligence	201302	23	5	0	0	17	11	4	0	5367	2561	937	3277	1156	154
1164	Artificial_intelligence	201303	61	7	1	0	34	21	6	1	5428	2590	944	3318	1172	155
1164	Artificial_intelligence	201304	22	5	0	0	20	15	5	0	5450	2606	949	3335	1182	156
1164	Artificial_intelligence	201305	37	7	0	0	20	10	3	0	5487	2624	956	3361	1190	156
1164	Artificial_intelligence	201306	20	4	0	0	13	7	4	0	5507	2635	960	3375	1195	156
1164	Artificial_intelligence	201307	30	9	0	0	20	11	7	0	5537	2650	969	3392	1201	157
1164	Artificial_intelligence	201308	16	2	0	0	12	7	2	0	5553	2660	971	3400	1206	157
1164	Artificial_intelligence	201309	10	4	0	0	10	6	4	0	5563	2668	975	3406	1210	158
1164	Artificial_intelligence	201310	33	12	0	0	21	11	9	0	5596	2681	987	3425	1213	159
1164	Artificial_intelligence	201311	18	8	0	0	14	8	6	0	5614	2692	995	3436	1218	160
1164	Artificial_intelligence	201312	21	6	0	0	16	9	5	0	5635	2705	1001	3447	1224	161
1164	Artificial_intelligence	201401	22	4	0	0	18	14	4	0	5657	2714	1005	3465	1229	161
1164	Artificial_intelligence	201402	23	6	0	0	19	12	5	0	5680	2728	1011	3479	1236	162
1164	Artificial_intelligence	201403	28	9	0	0	17	9	6	0	5708	2741	1020	3492	1241	163
1164	Artificial_intelligence	201404	44	8	0	0	22	11	5	0	5752	2757	1028	3516	1247	164
1164	Artificial_intelligence	201405	29	6	0	0	21	12	6	0	5781	2771	1034	3535	1253	164
1164	Artificial_intelligence	201406	35	6	0	0	20	15	5	0	5816	2785	1040	3565	1262	165
1164	Artificial_intelligence	201407	19	6	0	0	17	11	6	0	5835	2798	1046	3577	1269	168
1164	Artificial_intelligence	201408	21	7	0	0	12	8	4	0	5856	2805	1053	3589	1272	168
1164	Artificial_intelligence	201409	28	7	1	0	17	9	5	1	5884	2815	1060	3601	1275	170
1164	Artificial_intelligence	201410	64	23	10	4	29	23	12	3	5948	2835	1083	3655	1288	187
1164	Artificial_intelligence	201411	94	17	4	2	32	23	11	3	6042	2858	1100	3730	1302	198
1164	Artificial_intelligence	201412	72	8	1	1	27	19	8	1	6114	2876	1108	3792	1311	200
1164	Artificial_intelligence	201501	34	5	0	0	24	18	5	0	6148	2893	1113	3819	1322	201
1164	Artificial_intelligence	201502	21	6	0	0	17	12	6	0	6169	2902	1119	3832	1326	201
1164	Artificial_intelligence	201503	18	6	0	0	16	11	6	0	6187	2915	1125	3845	1333	203
1164	Artificial_intelligence	201504	19	4	0	0	13	9	2	0	6206	2924	1129	3859	1337	204
1164	Artificial_intelligence	201505	22	2	0	0	14	12	2	0	6228	2934	1131	3877	1344	205
1164	Artificial_intelligence	201506	21	5	0	0	20	16	4	0	6249	2949	1136	3894	1355	207
1164	Artificial_intelligence	201507	27	10	0	0	23	15	9	0	6276	2965	1146	3912	1361	210
1164	Artificial_intelligence	201508	12	4	0	0	10	6	3	0	6288	2972	1150	3919	1364	210
1164	Artificial_intelligence	201509	17	6	0	0	14	8	5	0	6305	2983	1156	3929	1369	211
1164	Artificial_intelligence	201510	46	14	0	0	29	20	11	0	6351	3004	1170	3962	1381	214
1164	Artificial_intelligence	201511	31	8	0	0	23	15	6	0	6382	3018	1178	3984	1387	215
1164	Artificial_intelligence	201512	15	4	0	0	14	12	4	0	6397	3030	1182	3997	1396	219
1164	Artificial_intelligence	201601	32	14	1	0	21	16	11	1	6429	3045	1196	4021	1406	225
1164	Artificial_intelligence	201602	41	16	0	0	30	18	9	0	6470	3066	1212	4048	1415	229
1164	Artificial_intelligence	201603	35	9	0	0	25	19	9	0	6505	3081	1221	4068	1425	230
1164	Artificial_intelligence	201604	51	15	0	0	34	25	11	0	6556	3104	1236	4109	1438	237
1164	Artificial_intelligence	201605	52	7	0	0	30	21	5	0	6608	3126	1243	4152	1451	238
1164	Artificial_intelligence	201606	55	8	0	0	30	24	8	0	6663	3146	1251	4200	1465	239
1164	Artificial_intelligence	201607	38	11	0	0	28	18	6	0	6701	3164	1262	4228	1473	242
1164	Artificial_intelligence	201608	29	12	3	1	23	16	10	3	6730	3175	1274	4248	1476	248
1164	Artificial_intelligence	201609	32	9	0	0	25	17	7	0	6762	3190	1283	4271	1483	251
1164	Artificial_intelligence	201610	35	11	0	0	24	15	7	0	6797	3207	1294	4292	1490	253
1164	Artificial_intelligence	201611	47	12	0	0	34	25	9	0	6844	3227	1306	4324	1501	255
1164	Artificial_intelligence	201612	66	23	2	1	44	31	18	2	6910	3262	1329	4371	1522	262
1164	Artificial_intelligence	201701	76	18	2	0	48	41	15	1	6986	3288	1347	4439	1536	274
1164	Artificial_intelligence	201702	60	15	0	0	42	28	12	0	7046	3320	1362	4484	1551	281
1164	Artificial_intelligence	201703	82	21	1	0	49	36	14	1	7128	3357	1383	4550	1573	290
1164	Artificial_intelligence	201704	44	13	0	0	30	21	8	0	7172	3376	1396	4583	1582	297
1164	Artificial_intelligence	201705	46	14	0	0	32	21	10	0	7218	3401	1410	4611	1594	299
1164	Artificial_intelligence	201706	45	10	0	0	32	23	10	0	7263	3420	1420	4646	1604	303
1164	Artificial_intelligence	201707	53	10	0	0	31	21	9	0	7316	3437	1430	4685	1609	304
1164	Artificial_intelligence	201708	29	8	0	0	27	19	8	0	7345	3457	1438	4705	1620	308
1164	Artificial_intelligence	201709	61	14	2	1	34	31	12	2	7406	3478	1452	4759	1635	318
1164	Artificial_intelligence	201710	53	11	0	0	29	23	9	0	7459	3498	1463	4801	1646	321
1164	Artificial_intelligence	201711	36	12	0	0	27	18	9	0	7495	3517	1475	4826	1656	327
1164	Artificial_intelligence	201712	57	21	0	0	47	29	14	0	7552	3548	1496	4862	1666	334
1164	Artificial_intelligence	201801	107	31	2	0	68	47	24	2	7659	3592	1527	4941	1685	350
1164	Artificial_intelligence	201802	78	22	0	0	49	42	18	0	7737	3624	1549	5011	1705	366
1164	Artificial_intelligence	201803	71	18	0	0	44	33	12	0	7808	3659	1567	5067	1728	374
1164	Artificial_intelligence	201804	102	19	0	0	56	44	14	0	7910	3697	1586	5152	1753	382
1164	Artificial_intelligence	201805	101	21	0	0	46	34	14	0	8011	3725	1607	5238	1766	392
1164	Artificial_intelligence	201806	75	13	0	0	38	27	10	0	8086	3750	1620	5297	1776	396
1164	Artificial_intelligence	201807	74	24	0	0	56	40	22	0	8160	3796	1644	5351	1802	406
85631	Augmented_reality	200305	1	0	0	0	1	0	0	0	1	1	0	0	0	0
85631	Augmented_reality	200308	10	2	1	0	4	2	2	1	11	5	2	3	2	1
85631	Augmented_reality	200309	1	0	0	0	1	0	0	0	12	6	2	3	2	1
85631	Augmented_reality	200312	2	0	0	0	1	1	0	0	14	7	2	5	3	1
85631	Augmented_reality	200403	3	0	0	0	3	3	0	0	17	10	2	8	6	1
85631	Augmented_reality	200404	1	0	0	0	1	0	0	0	18	11	2	8	6	1
85631	Augmented_reality	200407	2	0	0	0	2	1	0	0	20	13	2	9	7	1
85631	Augmented_reality	200408	6	0	0	0	5	3	0	0	26	18	2	13	10	1
85631	Augmented_reality	200409	5	0	0	0	3	2	0	0	31	21	2	17	12	1
85631	Augmented_reality	200410	3	0	0	0	2	1	0	0	34	23	2	18	13	1
85631	Augmented_reality	200411	1	0	0	0	1	0	0	0	35	24	2	18	13	1
85631	Augmented_reality	200501	2	0	0	0	1	1	0	0	37	25	2	20	14	1
85631	Augmented_reality	200502	6	0	0	0	4	2	0	0	43	29	2	24	16	1
85631	Augmented_reality	200503	2	0	0	0	2	1	0	0	45	31	2	25	17	1
85631	Augmented_reality	200504	3	0	0	0	2	0	0	0	48	33	2	25	17	1
85631	Augmented_reality	200505	6	0	0	0	4	2	0	0	54	36	2	27	19	1
85631	Augmented_reality	200506	4	0	0	0	3	1	0	0	58	39	2	29	20	1
85631	Augmented_reality	200507	2	0	0	0	1	0	0	0	60	40	2	29	20	1
85631	Augmented_reality	200508	7	0	0	0	4	2	0	0	67	44	2	33	22	1
85631	Augmented_reality	200509	2	0	0	0	2	1	0	0	69	46	2	34	23	1
85631	Augmented_reality	200510	7	1	0	0	7	3	1	0	76	53	3	37	26	1
85631	Augmented_reality	200511	5	0	0	0	5	0	0	0	81	58	3	37	26	1
85631	Augmented_reality	200512	4	0	0	0	3	2	0	0	85	61	3	39	28	1
85631	Augmented_reality	200602	5	1	0	0	4	3	1	0	90	64	4	43	30	1
85631	Augmented_reality	200603	9	0	0	0	5	2	0	0	99	68	4	45	32	1
85631	Augmented_reality	200604	10	1	0	0	7	4	1	0	109	75	5	51	36	1
85631	Augmented_reality	200605	13	2	0	0	8	2	2	0	122	83	7	53	38	1
85631	Augmented_reality	200606	8	0	0	0	6	4	0	0	130	88	7	59	41	1
85631	Augmented_reality	200607	5	0	0	0	5	2	0	0	135	93	7	61	43	1
85631	Augmented_reality	200608	6	0	0	0	6	2	0	0	141	99	7	63	45	1
85631	Augmented_reality	200609	7	1	0	0	7	3	1	0	148	106	8	66	48	1
85631	Augmented_reality	200610	12	0	0	0	7	4	0	0	160	112	8	72	51	1
85631	Augmented_reality	200611	16	0	0	0	12	4	0	0	176	124	8	77	55	1
85631	Augmented_reality	200612	16	0	0	0	10	7	0	0	192	131	8	89	61	1
85631	Augmented_reality	200701	3	0	0	0	3	1	0	0	195	134	8	90	62	1
85631	Augmented_reality	200702	20	1	0	0	12	6	1	0	215	146	9	98	68	1
85631	Augmented_reality	200703	1	1	0	0	1	1	1	0	216	147	10	99	69	2
85631	Augmented_reality	200704	20	0	0	0	13	2	0	0	236	160	10	101	71	2
85631	Augmented_reality	200705	8	1	0	0	6	2	1	0	244	166	11	103	73	2
85631	Augmented_reality	200706	16	1	0	0	9	5	1	0	260	173	12	113	76	2
85631	Augmented_reality	200707	3	1	0	0	3	2	1	0	263	176	13	115	78	2
85631	Augmented_reality	200709	10	0	0	0	4	1	0	0	273	179	13	116	79	2
85631	Augmented_reality	200710	26	0	0	0	9	2	0	0	299	187	13	118	81	2
85631	Augmented_reality	200711	8	0	0	0	8	4	0	0	307	195	13	122	85	2
85631	Augmented_reality	200712	10	0	0	0	6	4	0	0	317	200	13	128	88	2
85631	Augmented_reality	200801	6	0	0	0	5	2	0	0	323	205	13	131	90	2
85631	Augmented_reality	200802	8	1	0	0	6	3	1	0	331	211	14	134	93	3
85631	Augmented_reality	200803	19	0	0	0	9	5	0	0	350	218	14	148	98	3
85631	Augmented_reality	200804	2	1	0	0	2	1	1	0	352	219	15	149	98	3
85631	Augmented_reality	200805	12	3	0	0	8	3	1	0	364	225	18	155	99	4
85631	Augmented_reality	200806	6	0	0	0	4	1	0	0	370	229	18	156	100	4
85631	Augmented_reality	200807	3	0	0	0	3	1	0	0	373	232	18	157	101	4
85631	Augmented_reality	200808	5	1	0	0	5	3	1	0	378	237	19	160	104	4
85631	Augmented_reality	200809	41	13	10	5	6	3	3	3	419	242	32	198	106	17
85631	Augmented_reality	200810	12	1	0	0	9	6	1	0	431	250	33	207	111	17
85631	Augmented_reality	200811	6	0	0	0	6	3	0	0	437	256	33	210	114	17
85631	Augmented_reality	200812	24	2	0	0	17	10	2	0	461	270	35	223	121	18
85631	Augmented_reality	200901	8	1	0	0	6	5	1	0	469	274	36	229	124	19
85631	Augmented_reality	200902	10	0	0	0	8	2	0	0	479	282	36	232	126	19
85631	Augmented_reality	200903	21	3	0	0	16	7	1	0	500	294	39	242	130	20
85631	Augmented_reality	200904	31	4	0	0	19	9	3	0	531	308	43	257	136	21
85631	Augmented_reality	200905	20	1	0	0	8	4	1	0	551	314	44	272	138	21
85631	Augmented_reality	200906	24	5	0	0	15	7	1	0	575	328	49	286	144	25
85631	Augmented_reality	200907	56	3	0	0	23	13	2	0	631	350	52	324	156	27
85631	Augmented_reality	200908	24	6	0	0	19	10	2	0	655	365	58	338	163	29
85631	Augmented_reality	200909	50	0	0	0	26	13	0	0	705	387	58	365	173	29
85631	Augmented_reality	200910	65	10	1	0	27	14	4	1	770	410	68	402	183	31
85631	Augmented_reality	200911	79	12	2	0	38	22	6	1	849	441	80	457	198	38
85631	Augmented_reality	200912	93	6	0	0	35	17	5	0	942	469	86	512	208	39
85631	Augmented_reality	201001	52	4	1	0	21	7	4	1	994	487	90	537	212	40
85631	Augmented_reality	201002	31	8	0	0	23	11	4	0	1025	507	98	555	220	43
85631	Augmented_reality	201003	74	8	0	0	25	16	6	0	1099	524	106	605	228	45
85631	Augmented_reality	201004	39	12	4	2	23	10	7	3	1138	543	118	624	234	50
85631	Augmented_reality	201005	41	9	0	0	24	12	4	0	1179	563	127	644	242	52
85631	Augmented_reality	201006	29	6	0	0	18	10	2	0	1208	578	133	663	249	56
85631	Augmented_reality	201007	14	2	0	0	13	9	2	0	1222	587	135	673	254	58
85631	Augmented_reality	201008	19	6	1	0	15	6	6	1	1241	599	141	682	258	58
85631	Augmented_reality	201009	19	1	0	0	13	8	1	0	1260	609	142	695	263	59
85631	Augmented_reality	201010	10	4	0	0	8	5	3	0	1270	615	146	702	267	62
85631	Augmented_reality	201011	24	4	0	0	18	7	3	0	1294	628	150	711	270	62
85631	Augmented_reality	201012	32	10	2	0	20	8	8	2	1326	642	160	724	273	64
85631	Augmented_reality	201101	22	1	0	0	16	10	1	0	1348	651	161	737	278	65
85631	Augmented_reality	201102	49	4	0	0	21	9	3	0	1397	669	165	769	284	66
85631	Augmented_reality	201103	50	4	2	1	21	12	3	2	1447	685	169	804	292	69
85631	Augmented_reality	201104	27	2	0	0	17	9	2	0	1474	698	171	817	298	69
85631	Augmented_reality	201105	30	4	0	0	18	11	3	0	1504	712	175	840	305	70
85631	Augmented_reality	201106	28	6	0	0	20	11	4	0	1532	726	181	856	311	72
85631	Augmented_reality	201107	12	1	0	0	10	8	1	0	1544	734	182	864	317	72
85631	Augmented_reality	201108	34	11	1	0	23	11	6	1	1578	752	193	884	323	74
85631	Augmented_reality	201109	6	1	0	0	6	3	1	0	1584	758	194	887	326	74
85631	Augmented_reality	201110	12	3	0	0	9	5	2	0	1596	764	197	893	328	74
85631	Augmented_reality	201111	9	0	0	0	8	5	0	0	1605	769	197	899	330	74
85631	Augmented_reality	201112	45	7	0	0	27	16	5	0	1650	791	204	928	342	74
85631	Augmented_reality	201201	37	6	0	0	21	9	4	0	1687	807	210	941	347	75
85631	Augmented_reality	201202	23	1	0	0	12	8	1	0	1710	816	211	959	352	75
85631	Augmented_reality	201203	33	1	0	0	15	8	1	0	1743	828	212	977	358	76
85631	Augmented_reality	201204	15	3	0	0	13	7	3	0	1758	837	215	984	362	76
85631	Augmented_reality	201205	44	5	0	0	28	15	4	0	1802	858	220	1003	371	78
85631	Augmented_reality	201206	21	4	0	0	13	7	4	0	1823	866	224	1017	374	79
85631	Augmented_reality	201207	23	2	0	0	10	7	2	0	1846	873	226	1034	378	79
85631	Augmented_reality	201208	46	5	0	0	25	16	4	0	1892	891	231	1064	388	80
85631	Augmented_reality	201209	24	0	0	0	14	10	0	0	1916	903	231	1083	396	80
85631	Augmented_reality	201210	27	7	0	0	15	9	5	0	1943	914	238	1095	401	80
85631	Augmented_reality	201211	86	2	0	0	10	5	2	0	2029	921	240	1176	403	80
85631	Augmented_reality	201212	47	7	0	0	19	12	3	0	2076	936	247	1214	411	84
85631	Augmented_reality	201301	27	3	0	0	19	13	2	0	2103	947	250	1232	418	87
85631	Augmented_reality	201302	10	0	0	0	8	5	0	0	2113	951	250	1238	420	87
85631	Augmented_reality	201303	17	3	0	0	13	9	3	0	2130	961	253	1251	427	88
85631	Augmented_reality	201304	34	0	0	0	10	8	0	0	2164	968	253	1278	433	88
85631	Augmented_reality	201305	16	2	0	0	10	8	2	0	2180	971	255	1291	435	88
85631	Augmented_reality	201306	33	6	0	0	19	11	6	0	2213	987	261	1305	444	90
85631	Augmented_reality	201307	61	19	3	2	22	14	8	2	2274	1003	280	1332	453	91
85631	Augmented_reality	201308	7	1	0	0	7	6	1	0	2281	1008	281	1338	457	91
85631	Augmented_reality	201309	6	2	0	0	3	2	1	0	2287	1010	283	1342	459	93
85631	Augmented_reality	201310	4	0	0	0	3	3	0	0	2291	1013	283	1346	462	93
85631	Augmented_reality	201311	13	3	0	0	6	5	2	0	2304	1017	286	1357	465	96
85631	Augmented_reality	201312	11	1	0	0	6	4	1	0	2315	1022	287	1366	468	96
85631	Augmented_reality	201401	11	3	0	0	8	4	2	0	2326	1030	290	1371	472	96
85631	Augmented_reality	201402	10	0	0	0	8	5	0	0	2336	1038	290	1376	477	96
85631	Augmented_reality	201403	11	1	0	0	10	5	1	0	2347	1044	291	1382	478	96
85631	Augmented_reality	201404	17	2	0	0	11	4	2	0	2364	1053	293	1387	480	96
85631	Augmented_reality	201405	18	2	0	0	8	4	2	0	2382	1061	295	1401	483	96
85631	Augmented_reality	201406	7	0	0	0	6	5	0	0	2389	1067	295	1407	488	96
85631	Augmented_reality	201407	6	1	0	0	6	5	1	0	2395	1072	296	1412	492	97
85631	Augmented_reality	201408	12	0	0	0	4	2	0	0	2407	1075	296	1422	493	97
85631	Augmented_reality	201409	5	0	0	0	4	3	0	0	2412	1078	296	1425	495	97
85631	Augmented_reality	201410	10	2	0	0	8	5	2	0	2422	1084	298	1430	497	98
85631	Augmented_reality	201411	14	2	0	0	8	5	2	0	2436	1091	300	1440	501	99
85631	Augmented_reality	201412	17	2	0	0	9	7	2	0	2453	1094	302	1454	502	99
85631	Augmented_reality	201501	8	0	0	0	4	3	0	0	2461	1097	302	1461	504	99
85631	Augmented_reality	201502	19	1	0	0	12	8	1	0	2480	1107	303	1474	510	100
85631	Augmented_reality	201503	15	1	0	0	12	8	1	0	2495	1117	304	1485	515	100
85631	Augmented_reality	201504	22	0	0	0	8	6	0	0	2517	1124	304	1504	520	100
85631	Augmented_reality	201505	4	1	0	0	3	1	1	0	2521	1127	305	1505	521	100
85631	Augmented_reality	201506	9	1	0	0	6	6	1	0	2530	1133	306	1514	526	101
85631	Augmented_reality	201507	5	0	0	0	4	2	0	0	2535	1137	306	1517	528	101
85631	Augmented_reality	201508	14	1	0	0	9	9	1	0	2549	1145	307	1531	534	102
85631	Augmented_reality	201509	12	0	0	0	9	8	0	0	2561	1148	307	1541	536	102
85631	Augmented_reality	201510	7	2	0	0	6	6	2	0	2568	1152	309	1548	540	104
85631	Augmented_reality	201511	31	6	0	0	17	10	3	0	2599	1165	315	1562	545	105
85631	Augmented_reality	201512	9	0	0	0	6	5	0	0	2608	1170	315	1569	549	105
85631	Augmented_reality	201602	2	0	0	0	1	1	0	0	2610	1170	315	1571	549	105
85631	Augmented_reality	201603	21	4	0	0	15	12	4	0	2631	1182	319	1588	558	107
85631	Augmented_reality	201604	2	1	0	0	2	1	1	0	2633	1183	320	1589	558	107
85631	Augmented_reality	201605	8	0	0	0	3	2	0	0	2641	1186	320	1591	560	107
85631	Augmented_reality	201606	5	1	0	0	5	3	1	0	2646	1189	321	1594	561	107
85631	Augmented_reality	201607	7	0	0	0	6	4	0	0	2653	1195	321	1598	565	107
85631	Augmented_reality	201608	41	4	0	0	26	17	4	0	2694	1216	325	1627	576	108
85631	Augmented_reality	201609	17	3	0	0	14	10	3	0	2711	1227	328	1640	583	109
85631	Augmented_reality	201610	19	2	0	0	12	9	2	0	2730	1235	330	1656	587	110
85631	Augmented_reality	201611	20	3	0	0	13	7	2	0	2750	1244	333	1666	590	110
85631	Augmented_reality	201612	11	3	1	0	10	7	3	1	2761	1251	336	1674	594	112
85631	Augmented_reality	201701	24	4	0	0	16	13	4	0	2785	1262	340	1695	600	114
85631	Augmented_reality	201702	16	3	0	0	14	10	3	0	2801	1271	343	1707	605	116
85631	Augmented_reality	201703	11	1	0	0	10	9	1	0	2812	1279	344	1717	611	117
85631	Augmented_reality	201704	25	3	0	0	19	13	3	0	2837	1294	347	1733	618	119
85631	Augmented_reality	201705	15	1	0	0	13	9	1	0	2852	1303	348	1743	621	119
85631	Augmented_reality	201706	37	6	0	0	23	14	4	0	2889	1323	354	1764	631	120
85631	Augmented_reality	201707	19	2	0	0	14	11	2	0	2908	1333	356	1775	638	121
85631	Augmented_reality	201708	39	11	2	1	16	13	6	2	2947	1344	367	1803	646	124
85631	Augmented_reality	201709	25	1	0	0	12	10	1	0	2972	1351	368	1815	651	124
85631	Augmented_reality	201710	7	0	0	0	6	5	0	0	2979	1355	368	1821	653	124
85631	Augmented_reality	201711	21	2	0	0	16	14	2	0	3000	1369	370	1839	664	125
85631	Augmented_reality	201712	6	1	0	0	5	2	1	0	3006	1374	371	1842	666	125
85631	Augmented_reality	201801	13	1	0	0	5	3	1	0	3019	1378	372	1850	668	125
85631	Augmented_reality	201802	22	2	0	0	15	10	1	0	3041	1389	374	1866	674	126
85631	Augmented_reality	201803	9	0	0	0	8	6	0	0	3050	1395	374	1873	678	126
85631	Augmented_reality	201804	43	4	0	0	26	23	3	0	3093	1417	378	1913	696	130
85631	Augmented_reality	201805	18	4	0	0	15	12	3	0	3111	1430	382	1927	704	133
85631	Augmented_reality	201806	15	1	0	0	9	7	1	0	3126	1437	383	1940	709	134
85631	Augmented_reality	201807	22	1	0	0	16	10	1	0	3148	1449	384	1953	715	134
47967	Authentication	200207	1	0	0	0	1	0	0	0	1	1	0	0	0	0
47967	Authentication	200208	4	0	0	0	2	1	0	0	5	3	0	2	1	0
47967	Authentication	200209	1	0	0	0	1	0	0	0	6	4	0	2	1	0
47967	Authentication	200210	1	0	0	0	1	0	0	0	7	5	0	2	1	0
47967	Authentication	200211	1	0	0	0	1	0	0	0	8	6	0	2	1	0
47967	Authentication	200302	5	0	0	0	3	0	0	0	13	9	0	2	1	0
47967	Authentication	200308	3	0	0	0	3	2	0	0	16	12	0	4	3	0
47967	Authentication	200309	1	0	0	0	1	1	0	0	17	13	0	5	4	0
47967	Authentication	200311	1	0	0	0	1	1	0	0	18	14	0	6	5	0
47967	Authentication	200312	5	0	0	0	3	3	0	0	23	16	0	11	7	0
47967	Authentication	200403	1	0	0	0	1	1	0	0	24	17	0	12	8	0
47967	Authentication	200405	3	0	0	0	3	2	0	0	27	20	0	14	10	0
47967	Authentication	200406	3	0	0	0	3	2	0	0	30	23	0	16	12	0
47967	Authentication	200407	2	0	0	0	2	1	0	0	32	24	0	17	12	0
47967	Authentication	200408	3	0	0	0	2	2	0	0	35	25	0	20	13	0
47967	Authentication	200410	1	0	0	0	1	1	0	0	36	25	0	21	13	0
47967	Authentication	200411	2	0	0	0	2	0	0	0	38	27	0	21	13	0
47967	Authentication	200412	5	0	0	0	4	2	0	0	43	30	0	24	15	0
47967	Authentication	200501	3	0	0	0	2	2	0	0	46	31	0	27	16	0
47967	Authentication	200503	4	0	0	0	3	2	0	0	50	34	0	29	18	0
47967	Authentication	200504	2	0	0	0	2	1	0	0	52	35	0	30	18	0
47967	Authentication	200505	3	0	0	0	2	0	0	0	55	37	0	30	18	0
47967	Authentication	200506	7	0	0	0	5	3	0	0	62	42	0	34	21	0
47967	Authentication	200507	5	1	0	0	4	2	1	0	67	45	1	36	22	0
47967	Authentication	200508	4	0	0	0	3	2	0	0	71	48	1	38	24	0
47967	Authentication	200509	8	1	0	0	8	6	1	0	79	54	2	44	28	0
47967	Authentication	200510	7	0	0	0	6	3	0	0	86	58	2	47	29	0
47967	Authentication	200511	7	0	0	0	7	2	0	0	93	65	2	49	31	0
47967	Authentication	200512	2	0	0	0	2	1	0	0	95	67	2	50	32	0
47967	Authentication	200601	5	0	0	0	5	4	0	0	100	70	2	54	34	0
47967	Authentication	200602	20	10	4	0	11	3	5	1	120	80	12	63	36	3
47967	Authentication	200603	14	6	1	0	11	4	5	1	134	89	18	69	38	5
47967	Authentication	200604	3	0	0	0	3	2	0	0	137	92	18	71	40	5
47967	Authentication	200605	10	1	0	0	7	6	1	0	147	98	19	78	45	5
47967	Authentication	200606	7	1	0	0	5	4	1	0	154	102	20	83	48	6
47967	Authentication	200607	10	1	0	0	8	5	1	0	164	108	21	90	51	6
47967	Authentication	200608	7	0	0	0	7	6	0	0	171	115	21	96	57	6
47967	Authentication	200609	7	1	0	0	5	2	1	0	178	119	22	98	58	6
47967	Authentication	200610	4	1	0	0	4	3	1	0	182	123	23	101	61	6
47967	Authentication	200611	8	2	0	0	8	6	2	0	190	130	25	107	66	7
47967	Authentication	200612	12	1	0	0	9	4	1	0	202	137	26	113	68	7
47967	Authentication	200701	13	2	0	0	10	4	2	0	215	147	28	117	72	7
47967	Authentication	200702	4	0	0	0	3	1	0	0	219	150	28	118	73	7
47967	Authentication	200703	2	0	0	0	2	1	0	0	221	152	28	119	74	7
47967	Authentication	200704	7	0	0	0	7	4	0	0	228	159	28	123	78	7
47967	Authentication	200705	12	0	0	0	8	4	0	0	240	167	28	130	82	7
47967	Authentication	200706	5	1	0	0	5	3	1	0	245	172	29	133	85	7
47967	Authentication	200707	3	0	0	0	3	2	0	0	248	175	29	135	87	7
47967	Authentication	200708	8	0	0	0	7	3	0	0	256	182	29	138	90	7
47967	Authentication	200709	5	1	0	0	5	1	1	0	261	187	30	139	91	7
47967	Authentication	200710	12	3	0	0	11	4	3	0	273	196	33	144	93	7
47967	Authentication	200711	19	1	0	0	9	5	1	0	292	204	34	152	97	7
47967	Authentication	200712	5	0	0	0	4	3	0	0	297	208	34	156	100	7
47967	Authentication	200801	2	0	0	0	2	0	0	0	299	210	34	156	100	7
47967	Authentication	200802	4	0	0	0	3	3	0	0	303	212	34	160	102	7
47967	Authentication	200803	3	1	0	0	3	2	1	0	306	215	35	162	104	7
47967	Authentication	200804	5	1	0	0	4	1	1	0	311	219	36	163	105	7
47967	Authentication	200805	21	0	0	0	5	2	0	0	332	224	36	180	107	7
47967	Authentication	200806	11	2	0	0	7	3	2	0	343	229	38	187	108	7
47967	Authentication	200807	5	1	0	0	5	4	1	0	348	233	39	191	111	7
47967	Authentication	200808	11	3	0	0	9	5	3	0	359	242	42	196	116	8
47967	Authentication	200810	4	0	0	0	3	2	0	0	363	244	42	198	117	8
47967	Authentication	200811	10	2	0	0	7	3	2	0	373	249	44	201	118	8
47967	Authentication	200812	11	2	0	0	7	5	2	0	384	255	46	209	122	8
47967	Authentication	200901	12	3	0	0	10	7	3	0	396	264	49	218	128	8
47967	Authentication	200902	14	3	0	0	11	5	2	0	410	275	52	224	133	9
47967	Authentication	200903	8	0	0	0	7	5	0	0	418	280	52	229	136	9
47967	Authentication	200905	3	0	0	0	2	1	0	0	421	282	52	231	137	9
47967	Authentication	200906	2	0	0	0	2	2	0	0	423	283	52	233	138	9
47967	Authentication	200908	2	0	0	0	2	1	0	0	425	285	52	234	139	9
47967	Authentication	200909	12	2	0	0	8	5	2	0	437	291	54	243	142	10
47967	Authentication	200910	14	0	0	0	11	7	0	0	451	300	54	250	147	10
47967	Authentication	200911	8	0	0	0	7	4	0	0	459	304	54	255	149	10
47967	Authentication	200912	2	0	0	0	2	2	0	0	461	306	54	257	151	10
47967	Authentication	201001	7	1	0	0	5	4	1	0	468	311	55	263	155	10
47967	Authentication	201002	3	0	0	0	3	2	0	0	471	313	55	265	156	10
47967	Authentication	201003	3	0	0	0	3	3	0	0	474	315	55	268	158	10
47967	Authentication	201004	8	3	0	0	6	4	2	0	482	320	58	273	161	10
47967	Authentication	201005	7	1	0	0	5	4	1	0	489	324	59	279	164	10
47967	Authentication	201006	7	0	0	0	4	4	0	0	496	328	59	286	168	10
47967	Authentication	201007	13	4	0	0	9	6	3	0	509	336	63	295	173	12
47967	Authentication	201008	7	2	0	0	5	2	1	0	516	341	65	298	175	12
47967	Authentication	201009	8	2	0	0	5	4	2	0	524	345	67	305	178	13
47967	Authentication	201010	20	6	0	0	10	6	3	0	544	350	73	318	180	14
47967	Authentication	201012	4	1	0	0	4	3	1	0	548	354	74	321	183	14
47967	Authentication	201101	2	0	0	0	2	2	0	0	550	356	74	323	185	14
47967	Authentication	201102	2	0	0	0	2	1	0	0	552	358	74	324	186	14
47967	Authentication	201103	11	2	0	0	9	7	2	0	563	362	76	333	188	14
47967	Authentication	201104	4	0	0	0	4	4	0	0	567	364	76	337	190	14
47967	Authentication	201105	5	2	0	0	5	3	2	0	572	368	78	340	192	14
47967	Authentication	201106	9	2	0	0	7	7	2	0	581	375	80	349	199	16
47967	Authentication	201107	7	1	0	0	6	5	1	0	588	378	81	354	201	16
47967	Authentication	201108	8	3	0	0	5	3	2	0	596	383	84	358	204	17
47967	Authentication	201109	1	0	0	0	1	1	0	0	597	384	84	359	205	17
47967	Authentication	201110	1	0	0	0	1	1	0	0	598	385	84	360	206	17
47967	Authentication	201111	3	1	0	0	3	2	1	0	601	388	85	362	208	17
47967	Authentication	201112	1	0	0	0	1	1	0	0	602	388	85	363	208	17
47967	Authentication	201201	1	0	0	0	1	0	0	0	603	389	85	363	208	17
47967	Authentication	201202	5	1	0	0	4	2	1	0	608	391	86	365	208	17
47967	Authentication	201203	2	1	0	0	2	1	1	0	610	392	87	366	208	17
47967	Authentication	201204	2	0	0	0	2	2	0	0	612	393	87	368	209	17
47967	Authentication	201205	1	0	0	0	1	1	0	0	613	394	87	369	210	17
47967	Authentication	201206	4	0	0	0	1	0	0	0	617	395	87	369	210	17
47967	Authentication	201208	1	0	0	0	1	1	0	0	618	395	87	370	210	17
47967	Authentication	201209	26	0	0	0	2	1	0	0	644	397	87	395	211	17
47967	Authentication	201210	3	0	0	0	2	2	0	0	647	399	87	398	213	17
47967	Authentication	201211	1	0	0	0	1	1	0	0	648	399	87	399	213	17
47967	Authentication	201212	4	1	0	0	4	3	1	0	652	402	88	402	215	17
47967	Authentication	201301	7	1	0	0	4	3	1	0	659	405	89	407	217	18
47967	Authentication	201302	2	0	0	0	2	2	0	0	661	407	89	409	219	18
47967	Authentication	201303	5	1	0	0	4	2	1	0	666	411	90	411	221	18
47967	Authentication	201304	7	1	0	0	4	2	1	0	673	415	91	413	223	19
47967	Authentication	201307	7	2	0	0	7	5	2	0	680	419	93	418	225	19
47967	Authentication	201308	3	0	0	0	2	1	0	0	683	421	93	420	226	19
47967	Authentication	201309	4	2	0	0	4	2	2	0	687	424	95	422	227	19
47967	Authentication	201310	10	4	0	0	8	5	4	0	697	430	99	427	230	19
47967	Authentication	201311	2	0	0	0	2	1	0	0	699	432	99	428	231	19
47967	Authentication	201401	2	1	0	0	2	2	1	0	701	434	100	430	233	20
47967	Authentication	201402	5	0	0	0	3	3	0	0	706	437	100	435	236	20
47967	Authentication	201403	5	1	0	0	4	2	1	0	711	440	101	437	237	20
47967	Authentication	201404	10	1	0	0	6	5	1	0	721	445	102	446	241	20
47967	Authentication	201405	3	0	0	0	2	1	0	0	724	446	102	448	241	20
47967	Authentication	201406	9	1	0	0	7	3	1	0	733	452	103	452	243	20
47967	Authentication	201407	2	0	0	0	1	1	0	0	735	453	103	454	244	20
47967	Authentication	201409	7	2	0	0	5	4	2	0	742	457	105	459	247	21
47967	Authentication	201411	12	3	0	0	7	5	1	0	754	462	108	467	250	23
47967	Authentication	201501	11	0	0	0	5	5	0	0	765	464	108	478	252	23
47967	Authentication	201503	2	0	0	0	1	0	0	0	767	465	108	478	252	23
47967	Authentication	201504	1	0	0	0	1	1	0	0	768	466	108	479	253	23
47967	Authentication	201505	12	4	0	0	9	5	4	0	780	472	112	484	255	23
47967	Authentication	201506	6	2	0	0	3	1	1	0	786	474	114	486	255	23
47967	Authentication	201507	7	2	0	0	5	3	2	0	793	478	116	491	257	23
47967	Authentication	201508	7	0	0	0	4	3	0	0	800	480	116	496	258	23
47967	Authentication	201509	16	4	0	0	4	3	3	0	816	484	120	500	261	23
47967	Authentication	201510	2	1	0	0	1	0	1	0	818	485	121	500	261	23
47967	Authentication	201511	1	0	0	0	1	1	0	0	819	486	121	501	262	23
47967	Authentication	201512	10	3	0	0	6	4	3	0	829	491	124	505	265	23
47967	Authentication	201601	11	0	0	0	1	1	0	0	840	492	124	516	266	23
47967	Authentication	201602	2	0	0	0	2	2	0	0	842	493	124	518	267	23
47967	Authentication	201603	2	1	0	0	2	1	1	0	844	494	125	519	267	23
47967	Authentication	201604	1	0	0	0	1	1	0	0	845	495	125	520	268	23
47967	Authentication	201605	5	1	0	0	4	4	1	0	850	499	126	525	271	24
47967	Authentication	201606	3	0	0	0	3	2	0	0	853	501	126	527	272	24
47967	Authentication	201608	7	0	0	0	4	4	0	0	860	504	126	534	275	24
47967	Authentication	201610	16	0	0	0	3	3	0	0	876	506	126	550	277	24
47967	Authentication	201611	3	0	0	0	3	2	0	0	879	508	126	552	277	24
47967	Authentication	201612	6	3	0	0	6	4	3	0	885	513	129	556	279	25
47967	Authentication	201701	5	1	0	0	3	2	1	0	890	515	130	560	280	25
47967	Authentication	201702	2	1	0	0	2	1	1	0	892	517	131	561	281	25
47967	Authentication	201703	9	1	0	0	8	6	1	0	901	523	132	568	285	26
47967	Authentication	201704	6	1	0	0	6	5	1	0	907	529	133	573	289	27
47967	Authentication	201705	3	0	0	0	3	2	0	0	910	532	133	575	291	27
47967	Authentication	201706	4	1	0	0	4	3	1	0	914	536	134	578	294	27
47967	Authentication	201707	3	1	0	0	3	3	1	0	917	539	135	581	297	28
47967	Authentication	201708	10	2	0	0	6	4	1	0	927	544	137	587	300	29
47967	Authentication	201710	3	1	0	0	3	2	1	0	930	547	138	589	302	29
47967	Authentication	201711	3	1	0	0	3	3	1	0	933	550	139	592	305	30
47967	Authentication	201712	4	0	0	0	3	2	0	0	937	553	139	595	306	30
47967	Authentication	201801	4	1	0	0	3	2	1	0	941	555	140	598	306	31
47967	Authentication	201802	4	1	0	0	4	3	1	0	945	559	141	601	308	32
47967	Authentication	201803	2	0	0	0	2	2	0	0	947	561	141	603	310	32
47967	Authentication	201804	2	1	0	0	2	2	1	0	949	562	142	605	311	33
47967	Authentication	201806	3	1	0	0	3	2	1	0	952	564	143	607	312	33
47967	Authentication	201807	2	1	0	0	2	2	1	0	954	566	144	609	313	34
2884728	Automated_reasoning	200511	3	0	0	0	3	2	0	0	3	3	0	2	2	0
2884728	Automated_reasoning	200512	1	0	0	0	1	0	0	0	4	4	0	2	2	0
2884728	Automated_reasoning	200601	5	0	0	0	3	3	0	0	9	7	0	7	5	0
2884728	Automated_reasoning	200603	5	2	0	0	4	3	2	0	14	10	2	11	7	1
2884728	Automated_reasoning	200604	4	0	0	0	3	2	0	0	18	12	2	14	8	1
2884728	Automated_reasoning	200606	1	0	0	0	1	1	0	0	19	13	2	15	9	1
2884728	Automated_reasoning	200607	1	0	0	0	1	1	0	0	20	14	2	16	10	1
2884728	Automated_reasoning	200612	1	0	0	0	1	1	0	0	21	15	2	17	11	1
2884728	Automated_reasoning	200702	3	0	0	0	2	1	0	0	24	17	2	19	12	1
2884728	Automated_reasoning	200705	1	0	0	0	1	1	0	0	25	18	2	20	13	1
2884728	Automated_reasoning	200706	1	0	0	0	1	1	0	0	26	19	2	21	14	1
2884728	Automated_reasoning	200711	4	1	0	0	4	2	1	0	30	22	3	23	15	1
2884728	Automated_reasoning	200803	1	0	0	0	1	1	0	0	31	23	3	24	16	1
2884728	Automated_reasoning	200806	1	0	0	0	1	1	0	0	32	24	3	25	17	1
2884728	Automated_reasoning	200809	1	0	0	0	1	1	0	0	33	25	3	26	18	1
2884728	Automated_reasoning	200810	1	0	0	0	1	1	0	0	34	26	3	27	19	1
2884728	Automated_reasoning	200901	3	0	0	0	3	2	0	0	37	29	3	29	21	1
2884728	Automated_reasoning	200902	1	0	0	0	1	1	0	0	38	30	3	30	22	1
2884728	Automated_reasoning	200903	2	0	0	0	1	1	0	0	40	30	3	32	22	1
2884728	Automated_reasoning	200905	7	2	0	0	6	3	2	0	47	36	5	35	25	1
2884728	Automated_reasoning	200912	1	0	0	0	1	1	0	0	48	37	5	36	26	1
2884728	Automated_reasoning	201001	1	0	0	0	1	1	0	0	49	38	5	37	27	1
2884728	Automated_reasoning	201003	1	0	0	0	1	0	0	0	50	39	5	37	27	1
2884728	Automated_reasoning	201005	2	0	0	0	1	1	0	0	52	40	5	39	28	1
2884728	Automated_reasoning	201010	1	0	0	0	1	1	0	0	53	41	5	40	29	1
2884728	Automated_reasoning	201011	25	0	0	0	4	4	0	0	78	44	5	65	32	1
2884728	Automated_reasoning	201012	9	0	0	0	2	2	0	0	87	45	5	74	33	1
2884728	Automated_reasoning	201101	2	0	0	0	2	1	0	0	89	47	5	75	34	1
2884728	Automated_reasoning	201102	1	0	0	0	1	0	0	0	90	48	5	75	34	1
2884728	Automated_reasoning	201103	2	0	0	0	2	2	0	0	92	50	5	77	36	1
2884728	Automated_reasoning	201105	1	0	0	0	1	1	0	0	93	51	5	78	37	1
2884728	Automated_reasoning	201106	1	0	0	0	1	1	0	0	94	52	5	79	38	1
2884728	Automated_reasoning	201108	1	0	0	0	1	1	0	0	95	53	5	80	39	1
2884728	Automated_reasoning	201109	2	0	0	0	2	2	0	0	97	55	5	82	41	1
2884728	Automated_reasoning	201110	1	0	0	0	1	1	0	0	98	56	5	83	42	1
2884728	Automated_reasoning	201201	2	0	0	0	2	1	0	0	100	58	5	84	43	1
2884728	Automated_reasoning	201203	1	0	0	0	1	1	0	0	101	59	5	85	44	1
2884728	Automated_reasoning	201204	1	0	0	0	1	0	0	0	102	60	5	85	44	1
2884728	Automated_reasoning	201205	3	0	0	0	2	1	0	0	105	62	5	87	45	1
2884728	Automated_reasoning	201206	1	0	0	0	1	1	0	0	106	63	5	88	46	1
2884728	Automated_reasoning	201208	1	0	0	0	1	0	0	0	107	64	5	88	46	1
2884728	Automated_reasoning	201209	1	0	0	0	1	1	0	0	108	65	5	89	47	1
2884728	Automated_reasoning	201210	1	0	0	0	1	1	0	0	109	65	5	90	47	1
2884728	Automated_reasoning	201302	6	0	0	0	1	1	0	0	115	66	5	96	48	1
2884728	Automated_reasoning	201303	1	0	0	0	1	1	0	0	116	67	5	97	49	1
2884728	Automated_reasoning	201304	1	0	0	0	1	0	0	0	117	68	5	97	49	1
2884728	Automated_reasoning	201305	3	1	0	0	2	1	1	0	120	70	6	99	50	1
2884728	Automated_reasoning	201306	4	0	0	0	3	2	0	0	124	73	6	102	52	1
2884728	Automated_reasoning	201309	2	1	0	0	2	1	1	0	126	75	7	103	53	1
2884728	Automated_reasoning	201310	1	0	0	0	1	1	0	0	127	76	7	104	54	1
2884728	Automated_reasoning	201311	1	0	0	0	1	1	0	0	128	77	7	105	55	1
2884728	Automated_reasoning	201403	1	0	0	0	1	1	0	0	129	78	7	106	56	1
2884728	Automated_reasoning	201405	2	0	0	0	2	1	0	0	131	80	7	107	57	1
2884728	Automated_reasoning	201406	1	0	0	0	1	1	0	0	132	81	7	108	58	1
2884728	Automated_reasoning	201501	1	0	0	0	1	0	0	0	133	82	7	108	58	1
2884728	Automated_reasoning	201502	4	0	0	0	2	1	0	0	137	83	7	109	58	1
2884728	Automated_reasoning	201503	2	0	0	0	1	1	0	0	139	84	7	111	59	1
2884728	Automated_reasoning	201506	2	0	0	0	1	0	0	0	141	85	7	111	59	1
2884728	Automated_reasoning	201512	4	0	0	0	2	2	0	0	145	87	7	115	61	1
2884728	Automated_reasoning	201601	3	0	0	0	3	3	0	0	148	90	7	118	64	1
2884728	Automated_reasoning	201603	1	0	0	0	1	0	0	0	149	91	7	118	64	1
2884728	Automated_reasoning	201606	5	0	0	0	1	1	0	0	154	92	7	123	65	1
2884728	Automated_reasoning	201607	2	0	0	0	2	1	0	0	156	93	7	124	65	1
2884728	Automated_reasoning	201609	1	0	0	0	1	0	0	0	157	94	7	124	65	1
2884728	Automated_reasoning	201610	1	0	0	0	1	1	0	0	158	95	7	125	66	1
2884728	Automated_reasoning	201706	1	0	0	0	1	1	0	0	159	96	7	126	67	1
2884728	Automated_reasoning	201707	8	2	0	0	3	2	2	0	167	99	9	128	69	1
2884728	Automated_reasoning	201709	1	0	0	0	1	1	0	0	168	99	9	129	69	1
2884728	Automated_reasoning	201711	2	0	0	0	1	1	0	0	170	99	9	131	69	1
2884728	Automated_reasoning	201803	2	0	0	0	2	1	0	0	172	100	9	132	69	1
2884728	Automated_reasoning	201804	5	0	0	0	1	1	0	0	177	100	9	137	69	1
2884728	Automated_reasoning	201805	1	0	0	0	1	1	0	0	178	101	9	138	70	1
2884728	Automated_reasoning	201807	1	0	0	0	1	1	0	0	179	101	9	139	70	1
173354	Automation	200302	2	0	0	0	2	1	0	0	2	2	0	1	1	0
173354	Automation	200310	1	0	0	0	1	1	0	0	3	3	0	2	2	0
173354	Automation	200312	11	3	0	0	4	3	2	0	14	7	3	7	5	1
173354	Automation	200401	2	0	0	0	2	1	0	0	16	9	3	8	6	1
173354	Automation	200403	4	0	0	0	3	2	0	0	20	10	3	10	6	1
173354	Automation	200404	2	0	0	0	2	2	0	0	22	12	3	12	8	1
173354	Automation	200406	1	0	0	0	1	0	0	0	23	13	3	12	8	1
173354	Automation	200408	4	0	0	0	1	0	0	0	27	14	3	12	8	1
173354	Automation	200409	3	0	0	0	3	3	0	0	30	17	3	15	11	1
173354	Automation	200410	2	0	0	0	2	2	0	0	32	19	3	17	13	1
173354	Automation	200411	1	0	0	0	1	0	0	0	33	20	3	17	13	1
173354	Automation	200412	3	0	0	0	3	1	0	0	36	23	3	18	14	1
173354	Automation	200501	1	0	0	0	1	1	0	0	37	24	3	19	15	1
173354	Automation	200504	2	0	0	0	2	1	0	0	39	26	3	20	16	1
173354	Automation	200506	4	0	0	0	3	1	0	0	43	29	3	21	17	1
173354	Automation	200508	11	0	0	0	4	4	0	0	54	33	3	32	21	1
173354	Automation	200509	15	0	0	0	8	5	0	0	69	41	3	38	26	1
173354	Automation	200510	6	0	0	0	6	4	0	0	75	45	3	42	28	1
173354	Automation	200511	2	0	0	0	2	0	0	0	77	47	3	42	28	1
173354	Automation	200512	6	0	0	0	5	0	0	0	83	52	3	42	28	1
173354	Automation	200601	4	0	0	0	4	1	0	0	87	56	3	43	29	1
173354	Automation	200602	25	0	0	0	6	4	0	0	112	62	3	66	33	1
173354	Automation	200603	13	0	0	0	8	6	0	0	125	69	3	75	38	1
173354	Automation	200604	4	0	0	0	4	3	0	0	129	72	3	78	40	1
173354	Automation	200605	15	1	0	0	9	5	1	0	144	79	4	88	44	1
173354	Automation	200606	13	1	0	0	7	4	1	0	157	86	5	96	48	1
173354	Automation	200607	6	1	0	0	4	3	1	0	163	90	6	101	51	2
173354	Automation	200608	21	1	0	0	13	7	1	0	184	103	7	109	58	2
173354	Automation	200609	11	1	0	0	7	4	1	0	195	109	8	114	62	2
173354	Automation	200610	6	1	0	0	4	2	1	0	201	113	9	116	64	2
173354	Automation	200611	6	0	0	0	5	2	0	0	207	118	9	119	66	2
173354	Automation	200612	14	2	0	0	11	5	2	0	221	128	11	124	71	2
173354	Automation	200701	22	5	0	0	14	8	4	0	243	142	16	138	79	3
173354	Automation	200702	16	9	3	1	10	3	5	2	259	151	25	145	81	5
173354	Automation	200703	10	1	0	0	10	3	1	0	269	159	26	148	83	5
173354	Automation	200704	22	5	1	0	11	6	3	1	291	169	31	162	89	7
173354	Automation	200705	16	1	0	0	9	5	1	0	307	178	32	171	94	7
173354	Automation	200706	6	1	0	0	5	3	1	0	313	183	33	174	97	7
173354	Automation	200707	11	3	0	0	10	6	3	0	324	191	36	181	101	7
173354	Automation	200708	1	0	0	0	1	0	0	0	325	192	36	181	101	7
173354	Automation	200709	16	5	0	0	12	6	3	0	341	202	41	190	105	7
173354	Automation	200710	6	2	0	0	5	3	2	0	347	205	43	193	106	7
173354	Automation	200711	17	2	0	0	12	5	2	0	364	216	45	198	110	7
173354	Automation	200712	10	1	0	0	10	5	1	0	374	224	46	203	113	7
173354	Automation	200801	32	7	0	0	17	10	6	0	406	237	53	215	119	10
173354	Automation	200802	7	2	0	0	7	6	2	0	413	243	55	221	124	12
173354	Automation	200803	10	2	0	0	9	5	2	0	423	251	57	226	128	12
173354	Automation	200804	7	2	0	0	5	3	1	0	430	256	59	230	131	13
173354	Automation	200805	20	2	0	0	12	8	2	0	450	266	61	245	137	14
173354	Automation	200806	33	3	0	0	12	7	2	0	483	277	64	265	143	15
173354	Automation	200807	12	3	0	0	10	7	3	0	495	286	67	274	149	17
173354	Automation	200808	20	3	0	0	10	4	2	0	515	295	70	281	152	18
173354	Automation	200809	9	2	0	0	7	6	2	0	524	299	72	288	155	19
173354	Automation	200810	7	1	0	0	6	3	1	0	531	304	73	291	157	19
173354	Automation	200811	20	3	0	0	10	5	1	0	551	313	76	300	161	19
173354	Automation	200812	8	2	0	0	7	2	1	0	559	319	78	303	162	19
173354	Automation	200901	18	6	0	0	10	6	5	0	577	328	84	316	167	22
173354	Automation	200902	6	2	0	0	5	2	2	0	583	332	86	318	168	22
173354	Automation	200903	21	10	1	0	12	6	5	1	604	342	96	329	172	24
173354	Automation	200904	30	10	1	0	19	11	10	1	634	359	106	347	181	28
173354	Automation	200905	10	0	0	0	6	4	0	0	644	364	106	355	184	28
173354	Automation	200906	19	4	0	0	11	10	3	0	663	374	110	372	193	31
173354	Automation	200907	12	2	0	0	10	5	2	0	675	382	112	379	196	31
173354	Automation	200908	3	1	0	0	3	1	1	0	678	384	113	380	196	31
173354	Automation	200909	9	1	0	0	5	5	1	0	687	388	114	389	200	32
173354	Automation	200910	16	4	0	0	12	6	4	0	703	399	118	397	205	33
173354	Automation	200911	6	1	0	0	4	3	1	0	709	401	119	401	206	34
173354	Automation	200912	3	1	0	0	3	1	1	0	712	404	120	402	207	34
173354	Automation	201001	4	0	0	0	4	4	0	0	716	408	120	406	211	34
173354	Automation	201002	7	2	0	0	7	6	2	0	723	413	122	412	215	35
173354	Automation	201003	10	1	0	0	7	6	1	0	733	420	123	421	221	36
173354	Automation	201004	11	4	0	0	10	4	3	0	744	429	127	426	224	36
173354	Automation	201005	12	5	0	0	9	6	3	0	756	436	132	435	228	38
173354	Automation	201006	18	3	0	0	10	9	3	0	774	443	135	452	234	40
173354	Automation	201007	54	5	0	0	12	7	3	0	828	448	140	488	234	40
173354	Automation	201008	1	0	0	0	1	1	0	0	829	448	140	489	234	40
173354	Automation	201009	4	1	0	0	4	2	1	0	833	451	141	491	235	40
173354	Automation	201010	84	5	0	0	14	7	4	0	917	463	146	563	240	41
173354	Automation	201011	46	2	0	0	7	2	1	0	963	468	148	604	241	41
173354	Automation	201012	73	3	0	0	11	7	3	0	1036	477	151	673	246	41
173354	Automation	201101	14	1	0	0	4	3	1	0	1050	479	152	686	247	41
173354	Automation	201102	13	1	0	0	7	6	1	0	1063	483	153	698	250	41
173354	Automation	201103	13	5	0	0	9	5	3	0	1076	490	158	707	253	42
173354	Automation	201104	8	0	0	0	6	5	0	0	1084	496	158	714	258	42
173354	Automation	201105	23	4	0	0	12	6	1	0	1107	505	162	730	261	45
173354	Automation	201106	3	0	0	0	3	1	0	0	1110	508	162	731	262	45
173354	Automation	201107	13	1	0	0	7	5	1	0	1123	513	163	742	265	46
173354	Automation	201108	8	2	0	0	7	3	2	0	1131	519	165	745	267	46
173354	Automation	201109	13	2	0	0	8	4	2	0	1144	526	167	749	270	46
173354	Automation	201110	16	4	0	0	11	4	4	0	1160	537	171	753	274	46
173354	Automation	201111	10	2	0	0	9	6	2	0	1170	544	173	760	278	46
173354	Automation	201112	20	4	0	0	11	5	4	0	1190	553	177	765	281	46
173354	Automation	201201	7	1	0	0	6	3	1	0	1197	557	178	768	282	46
173354	Automation	201202	8	0	0	0	5	3	0	0	1205	561	178	773	284	46
173354	Automation	201203	27	11	0	0	15	6	6	0	1232	570	189	784	286	46
173354	Automation	201204	16	1	0	0	11	8	1	0	1248	577	190	796	290	46
173354	Automation	201205	4	0	0	0	3	3	0	0	1252	579	190	800	292	46
173354	Automation	201206	19	4	0	0	15	12	3	0	1271	593	194	816	303	50
173354	Automation	201207	14	2	0	0	9	5	2	0	1285	600	196	821	306	50
173354	Automation	201208	10	1	0	0	7	4	1	0	1295	606	197	827	309	51
173354	Automation	201209	8	3	0	0	8	5	3	0	1303	611	200	832	311	52
173354	Automation	201210	22	9	0	0	14	8	7	0	1325	620	209	842	315	53
173354	Automation	201211	5	1	0	0	5	4	1	0	1330	624	210	846	318	54
173354	Automation	201212	29	1	0	0	7	5	1	0	1359	628	211	851	320	54
173354	Automation	201301	10	3	0	0	8	5	3	0	1369	634	214	856	323	54
173354	Automation	201302	9	2	0	0	7	4	2	0	1378	639	216	862	325	54
173354	Automation	201303	7	3	0	0	7	4	3	0	1385	644	219	866	327	54
173354	Automation	201304	2	1	0	0	2	1	1	0	1387	646	220	867	328	54
173354	Automation	201305	9	1	0	0	5	3	1	0	1396	651	221	874	331	55
173354	Automation	201307	7	2	0	0	4	3	2	0	1403	652	223	877	331	55
173354	Automation	201308	4	1	0	0	3	2	1	0	1407	655	224	879	333	55
173354	Automation	201309	7	1	0	0	5	3	1	0	1414	659	225	884	335	55
173354	Automation	201310	105	5	0	0	9	6	2	0	1519	666	230	982	339	58
173354	Automation	201311	16	4	0	0	11	5	4	0	1535	673	234	992	341	58
173354	Automation	201312	12	4	0	0	8	7	3	0	1547	677	238	1003	344	61
173354	Automation	201401	20	2	0	0	10	6	2	0	1567	683	240	1012	346	62
173354	Automation	201402	22	0	0	0	6	2	0	0	1589	687	240	1030	346	62
173354	Automation	201403	10	2	0	0	8	4	2	0	1599	692	242	1034	347	62
173354	Automation	201404	11	2	0	0	6	5	2	0	1610	696	244	1042	350	62
173354	Automation	201405	10	3	0	0	8	6	3	0	1620	703	247	1049	355	64
173354	Automation	201406	8	3	0	0	8	5	3	0	1628	708	250	1054	357	64
173354	Automation	201407	19	1	0	0	3	2	1	0	1647	710	251	1072	358	64
173354	Automation	201408	4	1	0	0	4	2	1	0	1651	713	252	1074	359	64
173354	Automation	201409	5	3	1	0	4	2	3	1	1656	715	255	1076	359	65
173354	Automation	201410	10	2	0	0	7	6	2	0	1666	720	257	1084	363	65
173354	Automation	201411	5	0	0	0	3	2	0	0	1671	723	257	1086	365	65
173354	Automation	201412	4	1	0	0	4	2	1	0	1675	725	258	1088	366	66
173354	Automation	201501	21	2	0	0	13	6	2	0	1696	734	260	1094	368	66
173354	Automation	201502	5	1	0	0	5	4	1	0	1701	738	261	1098	371	67
173354	Automation	201503	13	2	0	0	8	2	2	0	1714	745	263	1100	372	67
173354	Automation	201504	6	2	0	0	6	3	2	0	1720	748	265	1103	372	67
173354	Automation	201506	2	1	0	0	2	1	1	0	1722	749	266	1104	372	67
173354	Automation	201507	13	0	0	0	2	2	0	0	1735	749	266	1117	372	67
173354	Automation	201508	17	4	0	0	10	5	3	0	1752	755	270	1126	373	67
173354	Automation	201509	3	1	0	0	3	2	1	0	1755	757	271	1128	374	67
173354	Automation	201510	20	6	1	0	15	8	4	1	1775	769	277	1141	379	69
173354	Automation	201511	6	1	0	0	6	5	1	0	1781	774	278	1146	383	69
173354	Automation	201512	18	3	0	0	8	6	3	0	1799	780	281	1162	387	70
173354	Automation	201601	5	2	0	0	4	3	2	0	1804	782	283	1166	388	71
173354	Automation	201602	8	1	0	0	5	4	1	0	1812	786	284	1173	391	71
173354	Automation	201603	6	0	0	0	5	3	0	0	1818	791	284	1176	394	71
173354	Automation	201604	13	0	0	0	7	5	0	0	1831	797	284	1186	398	71
173354	Automation	201605	6	3	0	0	5	4	3	0	1837	801	287	1190	401	72
173354	Automation	201606	10	2	0	0	9	7	2	0	1847	806	289	1198	404	73
173354	Automation	201607	11	4	0	0	11	8	4	0	1858	813	293	1206	408	74
173354	Automation	201608	10	1	0	0	8	6	1	0	1868	820	294	1214	413	75
173354	Automation	201609	7	2	0	0	6	3	2	0	1875	824	296	1217	414	75
173354	Automation	201610	48	8	0	0	14	10	7	0	1923	834	304	1252	419	78
173354	Automation	201611	19	2	0	0	9	8	2	0	1942	840	306	1270	424	79
173354	Automation	201612	19	4	0	0	12	9	3	0	1961	849	310	1286	429	81
173354	Automation	201701	5	0	0	0	3	2	0	0	1966	850	310	1290	429	81
173354	Automation	201702	17	2	0	0	9	8	2	0	1983	853	312	1306	431	83
173354	Automation	201703	11	5	0	0	10	7	5	0	1994	860	317	1314	435	86
173354	Automation	201704	25	9	2	1	14	11	6	2	2019	868	326	1336	440	92
173354	Automation	201705	8	3	0	0	6	5	3	0	2027	872	329	1343	443	95
173354	Automation	201706	12	1	0	0	7	5	1	0	2039	877	330	1353	445	96
173354	Automation	201707	6	2	0	0	6	5	2	0	2045	881	332	1358	448	97
173354	Automation	201708	12	2	0	0	8	5	2	0	2057	888	334	1367	452	97
173354	Automation	201709	17	4	0	0	13	10	4	0	2074	897	338	1379	458	98
173354	Automation	201710	14	3	0	0	8	3	2	0	2088	903	341	1383	459	98
173354	Automation	201711	3	1	0	0	3	2	1	0	2091	905	342	1385	460	98
173354	Automation	201712	19	9	3	2	12	7	7	2	2110	915	351	1394	465	99
173354	Automation	201801	18	5	2	1	8	6	4	2	2128	922	356	1402	470	100
173354	Automation	201802	20	5	0	0	15	11	4	0	2148	932	361	1414	474	103
173354	Automation	201803	20	1	0	0	10	9	1	0	2168	939	362	1433	480	103
173354	Automation	201804	21	1	0	0	12	11	1	0	2189	944	363	1453	484	104
173354	Automation	201805	13	4	0	0	11	9	4	0	2202	952	367	1463	488	105
173354	Automation	201806	21	1	0	0	4	2	1	0	2223	955	368	1482	489	105
173354	Automation	201807	19	5	0	0	13	9	5	0	2242	964	373	1495	494	105
245926	Autonomous_car	200312	2	0	0	0	2	1	0	0	2	2	0	1	1	0
245926	Autonomous_car	200408	1	0	0	0	1	1	0	0	3	3	0	2	2	0
245926	Autonomous_car	200501	1	0	0	0	1	0	0	0	4	4	0	2	2	0
245926	Autonomous_car	200502	1	0	0	0	1	0	0	0	5	5	0	2	2	0
245926	Autonomous_car	200504	1	0	0	0	1	0	0	0	6	5	0	2	2	0
245926	Autonomous_car	200505	1	0	0	0	1	1	0	0	7	6	0	3	3	0
245926	Autonomous_car	200506	1	0	0	0	1	1	0	0	8	7	0	4	4	0
245926	Autonomous_car	200507	2	0	0	0	2	1	0	0	10	9	0	5	5	0
245926	Autonomous_car	200508	9	0	0	0	4	3	0	0	19	13	0	12	8	0
245926	Autonomous_car	200509	4	0	0	0	3	2	0	0	23	16	0	15	10	0
245926	Autonomous_car	200510	1	0	0	0	1	1	0	0	24	17	0	16	11	0
245926	Autonomous_car	200512	2	0	0	0	1	0	0	0	26	18	0	16	11	0
245926	Autonomous_car	200601	6	1	0	0	3	1	1	0	32	21	1	17	12	0
245926	Autonomous_car	200602	2	0	0	0	1	1	0	0	34	21	1	19	12	0
245926	Autonomous_car	200603	40	0	0	0	5	4	0	0	74	25	1	58	15	0
245926	Autonomous_car	200604	79	0	0	0	16	10	0	0	153	39	1	127	23	0
245926	Autonomous_car	200605	27	0	0	0	7	5	0	0	180	44	1	152	26	0
245926	Autonomous_car	200606	9	0	0	0	7	5	0	0	189	50	1	159	30	0
245926	Autonomous_car	200607	10	0	0	0	8	5	0	0	199	57	1	166	34	0
245926	Autonomous_car	200608	10	0	0	0	7	5	0	0	209	62	1	174	37	0
245926	Autonomous_car	200609	7	0	0	0	4	2	0	0	216	66	1	178	39	0
245926	Autonomous_car	200610	7	1	0	0	4	3	1	0	223	68	2	184	40	0
245926	Autonomous_car	200611	10	0	0	0	4	4	0	0	233	70	2	194	42	0
245926	Autonomous_car	200612	15	0	0	0	11	9	0	0	248	80	2	207	50	0
245926	Autonomous_car	200701	8	1	0	0	5	4	1	0	256	84	3	213	53	1
245926	Autonomous_car	200702	11	0	0	0	7	3	0	0	267	90	3	216	55	1
245926	Autonomous_car	200703	2	0	0	0	2	1	0	0	269	92	3	217	56	1
245926	Autonomous_car	200704	6	0	0	0	4	1	0	0	275	96	3	219	57	1
245926	Autonomous_car	200705	4	1	0	0	4	3	1	0	279	99	4	222	59	1
245926	Autonomous_car	200706	6	1	0	0	6	2	1	0	285	104	5	224	60	1
245926	Autonomous_car	200707	11	0	0	0	4	4	0	0	296	108	5	235	64	1
245926	Autonomous_car	200708	8	1	0	0	8	4	1	0	304	115	6	239	67	1
245926	Autonomous_car	200709	19	0	0	0	10	8	0	0	323	124	6	255	74	1
245926	Autonomous_car	200710	7	2	0	0	7	3	2	0	330	129	8	258	75	1
245926	Autonomous_car	200711	2	0	0	0	1	0	0	0	332	130	8	258	75	1
245926	Autonomous_car	200712	27	2	0	0	8	5	2	0	359	133	10	280	76	2
245926	Autonomous_car	200801	9	0	0	0	6	4	0	0	368	139	10	287	80	2
245926	Autonomous_car	200802	14	1	0	0	11	3	1	0	382	148	11	291	81	2
245926	Autonomous_car	200803	9	0	0	0	2	0	0	0	391	150	11	291	81	2
245926	Autonomous_car	200804	4	0	0	0	3	3	0	0	395	153	11	295	84	2
245926	Autonomous_car	200805	11	1	0	0	7	3	1	0	406	159	12	299	86	2
245926	Autonomous_car	200806	4	0	0	0	3	1	0	0	410	162	12	301	87	2
245926	Autonomous_car	200807	8	2	0	0	5	4	1	0	418	167	14	306	91	2
245926	Autonomous_car	200808	3	0	0	0	3	1	0	0	421	170	14	307	92	2
245926	Autonomous_car	200809	2	0	0	0	1	0	0	0	423	171	14	307	92	2
245926	Autonomous_car	200810	7	0	0	0	5	2	0	0	430	176	14	310	94	2
245926	Autonomous_car	200811	24	8	1	0	6	4	3	1	454	180	22	331	96	10
245926	Autonomous_car	200812	31	3	0	0	9	7	1	0	485	184	25	358	99	12
245926	Autonomous_car	200901	6	0	0	0	4	3	0	0	491	186	25	363	100	12
245926	Autonomous_car	200902	4	1	0	0	3	2	1	0	495	188	26	365	101	12
245926	Autonomous_car	200903	13	3	0	0	9	5	1	0	508	193	29	374	103	13
245926	Autonomous_car	200904	16	1	0	0	11	8	1	0	524	202	30	386	109	13
245926	Autonomous_car	200905	9	1	0	0	8	7	1	0	533	208	31	394	114	13
245926	Autonomous_car	200906	7	0	0	0	6	3	0	0	540	213	31	398	116	13
245926	Autonomous_car	200907	4	0	0	0	3	1	0	0	544	216	31	399	117	13
245926	Autonomous_car	200908	2	0	0	0	2	2	0	0	546	218	31	401	119	13
245926	Autonomous_car	200909	5	1	0	0	5	3	1	0	551	221	32	404	120	14
245926	Autonomous_car	200910	7	0	0	0	6	4	0	0	558	226	32	408	123	14
245926	Autonomous_car	200911	4	0	0	0	4	2	0	0	562	230	32	410	125	14
245926	Autonomous_car	200912	7	0	0	0	6	3	0	0	569	236	32	414	128	14
245926	Autonomous_car	201001	14	1	0	0	6	5	1	0	583	241	33	423	132	14
245926	Autonomous_car	201002	5	0	0	0	4	4	0	0	588	244	33	428	135	14
245926	Autonomous_car	201003	12	1	0	0	9	5	1	0	600	252	34	434	139	14
245926	Autonomous_car	201004	5	1	0	0	5	3	1	0	605	256	35	437	141	14
245926	Autonomous_car	201005	9	1	0	0	7	3	1	0	614	262	36	440	143	14
245926	Autonomous_car	201006	10	0	0	0	7	1	0	0	624	269	36	442	144	14
245926	Autonomous_car	201007	4	1	0	0	4	3	1	0	628	272	37	445	146	14
245926	Autonomous_car	201008	7	0	0	0	6	2	0	0	635	278	37	447	148	14
245926	Autonomous_car	201009	8	1	0	0	8	4	1	0	643	286	38	451	152	14
245926	Autonomous_car	201010	4	1	0	0	4	4	1	0	647	288	39	455	154	15
245926	Autonomous_car	201011	34	4	0	0	17	13	4	0	681	302	43	484	164	15
245926	Autonomous_car	201012	11	0	0	0	9	6	0	0	692	309	43	492	168	15
245926	Autonomous_car	201101	1	0	0	0	1	0	0	0	693	310	43	492	168	15
245926	Autonomous_car	201102	46	6	0	0	17	11	4	0	739	322	49	525	174	18
245926	Autonomous_car	201103	8	2	0	0	6	5	1	0	747	327	51	531	178	18
245926	Autonomous_car	201104	4	0	0	0	4	3	0	0	751	330	51	534	180	18
245926	Autonomous_car	201105	5	1	0	0	5	2	1	0	756	334	52	536	181	18
245926	Autonomous_car	201106	12	0	0	0	8	8	0	0	768	341	52	548	188	18
245926	Autonomous_car	201107	14	2	0	0	7	6	1	0	782	345	54	558	191	18
245926	Autonomous_car	201108	24	0	0	0	9	6	0	0	806	349	54	579	192	18
245926	Autonomous_car	201109	15	1	0	0	10	3	1	0	821	357	55	582	193	18
245926	Autonomous_car	201110	25	0	0	0	6	4	0	0	846	361	55	605	195	18
245926	Autonomous_car	201111	34	0	0	0	10	10	0	0	880	366	55	639	200	18
245926	Autonomous_car	201112	10	0	0	0	9	7	0	0	890	371	55	647	203	18
245926	Autonomous_car	201201	11	0	0	0	6	5	0	0	901	376	55	657	207	18
245926	Autonomous_car	201202	7	0	0	0	4	3	0	0	908	379	55	663	209	18
245926	Autonomous_car	201203	8	1	0	0	5	3	1	0	916	382	56	667	210	18
245926	Autonomous_car	201204	13	0	0	0	8	7	0	0	929	389	56	679	216	18
245926	Autonomous_car	201205	21	0	0	0	12	8	0	0	950	397	56	695	220	18
245926	Autonomous_car	201206	18	3	0	0	14	6	3	0	968	408	59	704	223	18
245926	Autonomous_car	201207	16	0	0	0	10	6	0	0	984	416	59	716	227	18
245926	Autonomous_car	201208	14	0	0	0	9	5	0	0	998	424	59	722	231	18
245926	Autonomous_car	201209	13	3	1	0	7	2	2	1	1011	429	62	729	231	19
245926	Autonomous_car	201210	30	1	0	0	16	11	1	0	1041	442	63	744	239	19
245926	Autonomous_car	201211	20	6	0	0	15	10	5	0	1061	453	69	755	245	19
245926	Autonomous_car	201212	13	0	0	0	7	7	0	0	1074	458	69	768	250	19
245926	Autonomous_car	201301	12	3	0	0	10	8	3	0	1086	463	72	778	253	20
245926	Autonomous_car	201302	68	5	0	0	17	11	4	0	1154	478	77	835	262	21
245926	Autonomous_car	201303	54	2	0	0	14	8	1	0	1208	490	79	877	268	21
245926	Autonomous_car	201304	47	2	0	0	13	8	2	0	1255	500	81	918	273	21
245926	Autonomous_car	201305	16	0	0	0	9	8	0	0	1271	504	81	933	276	21
245926	Autonomous_car	201306	8	1	0	0	8	6	1	0	1279	509	82	939	279	21
245926	Autonomous_car	201307	45	1	0	0	10	9	1	0	1324	515	83	983	284	22
245926	Autonomous_car	201308	37	2	0	0	13	10	1	0	1361	523	85	1016	290	23
245926	Autonomous_car	201309	12	1	0	0	9	7	1	0	1373	528	86	1025	293	24
245926	Autonomous_car	201310	51	5	1	0	19	15	5	1	1424	538	91	1069	300	26
245926	Autonomous_car	201311	43	4	0	0	26	17	4	0	1467	554	95	1100	308	26
245926	Autonomous_car	201312	34	3	0	0	19	12	3	0	1501	567	98	1124	314	27
245926	Autonomous_car	201401	18	1	0	0	12	9	1	0	1519	575	99	1137	319	27
245926	Autonomous_car	201402	82	6	0	0	30	23	5	0	1601	592	105	1210	330	30
245926	Autonomous_car	201403	10	0	0	0	4	2	0	0	1611	595	105	1218	331	30
245926	Autonomous_car	201404	34	1	0	0	18	14	1	0	1645	604	106	1244	336	31
245926	Autonomous_car	201405	16	0	0	0	8	4	0	0	1661	610	106	1251	338	31
245926	Autonomous_car	201406	10	1	0	0	10	6	1	0	1671	616	107	1257	339	31
245926	Autonomous_car	201407	15	1	0	0	13	7	1	0	1686	625	108	1266	341	31
245926	Autonomous_car	201408	25	1	0	0	14	11	1	0	1711	633	109	1287	347	31
245926	Autonomous_car	201409	33	4	0	0	19	17	4	0	1744	645	113	1317	357	33
245926	Autonomous_car	201410	44	3	0	0	17	13	1	0	1788	652	116	1353	360	34
245926	Autonomous_car	201411	52	3	0	0	22	17	3	0	1840	663	119	1395	367	34
245926	Autonomous_car	201412	31	2	0	0	13	12	2	0	1871	670	121	1424	372	35
245926	Autonomous_car	201501	21	0	0	0	13	10	0	0	1892	675	121	1441	374	35
245926	Autonomous_car	201502	39	1	0	0	14	12	1	0	1931	683	122	1478	379	35
245926	Autonomous_car	201503	64	7	0	0	26	17	5	0	1995	700	129	1529	387	40
245926	Autonomous_car	201504	40	3	0	0	22	15	3	0	2035	713	132	1558	392	40
245926	Autonomous_car	201505	12	3	0	0	10	6	3	0	2047	722	135	1566	397	41
245926	Autonomous_car	201506	14	4	0	0	11	5	3	0	2061	730	139	1573	399	42
245926	Autonomous_car	201507	28	3	0	0	16	9	3	0	2089	742	142	1592	404	44
245926	Autonomous_car	201508	6	0	0	0	6	4	0	0	2095	746	142	1596	405	44
245926	Autonomous_car	201509	9	0	0	0	8	6	0	0	2104	751	142	1603	408	44
245926	Autonomous_car	201510	16	2	0	0	12	10	2	0	2120	759	144	1616	414	44
245926	Autonomous_car	201511	26	5	2	1	15	9	4	2	2146	768	149	1635	417	45
245926	Autonomous_car	201512	35	2	0	0	18	13	2	0	2181	780	151	1655	424	46
245926	Autonomous_car	201601	21	3	0	0	15	9	3	0	2202	789	154	1670	427	47
245926	Autonomous_car	201602	33	4	0	0	23	15	4	0	2235	807	158	1688	436	47
245926	Autonomous_car	201603	42	10	0	0	23	14	7	0	2277	824	168	1717	444	49
245926	Autonomous_car	201604	28	10	2	0	20	15	9	2	2305	838	178	1737	451	55
245926	Autonomous_car	201605	37	7	0	0	21	14	7	0	2342	853	185	1760	458	60
245926	Autonomous_car	201606	39	0	0	0	17	12	0	0	2381	865	185	1792	465	60
245926	Autonomous_car	201607	22	3	0	0	10	9	3	0	2403	872	188	1813	471	62
245926	Autonomous_car	201608	42	1	0	0	17	14	1	0	2445	886	189	1851	482	63
245926	Autonomous_car	201609	23	0	0	0	11	8	0	0	2468	893	189	1870	485	63
245926	Autonomous_car	201610	19	2	0	0	16	12	2	0	2487	904	191	1885	492	63
245926	Autonomous_car	201611	69	6	0	0	27	18	6	0	2556	922	197	1938	499	64
245926	Autonomous_car	201612	43	5	0	0	24	14	4	0	2599	940	202	1966	507	64
245926	Autonomous_car	201701	39	3	0	0	24	17	2	0	2638	957	205	1997	516	65
245926	Autonomous_car	201702	42	6	0	0	24	19	4	0	2680	969	211	2032	523	69
245926	Autonomous_car	201703	37	8	0	0	23	15	6	0	2717	982	219	2057	527	72
245926	Autonomous_car	201704	41	8	0	0	26	18	5	0	2758	1000	227	2088	534	73
245926	Autonomous_car	201705	32	7	0	0	20	15	5	0	2790	1015	234	2112	544	73
245926	Autonomous_car	201706	14	1	0	0	12	7	1	0	2804	1025	235	2119	548	73
245926	Autonomous_car	201707	16	0	0	0	12	7	0	0	2820	1034	235	2128	552	73
245926	Autonomous_car	201708	31	1	0	0	17	13	1	0	2851	1050	236	2153	562	74
245926	Autonomous_car	201709	58	9	0	0	35	25	8	0	2909	1077	245	2200	577	80
245926	Autonomous_car	201710	20	2	0	0	20	12	2	0	2929	1096	247	2212	588	80
245926	Autonomous_car	201711	37	5	0	0	27	17	5	0	2966	1119	252	2238	600	82
245926	Autonomous_car	201712	49	10	2	1	28	24	7	2	3015	1143	262	2282	618	91
245926	Autonomous_car	201801	35	4	0	0	28	18	4	0	3050	1165	266	2304	629	91
245926	Autonomous_car	201802	28	4	0	0	25	15	4	0	3078	1184	270	2321	637	91
245926	Autonomous_car	201803	40	14	3	1	27	17	9	2	3118	1201	284	2345	645	96
245926	Autonomous_car	201804	130	11	0	0	53	40	10	0	3248	1245	295	2436	671	102
245926	Autonomous_car	201805	36	4	0	0	25	20	4	0	3284	1263	299	2467	682	104
245926	Autonomous_car	201806	73	5	0	0	31	25	4	0	3357	1283	304	2520	693	105
245926	Autonomous_car	201807	58	10	0	0	25	22	5	0	3415	1295	314	2568	699	108
3897526	Back-to-back_user_agent	200602	4	0	0	0	1	1	0	0	4	1	0	4	1	0
3897526	Back-to-back_user_agent	200603	2	0	0	0	1	1	0	0	6	1	0	6	1	0
3897526	Back-to-back_user_agent	200605	2	0	0	0	2	2	0	0	8	3	0	8	3	0
3897526	Back-to-back_user_agent	200607	1	0	0	0	1	1	0	0	9	4	0	9	4	0
3897526	Back-to-back_user_agent	200701	1	0	0	0	1	0	0	0	10	5	0	9	4	0
3897526	Back-to-back_user_agent	200704	2	0	0	0	2	2	0	0	12	7	0	11	6	0
3897526	Back-to-back_user_agent	200706	1	0	0	0	1	1	0	0	13	8	0	12	7	0
3897526	Back-to-back_user_agent	200708	3	1	0	0	2	1	1	0	16	10	1	13	8	0
3897526	Back-to-back_user_agent	200711	2	0	0	0	2	2	0	0	18	12	1	15	10	0
3897526	Back-to-back_user_agent	200903	2	1	0	0	2	1	1	0	20	13	2	16	10	0
3897526	Back-to-back_user_agent	200908	2	0	0	0	1	1	0	0	22	14	2	18	11	0
3897526	Back-to-back_user_agent	200911	1	0	0	0	1	0	0	0	23	15	2	18	11	0
3897526	Back-to-back_user_agent	201001	1	0	0	0	1	0	0	0	24	16	2	18	11	0
3897526	Back-to-back_user_agent	201003	4	2	0	0	2	1	1	0	28	17	4	21	11	0
3897526	Back-to-back_user_agent	201004	3	0	0	0	2	1	0	0	31	19	4	22	12	0
3897526	Back-to-back_user_agent	201008	3	1	0	0	3	1	1	0	34	22	5	23	13	0
3897526	Back-to-back_user_agent	201301	2	0	0	0	2	1	0	0	36	23	5	24	13	0
3897526	Back-to-back_user_agent	201311	3	1	0	0	3	1	1	0	39	25	6	25	13	0
3897526	Back-to-back_user_agent	201611	4	1	0	0	3	3	1	0	43	27	7	29	15	1
3897526	Back-to-back_user_agent	201708	1	0	0	0	1	1	0	0	44	28	7	30	16	1
27051151	Big_data	201005	19	1	0	0	9	9	1	0	19	9	1	19	9	1
27051151	Big_data	201008	2	0	0	0	2	2	0	0	21	11	1	21	11	1
27051151	Big_data	201009	2	0	0	0	2	2	0	0	23	13	1	23	13	1
27051151	Big_data	201010	2	0	0	0	2	0	0	0	25	15	1	23	13	1
27051151	Big_data	201011	2	0	0	0	1	0	0	0	27	16	1	23	13	1
27051151	Big_data	201012	2	0	0	0	2	1	0	0	29	18	1	24	14	1
27051151	Big_data	201101	5	1	0	0	5	3	1	0	34	23	2	27	17	1
27051151	Big_data	201102	3	0	0	0	3	3	0	0	37	25	2	30	19	1
27051151	Big_data	201103	1	0	0	0	1	1	0	0	38	25	2	31	19	1
27051151	Big_data	201104	6	1	0	0	5	4	1	0	44	30	3	36	23	2
27051151	Big_data	201105	7	0	0	0	6	5	0	0	51	35	3	42	27	2
27051151	Big_data	201106	9	0	0	0	4	3	0	0	60	38	3	50	29	2
27051151	Big_data	201107	6	0	0	0	5	5	0	0	66	41	3	56	32	2
27051151	Big_data	201108	7	0	0	0	4	3	0	0	73	45	3	62	35	2
27051151	Big_data	201109	4	0	0	0	4	3	0	0	77	49	3	65	38	2
27051151	Big_data	201110	9	2	0	0	5	3	1	0	86	53	5	72	40	3
27051151	Big_data	201111	4	0	0	0	4	4	0	0	90	53	5	76	40	3
27051151	Big_data	201112	6	1	0	0	6	4	1	0	96	58	6	80	43	3
27051151	Big_data	201201	4	0	0	0	4	1	0	0	100	62	6	81	44	3
27051151	Big_data	201202	38	2	0	0	24	15	2	0	138	83	8	106	56	5
27051151	Big_data	201203	10	1	0	0	9	7	1	0	148	90	9	113	61	5
27051151	Big_data	201204	24	2	0	0	14	7	1	0	172	101	11	128	65	5
27051151	Big_data	201205	13	4	0	0	11	8	2	0	185	111	15	138	72	8
27051151	Big_data	201206	30	3	0	0	19	12	2	0	215	129	18	158	83	9
27051151	Big_data	201207	18	3	0	0	14	10	2	0	233	140	21	172	90	11
27051151	Big_data	201208	41	3	0	0	20	14	2	0	274	157	24	207	101	13
27051151	Big_data	201209	31	2	0	0	17	11	1	0	305	171	26	231	109	14
27051151	Big_data	201210	21	1	0	0	15	11	1	0	326	181	27	247	115	14
27051151	Big_data	201211	25	5	0	0	20	9	4	0	351	196	32	259	119	17
27051151	Big_data	201212	18	0	0	0	14	11	0	0	369	207	32	272	127	17
27051151	Big_data	201301	50	11	0	0	23	17	7	0	419	225	43	314	139	25
27051151	Big_data	201302	41	3	0	0	28	14	3	0	460	250	46	339	150	26
27051151	Big_data	201303	22	1	0	0	21	13	1	0	482	270	47	352	162	26
27051151	Big_data	201304	64	5	0	0	31	19	5	0	546	295	52	400	175	29
27051151	Big_data	201305	42	3	0	0	29	19	3	0	588	321	55	429	191	31
27051151	Big_data	201306	58	7	0	0	24	10	5	0	646	343	62	450	199	35
27051151	Big_data	201307	44	5	0	0	29	17	5	0	690	367	67	473	212	38
27051151	Big_data	201308	18	1	0	0	14	3	1	0	708	381	68	478	215	38
27051151	Big_data	201309	11	2	0	0	10	5	2	0	719	389	70	483	218	38
27051151	Big_data	201310	26	3	0	0	21	11	2	0	745	409	73	497	228	39
27051151	Big_data	201311	30	3	0	0	19	12	2	0	775	423	76	519	235	41
27051151	Big_data	201312	16	2	0	0	14	10	2	0	791	433	78	531	241	41
27051151	Big_data	201401	14	3	0	0	11	7	3	0	805	440	81	540	244	42
27051151	Big_data	201402	33	4	0	0	17	8	3	0	838	455	85	556	250	42
27051151	Big_data	201403	53	13	3	1	25	16	8	2	891	473	98	591	259	51
27051151	Big_data	201404	54	4	0	0	23	10	4	0	945	489	102	602	263	52
27051151	Big_data	201405	34	5	2	0	22	15	3	1	979	503	107	629	271	57
27051151	Big_data	201406	42	2	0	0	30	18	2	0	1021	526	109	652	283	58
27051151	Big_data	201407	30	3	0	0	24	16	2	0	1051	548	112	674	296	59
27051151	Big_data	201408	24	3	0	0	15	11	2	0	1075	559	115	693	303	61
27051151	Big_data	201409	33	4	0	0	19	12	4	0	1108	571	119	712	309	61
27051151	Big_data	201410	27	9	2	1	21	16	7	2	1135	587	128	732	319	64
27051151	Big_data	201411	26	5	0	0	18	12	4	0	1161	601	133	748	326	66
27051151	Big_data	201412	43	11	0	0	26	17	8	0	1204	622	144	778	338	72
27051151	Big_data	201501	19	2	0	0	12	5	2	0	1223	630	146	784	339	72
27051151	Big_data	201502	62	14	4	1	19	17	9	3	1285	644	160	837	351	82
27051151	Big_data	201503	49	8	2	0	26	20	7	2	1334	661	168	879	362	88
27051151	Big_data	201504	20	4	0	0	14	7	3	0	1354	671	172	891	365	89
27051151	Big_data	201505	37	5	0	0	25	16	3	0	1391	687	177	917	370	90
27051151	Big_data	201506	14	2	0	0	10	7	2	0	1405	695	179	927	375	92
27051151	Big_data	201507	33	9	0	0	16	9	4	0	1438	706	188	951	379	96
27051151	Big_data	201508	23	2	0	0	15	10	2	0	1461	716	190	964	384	97
27051151	Big_data	201509	44	4	0	0	26	16	3	0	1505	736	194	995	392	98
27051151	Big_data	201510	42	7	0	0	17	9	5	0	1547	748	201	1010	396	99
27051151	Big_data	201511	33	6	0	0	17	11	3	0	1580	760	207	1029	401	102
27051151	Big_data	201512	37	7	0	0	21	11	6	0	1617	777	214	1041	408	102
27051151	Big_data	201601	50	1	0	0	14	11	1	0	1667	789	215	1086	417	102
27051151	Big_data	201602	31	5	0	0	19	12	3	0	1698	802	220	1105	422	104
27051151	Big_data	201603	27	5	0	0	19	13	5	0	1725	815	225	1123	428	105
27051151	Big_data	201604	28	8	0	0	21	12	7	0	1753	830	233	1140	434	108
27051151	Big_data	201605	32	8	0	0	19	11	5	0	1785	843	241	1159	439	111
27051151	Big_data	201606	29	7	0	0	12	9	4	0	1814	849	248	1183	442	117
27051151	Big_data	201607	19	2	0	0	12	10	2	0	1833	856	250	1200	446	119
27051151	Big_data	201608	16	4	0	0	13	7	2	0	1849	865	254	1209	449	120
27051151	Big_data	201609	18	7	1	0	13	10	6	1	1867	871	261	1221	452	124
27051151	Big_data	201610	67	7	0	0	21	17	5	0	1934	882	268	1281	459	128
27051151	Big_data	201611	13	4	0	0	11	9	4	0	1947	888	272	1292	463	130
27051151	Big_data	201612	41	11	0	0	25	18	5	0	1988	906	283	1321	472	137
27051151	Big_data	201701	26	7	0	0	20	14	6	0	2014	917	290	1339	476	139
27051151	Big_data	201702	20	4	0	0	15	9	4	0	2034	927	294	1352	480	139
27051151	Big_data	201703	44	8	2	1	21	13	5	2	2078	942	302	1388	487	142
27051151	Big_data	201704	21	3	0	0	14	9	3	0	2099	951	305	1398	491	143
27051151	Big_data	201705	31	5	0	0	16	10	3	0	2130	962	310	1416	496	146
27051151	Big_data	201706	18	2	0	0	9	7	1	0	2148	968	312	1432	499	147
27051151	Big_data	201707	16	3	0	0	12	7	2	0	2164	974	315	1440	500	147
27051151	Big_data	201708	31	9	2	1	20	17	8	2	2195	985	324	1464	508	153
27051151	Big_data	201709	8	0	0	0	6	6	0	0	2203	990	324	1472	513	153
27051151	Big_data	201710	5	0	0	0	4	4	0	0	2208	991	324	1477	514	153
27051151	Big_data	201711	14	1	0	0	8	7	1	0	2222	996	325	1490	518	153
27051151	Big_data	201712	20	3	0	0	15	7	3	0	2242	1007	328	1498	522	154
27051151	Big_data	201801	26	5	0	0	17	10	4	0	2268	1022	333	1515	530	155
27051151	Big_data	201802	14	3	0	0	12	7	3	0	2282	1030	336	1522	532	155
27051151	Big_data	201803	34	7	0	0	19	9	4	0	2316	1046	343	1535	538	156
27051151	Big_data	201804	45	5	0	0	23	19	4	0	2361	1061	348	1570	547	159
27051151	Big_data	201805	15	3	0	0	14	12	3	0	2376	1071	351	1583	555	161
27051151	Big_data	201806	27	6	0	0	20	16	4	0	2403	1084	357	1604	563	164
27051151	Big_data	201807	10	2	0	0	8	5	1	0	2413	1090	359	1610	566	164
28249265	Bitcoin	200908	4	0	0	0	2	2	0	0	4	2	0	4	2	0
28249265	Bitcoin	200910	4	0	0	0	3	1	0	0	8	5	0	5	3	0
28249265	Bitcoin	200911	2	1	0	0	2	1	1	0	10	7	1	6	4	0
28249265	Bitcoin	200912	1	0	0	0	1	1	0	0	11	7	1	7	4	0
28249265	Bitcoin	201002	2	0	0	0	2	1	0	0	13	8	1	8	4	0
28249265	Bitcoin	201003	1	0	0	0	1	1	0	0	14	9	1	9	5	0
28249265	Bitcoin	201004	1	0	0	0	1	1	0	0	15	10	1	10	6	0
28249265	Bitcoin	201005	14	2	0	0	5	1	2	0	29	14	3	11	6	0
28249265	Bitcoin	201006	1	0	0	0	1	1	0	0	30	15	3	12	7	0
28249265	Bitcoin	201007	31	0	0	0	5	2	0	0	61	20	3	18	9	0
28249265	Bitcoin	201008	77	2	0	0	40	18	2	0	138	55	5	61	24	1
28249265	Bitcoin	201009	15	0	0	0	6	6	0	0	153	58	5	76	27	1
28249265	Bitcoin	201010	6	1	0	0	5	5	1	0	159	62	6	82	31	2
28249265	Bitcoin	201011	3	0	0	0	2	1	0	0	162	64	6	83	32	2
28249265	Bitcoin	201012	7	0	0	0	5	2	0	0	169	68	6	87	33	2
28249265	Bitcoin	201101	265	3	0	0	35	23	3	0	434	99	9	333	52	5
28249265	Bitcoin	201102	48	1	0	0	24	15	1	0	482	115	10	368	59	5
28249265	Bitcoin	201103	64	5	3	1	37	25	3	2	546	142	15	414	75	9
28249265	Bitcoin	201104	58	8	0	0	39	26	7	0	604	171	23	453	92	13
28249265	Bitcoin	201105	100	14	2	0	47	28	11	2	704	208	37	522	111	16
28249265	Bitcoin	201106	213	23	3	2	100	52	13	2	917	293	60	663	150	21
28249265	Bitcoin	201107	636	55	11	6	225	112	28	5	1553	496	115	1087	241	46
28249265	Bitcoin	201108	186	19	6	4	78	43	10	3	1739	555	134	1226	267	55
28249265	Bitcoin	201109	91	12	0	0	55	34	9	0	1830	599	146	1289	290	62
28249265	Bitcoin	201110	86	10	1	0	47	25	7	1	1916	633	156	1344	302	64
28249265	Bitcoin	201111	102	7	0	0	49	27	5	0	2018	669	163	1410	318	64
28249265	Bitcoin	201112	70	6	0	0	29	18	5	0	2088	688	169	1458	327	65
28249265	Bitcoin	201201	46	3	0	0	39	23	3	0	2134	717	172	1488	341	66
28249265	Bitcoin	201202	60	7	0	0	35	19	4	0	2194	741	179	1526	350	69
28249265	Bitcoin	201203	48	8	1	0	30	19	5	1	2242	765	187	1561	363	71
28249265	Bitcoin	201204	53	10	0	0	31	22	9	0	2295	789	197	1600	379	76
28249265	Bitcoin	201205	55	7	3	1	25	17	5	3	2350	804	204	1645	386	82
28249265	Bitcoin	201206	37	2	0	0	25	12	2	0	2387	822	206	1664	392	84
28249265	Bitcoin	201207	46	9	2	1	32	24	6	2	2433	842	215	1702	405	91
28249265	Bitcoin	201208	41	4	0	0	22	14	1	0	2474	860	219	1734	415	94
28249265	Bitcoin	201209	233	5	0	0	48	25	3	0	2707	896	224	1907	429	94
28249265	Bitcoin	201210	296	16	3	0	52	37	15	3	3003	933	240	2176	452	103
28249265	Bitcoin	201211	512	44	8	4	49	40	14	4	3515	968	284	2658	478	130
28249265	Bitcoin	201212	19	0	0	0	5	5	0	0	3534	971	284	2677	481	130
28249265	Bitcoin	201301	19	2	0	0	14	14	2	0	3553	981	286	2696	491	132
28249265	Bitcoin	201302	285	2	0	0	23	23	1	0	3838	997	288	2981	507	134
28249265	Bitcoin	201303	250	8	1	0	33	33	3	1	4088	1016	296	3231	526	142
28249265	Bitcoin	201304	438	8	0	0	53	53	1	0	4526	1056	304	3669	566	150
28249265	Bitcoin	201305	472	24	2	0	90	90	9	1	4998	1125	328	4141	635	174
28249265	Bitcoin	201306	157	4	1	0	30	30	2	1	5155	1143	332	4298	653	178
28249265	Bitcoin	201307	81	10	8	5	24	24	3	2	5236	1158	342	4379	668	188
28249265	Bitcoin	201308	38	0	0	0	17	17	0	0	5274	1168	342	4417	678	188
28249265	Bitcoin	201309	55	1	0	0	32	32	1	0	5329	1191	343	4472	701	189
28249265	Bitcoin	201310	16	1	0	0	10	10	1	0	5345	1197	344	4488	707	190
28249265	Bitcoin	201311	210	14	3	0	54	54	12	3	5555	1240	358	4698	750	204
28249265	Bitcoin	201312	300	15	3	0	77	77	12	3	5855	1291	373	4998	801	219
28249265	Bitcoin	201401	584	54	4	1	157	105	22	4	6439	1410	427	5487	868	246
28249265	Bitcoin	201402	546	26	8	4	68	65	12	4	6985	1448	453	6027	903	266
28249265	Bitcoin	201403	149	4	3	3	41	41	3	2	7134	1474	457	6176	929	270
28249265	Bitcoin	201404	554	53	19	14	127	77	18	5	7688	1571	510	6663	977	307
28249265	Bitcoin	201405	643	48	15	9	118	76	25	6	8331	1665	558	7243	1029	340
28249265	Bitcoin	201406	384	51	18	12	77	51	14	4	8715	1716	609	7597	1052	377
28249265	Bitcoin	201407	150	20	3	2	63	36	12	3	8865	1760	629	7716	1069	385
28249265	Bitcoin	201408	296	45	17	13	64	40	13	4	9161	1805	674	7981	1090	420
28249265	Bitcoin	201409	181	18	0	0	66	42	13	0	9342	1857	692	8130	1118	431
28249265	Bitcoin	201410	143	14	0	0	33	20	8	0	9485	1878	706	8258	1128	436
28249265	Bitcoin	201411	279	27	3	2	62	42	14	3	9764	1918	733	8513	1148	451
28249265	Bitcoin	201412	470	41	19	14	61	48	13	5	10234	1962	774	8968	1180	486
28249265	Bitcoin	201501	284	24	8	8	63	44	14	3	10518	2004	798	9224	1204	499
28249265	Bitcoin	201502	410	30	11	10	62	48	8	2	10928	2044	828	9614	1230	521
28249265	Bitcoin	201503	390	50	22	16	52	36	20	9	11318	2074	878	9936	1244	554
28249265	Bitcoin	201504	98	19	6	4	35	29	11	3	11416	2096	897	10027	1260	569
28249265	Bitcoin	201505	80	17	3	0	37	26	13	3	11496	2118	914	10096	1271	582
28249265	Bitcoin	201506	162	14	0	0	46	31	10	0	11658	2146	928	10237	1284	585
28249265	Bitcoin	201507	120	22	4	2	43	30	13	4	11778	2172	950	10338	1296	596
28249265	Bitcoin	201508	86	10	2	2	29	22	6	1	11864	2190	960	10414	1305	603
28249265	Bitcoin	201509	34	7	1	0	22	16	6	1	11898	2203	967	10439	1313	606
28249265	Bitcoin	201510	140	16	3	1	36	32	11	3	12038	2222	983	10570	1328	620
28249265	Bitcoin	201511	46	9	0	0	22	16	3	0	12084	2238	992	10606	1335	625
28249265	Bitcoin	201512	102	11	1	0	34	26	8	1	12186	2265	1003	10700	1352	635
28249265	Bitcoin	201601	121	23	0	0	58	37	17	0	12307	2306	1026	10785	1371	642
28249265	Bitcoin	201602	126	12	2	0	40	30	8	2	12433	2336	1038	10900	1390	650
28249265	Bitcoin	201603	82	10	1	0	31	23	5	1	12515	2358	1048	10967	1402	655
28249265	Bitcoin	201604	50	11	0	0	32	22	8	0	12565	2380	1059	11004	1412	659
28249265	Bitcoin	201605	22	2	0	0	11	11	2	0	12587	2386	1061	11026	1418	661
28249265	Bitcoin	201606	64	4	0	0	20	20	2	0	12651	2392	1065	11090	1424	665
28249265	Bitcoin	201607	56	3	2	0	12	12	2	1	12707	2398	1068	11146	1430	668
28249265	Bitcoin	201608	98	1	0	0	14	14	1	0	12805	2402	1069	11244	1434	669
28249265	Bitcoin	201609	25	2	1	1	6	6	2	1	12830	2404	1071	11269	1436	671
28249265	Bitcoin	201610	107	12	9	6	16	16	4	3	12937	2410	1083	11376	1442	683
28249265	Bitcoin	201611	194	17	9	8	29	21	6	2	13131	2430	1100	11558	1454	696
28249265	Bitcoin	201612	83	10	1	1	23	18	6	1	13214	2441	1110	11632	1460	701
28249265	Bitcoin	201701	64	9	4	3	19	19	4	3	13278	2451	1119	11696	1470	710
28249265	Bitcoin	201702	99	1	0	0	16	16	1	0	13377	2461	1120	11795	1480	711
28249265	Bitcoin	201703	11	1	0	0	6	6	1	0	13388	2464	1121	11806	1483	712
28249265	Bitcoin	201704	34	0	0	0	21	21	0	0	13422	2477	1121	11840	1496	712
28249265	Bitcoin	201705	46	3	0	0	13	13	1	0	13468	2483	1124	11886	1502	715
28249265	Bitcoin	201706	199	22	0	0	65	45	15	0	13667	2537	1146	12061	1526	726
28249265	Bitcoin	201707	156	28	1	0	58	38	14	1	13823	2579	1174	12196	1546	742
28249265	Bitcoin	201708	98	27	0	0	54	35	12	0	13921	2621	1201	12270	1568	754
28249265	Bitcoin	201709	136	29	1	0	69	48	14	1	14057	2673	1230	12376	1596	763
28249265	Bitcoin	201710	103	31	1	0	51	32	15	1	14160	2706	1261	12453	1609	775
28249265	Bitcoin	201711	263	48	0	0	94	46	18	0	14423	2787	1309	12616	1635	796
28249265	Bitcoin	201712	64	7	1	0	29	29	5	1	14487	2805	1316	12680	1653	803
28249265	Bitcoin	201801	307	18	2	0	50	50	8	2	14794	2839	1334	12987	1687	821
28249265	Bitcoin	201802	194	24	12	6	38	38	10	8	14988	2858	1358	13181	1706	845
28249265	Bitcoin	201803	82	2	0	0	19	19	2	0	15070	2867	1360	13263	1715	847
28249265	Bitcoin	201804	59	1	0	0	23	23	1	0	15129	2878	1361	13322	1726	848
28249265	Bitcoin	201805	50	10	4	3	17	17	6	3	15179	2884	1371	13372	1732	858
28249265	Bitcoin	201806	65	9	3	1	17	17	8	3	15244	2889	1380	13437	1737	867
28249265	Bitcoin	201807	118	7	1	0	21	21	5	1	15362	2896	1387	13555	1744	874
44065971	Blockchain	201503	1	0	0	0	1	1	0	0	1	1	0	1	1	0
44065971	Blockchain	201505	2	0	0	0	2	1	0	0	3	3	0	2	2	0
44065971	Blockchain	201506	32	0	0	0	6	6	0	0	35	9	0	34	8	0
44065971	Blockchain	201507	10	4	1	0	6	3	3	1	45	13	4	39	9	1
44065971	Blockchain	201508	21	1	0	0	15	10	1	0	66	25	5	54	16	2
44065971	Blockchain	201509	14	2	0	0	12	9	2	0	80	32	7	64	20	3
44065971	Blockchain	201510	15	0	0	0	8	7	0	0	95	37	7	77	24	3
44065971	Blockchain	201511	16	0	0	0	8	7	0	0	111	41	7	91	27	3
44065971	Blockchain	201512	63	2	0	0	15	13	1	0	174	51	9	147	35	5
44065971	Blockchain	201601	166	9	0	0	18	11	6	0	340	61	18	305	39	12
44065971	Blockchain	201602	44	3	0	0	17	11	2	0	384	72	21	331	45	13
44065971	Blockchain	201603	25	2	0	0	12	11	2	0	409	83	23	355	55	15
44065971	Blockchain	201604	84	11	3	2	23	16	3	2	493	103	34	426	66	22
44065971	Blockchain	201605	65	1	0	0	16	13	1	0	558	115	35	488	74	23
44065971	Blockchain	201606	86	6	0	0	30	18	5	0	644	137	41	557	83	24
44065971	Blockchain	201607	70	7	1	0	24	17	5	1	714	152	48	598	91	27
44065971	Blockchain	201608	48	1	0	0	15	12	1	0	762	158	49	641	94	28
44065971	Blockchain	201609	97	9	2	0	17	10	4	1	859	169	58	726	98	33
44065971	Blockchain	201610	143	11	2	0	28	18	4	1	1002	191	69	856	109	41
44065971	Blockchain	201611	127	24	17	15	26	18	6	3	1129	211	93	964	121	60
44065971	Blockchain	201612	154	9	0	0	38	26	6	0	1283	242	102	1101	137	65
44065971	Blockchain	201701	120	4	0	0	36	26	3	0	1403	271	106	1208	156	68
44065971	Blockchain	201702	71	9	1	0	27	21	4	1	1474	288	115	1271	166	75
44065971	Blockchain	201703	37	4	0	0	22	15	2	0	1511	307	119	1301	177	77
44065971	Blockchain	201704	43	1	0	0	21	12	1	0	1554	322	120	1333	185	78
44065971	Blockchain	201705	70	4	0	0	24	19	1	0	1624	341	124	1398	195	81
44065971	Blockchain	201706	107	10	0	0	32	23	5	0	1731	365	134	1494	208	89
44065971	Blockchain	201707	36	4	0	0	21	12	3	0	1767	381	138	1519	215	89
44065971	Blockchain	201708	41	5	0	0	18	12	3	0	1808	395	143	1549	223	92
44065971	Blockchain	201709	26	3	0	0	17	14	3	0	1834	407	146	1572	231	93
44065971	Blockchain	201710	88	4	0	0	33	25	2	0	1922	433	150	1651	249	95
44065971	Blockchain	201711	42	8	1	0	23	15	6	1	1964	452	158	1685	259	101
44065971	Blockchain	201712	101	15	0	0	47	31	8	0	2065	493	173	1760	284	107
44065971	Blockchain	201801	136	21	3	1	64	45	14	3	2201	547	194	1869	314	121
44065971	Blockchain	201802	158	33	6	4	61	45	13	2	2359	597	227	2004	344	142
44065971	Blockchain	201803	109	12	0	0	56	38	8	0	2468	642	239	2091	370	149
44065971	Blockchain	201804	91	23	3	1	55	40	11	3	2559	685	262	2159	393	167
44065971	Blockchain	201805	73	16	1	0	40	29	9	1	2632	716	278	2215	411	173
44065971	Blockchain	201806	61	15	0	0	39	30	11	0	2693	746	293	2265	431	181
44065971	Blockchain	201807	32	4	0	0	25	24	3	0	2725	764	297	2296	447	185
38893	Border_Gateway_Protocol	200202	1	0	0	0	1	1	0	0	1	1	0	1	1	0
38893	Border_Gateway_Protocol	200204	6	0	0	0	5	1	0	0	7	6	0	2	2	0
38893	Border_Gateway_Protocol	200207	2	0	0	0	2	2	0	0	9	8	0	4	4	0
38893	Border_Gateway_Protocol	200303	3	0	0	0	2	1	0	0	12	9	0	5	4	0
38893	Border_Gateway_Protocol	200305	5	0	0	0	2	2	0	0	17	9	0	10	4	0
38893	Border_Gateway_Protocol	200308	1	0	0	0	1	1	0	0	18	9	0	11	4	0
38893	Border_Gateway_Protocol	200309	4	0	0	0	3	0	0	0	22	12	0	11	4	0
38893	Border_Gateway_Protocol	200310	2	0	0	0	1	1	0	0	24	13	0	13	5	0
38893	Border_Gateway_Protocol	200311	3	0	0	0	1	1	0	0	27	14	0	16	6	0
38893	Border_Gateway_Protocol	200402	1	0	0	0	1	0	0	0	28	15	0	16	6	0
38893	Border_Gateway_Protocol	200403	2	0	0	0	2	0	0	0	30	17	0	16	6	0
38893	Border_Gateway_Protocol	200404	1	0	0	0	1	1	0	0	31	18	0	17	7	0
38893	Border_Gateway_Protocol	200405	7	0	0	0	3	1	0	0	38	21	0	22	8	0
38893	Border_Gateway_Protocol	200406	4	0	0	0	3	3	0	0	42	23	0	26	10	0
38893	Border_Gateway_Protocol	200407	1	0	0	0	1	1	0	0	43	24	0	27	11	0
38893	Border_Gateway_Protocol	200409	6	1	0	0	5	3	1	0	49	29	1	31	14	0
38893	Border_Gateway_Protocol	200410	14	0	0	0	4	3	0	0	63	32	1	43	16	0
38893	Border_Gateway_Protocol	200411	4	0	0	0	3	1	0	0	67	34	1	45	17	0
38893	Border_Gateway_Protocol	200412	8	1	0	0	5	2	1	0	75	39	2	47	19	0
38893	Border_Gateway_Protocol	200502	7	0	0	0	2	0	0	0	82	41	2	47	19	0
38893	Border_Gateway_Protocol	200503	2	0	0	0	2	1	0	0	84	42	2	48	19	0
38893	Border_Gateway_Protocol	200504	4	1	0	0	4	0	1	0	88	45	3	48	19	0
38893	Border_Gateway_Protocol	200505	2	0	0	0	2	2	0	0	90	47	3	50	21	0
38893	Border_Gateway_Protocol	200506	7	0	0	0	2	0	0	0	97	49	3	50	21	0
38893	Border_Gateway_Protocol	200507	2	0	0	0	2	1	0	0	99	51	3	51	22	0
38893	Border_Gateway_Protocol	200508	8	1	0	0	6	2	1	0	107	57	4	53	24	0
38893	Border_Gateway_Protocol	200509	9	1	0	0	6	3	1	0	116	63	5	57	27	0
38893	Border_Gateway_Protocol	200510	2	0	0	0	2	2	0	0	118	65	5	59	29	0
38893	Border_Gateway_Protocol	200511	5	0	0	0	4	3	0	0	123	69	5	62	32	0
38893	Border_Gateway_Protocol	200512	4	1	0	0	4	3	1	0	127	73	6	65	35	0
38893	Border_Gateway_Protocol	200601	3	1	0	0	3	2	1	0	130	75	7	67	36	0
38893	Border_Gateway_Protocol	200602	5	0	0	0	4	2	0	0	135	77	7	69	37	0
38893	Border_Gateway_Protocol	200603	10	1	0	0	5	2	1	0	145	80	8	71	37	0
38893	Border_Gateway_Protocol	200604	10	0	0	0	7	3	0	0	155	87	8	74	40	0
38893	Border_Gateway_Protocol	200605	13	1	0	0	11	4	1	0	168	97	9	78	43	0
38893	Border_Gateway_Protocol	200606	18	5	2	0	11	8	4	1	186	108	14	93	51	3
38893	Border_Gateway_Protocol	200607	16	0	0	0	12	8	0	0	202	119	14	103	58	3
38893	Border_Gateway_Protocol	200608	8	0	0	0	6	6	0	0	210	124	14	111	63	3
38893	Border_Gateway_Protocol	200609	13	1	0	0	10	4	1	0	223	134	15	116	67	3
38893	Border_Gateway_Protocol	200610	11	0	0	0	7	3	0	0	234	140	15	122	69	3
38893	Border_Gateway_Protocol	200611	8	0	0	0	4	0	0	0	242	144	15	122	69	3
38893	Border_Gateway_Protocol	200612	12	0	0	0	8	6	0	0	254	152	15	131	75	3
38893	Border_Gateway_Protocol	200701	18	3	0	0	14	9	3	0	272	165	18	140	83	3
38893	Border_Gateway_Protocol	200702	12	0	0	0	9	5	0	0	284	174	18	147	88	3
38893	Border_Gateway_Protocol	200703	5	0	0	0	5	4	0	0	289	179	18	151	92	3
38893	Border_Gateway_Protocol	200704	7	0	0	0	7	3	0	0	296	185	18	154	94	3
38893	Border_Gateway_Protocol	200705	12	2	0	0	12	5	2	0	308	195	20	159	97	3
38893	Border_Gateway_Protocol	200706	10	1	0	0	8	4	1	0	318	202	21	163	100	3
38893	Border_Gateway_Protocol	200707	27	3	0	0	13	7	3	0	345	213	24	180	105	3
38893	Border_Gateway_Protocol	200708	29	0	0	0	11	7	0	0	374	221	24	204	109	3
38893	Border_Gateway_Protocol	200709	8	1	0	0	6	2	1	0	382	227	25	206	111	3
38893	Border_Gateway_Protocol	200710	15	2	0	0	11	6	1	0	397	236	27	214	115	3
38893	Border_Gateway_Protocol	200711	6	1	0	0	5	3	1	0	403	240	28	218	117	3
38893	Border_Gateway_Protocol	200712	10	2	0	0	9	6	2	0	413	248	30	225	122	4
38893	Border_Gateway_Protocol	200801	5	3	1	0	4	3	2	1	418	251	33	229	124	6
38893	Border_Gateway_Protocol	200802	9	2	0	0	7	4	1	0	427	255	35	234	125	6
38893	Border_Gateway_Protocol	200803	8	0	0	0	6	4	0	0	435	260	35	238	128	6
38893	Border_Gateway_Protocol	200804	17	2	0	0	10	6	2	0	452	269	37	248	133	6
38893	Border_Gateway_Protocol	200805	16	3	0	0	13	6	3	0	468	278	40	255	135	6
38893	Border_Gateway_Protocol	200806	12	1	0	0	9	4	1	0	480	286	41	261	138	6
38893	Border_Gateway_Protocol	200807	7	1	0	0	5	4	1	0	487	289	42	267	140	6
38893	Border_Gateway_Protocol	200808	9	2	0	0	8	3	2	0	496	296	44	271	142	6
38893	Border_Gateway_Protocol	200809	11	2	0	0	9	6	1	0	507	303	46	279	147	7
38893	Border_Gateway_Protocol	200810	4	0	0	0	4	1	0	0	511	307	46	280	148	7
38893	Border_Gateway_Protocol	200811	6	1	0	0	6	3	1	0	517	312	47	283	150	7
38893	Border_Gateway_Protocol	200812	9	2	0	0	9	6	2	0	526	321	49	289	156	7
38893	Border_Gateway_Protocol	200901	14	5	2	1	11	7	4	2	540	331	54	299	162	10
38893	Border_Gateway_Protocol	200902	15	3	0	0	9	6	3	0	555	340	57	305	168	10
38893	Border_Gateway_Protocol	200903	15	4	0	0	11	2	4	0	570	350	61	308	169	10
38893	Border_Gateway_Protocol	200904	14	1	0	0	13	8	1	0	584	359	62	316	174	10
38893	Border_Gateway_Protocol	200905	15	4	0	0	11	6	4	0	599	368	66	326	178	10
38893	Border_Gateway_Protocol	200906	9	1	0	0	7	4	1	0	608	373	67	332	180	10
38893	Border_Gateway_Protocol	200907	4	1	0	0	4	1	1	0	612	376	68	333	180	10
38893	Border_Gateway_Protocol	200908	3	0	0	0	3	3	0	0	615	379	68	336	183	10
38893	Border_Gateway_Protocol	200909	4	0	0	0	3	1	0	0	619	382	68	337	184	10
38893	Border_Gateway_Protocol	200910	10	0	0	0	7	5	0	0	629	387	68	343	187	10
38893	Border_Gateway_Protocol	200911	4	1	0	0	4	3	1	0	633	390	69	346	189	10
38893	Border_Gateway_Protocol	200912	10	0	0	0	5	3	0	0	643	394	69	354	191	10
38893	Border_Gateway_Protocol	201001	5	0	0	0	5	2	0	0	648	399	69	356	193	10
38893	Border_Gateway_Protocol	201002	4	0	0	0	3	1	0	0	652	402	69	357	194	10
38893	Border_Gateway_Protocol	201003	6	1	0	0	5	2	1	0	658	407	70	359	196	10
38893	Border_Gateway_Protocol	201004	7	1	0	0	4	2	1	0	665	411	71	361	198	10
38893	Border_Gateway_Protocol	201005	9	1	0	0	7	3	1	0	674	418	72	364	201	10
38893	Border_Gateway_Protocol	201006	3	0	0	0	3	1	0	0	677	420	72	365	201	10
38893	Border_Gateway_Protocol	201007	2	0	0	0	2	1	0	0	679	422	72	366	202	10
38893	Border_Gateway_Protocol	201008	36	2	0	0	7	4	2	0	715	428	74	372	205	11
38893	Border_Gateway_Protocol	201009	11	0	0	0	10	5	0	0	726	436	74	378	208	11
38893	Border_Gateway_Protocol	201010	8	1	0	0	6	2	1	0	734	442	75	380	210	11
38893	Border_Gateway_Protocol	201011	3	1	0	0	3	2	1	0	737	444	76	382	211	11
38893	Border_Gateway_Protocol	201012	7	0	0	0	5	2	0	0	744	449	76	384	213	11
38893	Border_Gateway_Protocol	201101	4	0	0	0	3	0	0	0	748	452	76	384	213	11
38893	Border_Gateway_Protocol	201102	13	2	0	0	9	4	2	0	761	459	78	388	215	11
38893	Border_Gateway_Protocol	201103	4	0	0	0	3	1	0	0	765	462	78	389	216	11
38893	Border_Gateway_Protocol	201104	5	0	0	0	4	1	0	0	770	466	78	390	217	11
38893	Border_Gateway_Protocol	201105	2	0	0	0	1	0	0	0	772	467	78	390	217	11
38893	Border_Gateway_Protocol	201106	4	0	0	0	4	4	0	0	776	470	78	394	220	11
38893	Border_Gateway_Protocol	201107	9	1	0	0	8	4	1	0	785	478	79	398	224	11
38893	Border_Gateway_Protocol	201108	5	0	0	0	4	3	0	0	790	481	79	401	226	11
38893	Border_Gateway_Protocol	201109	7	0	0	0	6	5	0	0	797	486	79	406	230	11
38893	Border_Gateway_Protocol	201110	5	1	0	0	5	3	1	0	802	489	80	409	231	11
38893	Border_Gateway_Protocol	201111	3	0	0	0	3	0	0	0	805	492	80	409	231	11
38893	Border_Gateway_Protocol	201112	1	0	0	0	1	0	0	0	806	493	80	409	231	11
38893	Border_Gateway_Protocol	201201	8	0	0	0	7	5	0	0	814	499	80	414	235	11
38893	Border_Gateway_Protocol	201202	16	1	0	0	11	3	1	0	830	510	81	418	238	11
38893	Border_Gateway_Protocol	201203	4	0	0	0	3	1	0	0	834	513	81	420	239	11
38893	Border_Gateway_Protocol	201204	8	1	0	0	6	3	1	0	842	519	82	423	242	11
38893	Border_Gateway_Protocol	201205	3	1	0	0	3	1	1	0	845	522	83	424	243	11
38893	Border_Gateway_Protocol	201206	3	1	0	0	3	1	1	0	848	525	84	425	244	11
38893	Border_Gateway_Protocol	201207	5	0	0	0	3	3	0	0	853	528	84	430	247	11
38893	Border_Gateway_Protocol	201208	10	2	0	0	9	4	2	0	863	535	86	434	249	11
38893	Border_Gateway_Protocol	201209	4	1	0	0	4	2	1	0	867	538	87	436	250	11
38893	Border_Gateway_Protocol	201210	3	0	0	0	3	1	0	0	870	539	87	437	250	11
38893	Border_Gateway_Protocol	201211	5	1	0	0	5	2	1	0	875	543	88	439	251	11
38893	Border_Gateway_Protocol	201212	4	0	0	0	4	2	0	0	879	545	88	441	251	11
38893	Border_Gateway_Protocol	201301	6	2	0	0	6	4	2	0	885	551	90	445	254	11
38893	Border_Gateway_Protocol	201302	5	0	0	0	2	1	0	0	890	553	90	448	255	11
38893	Border_Gateway_Protocol	201303	3	0	0	0	3	2	0	0	893	556	90	450	257	11
38893	Border_Gateway_Protocol	201304	7	0	0	0	5	3	0	0	900	561	90	453	259	11
38893	Border_Gateway_Protocol	201305	13	1	0	0	11	3	1	0	913	571	91	457	262	11
38893	Border_Gateway_Protocol	201306	2	0	0	0	2	2	0	0	915	573	91	459	264	11
38893	Border_Gateway_Protocol	201307	12	2	0	0	10	3	2	0	927	582	93	463	266	11
38893	Border_Gateway_Protocol	201308	2	0	0	0	2	2	0	0	929	583	93	465	267	11
38893	Border_Gateway_Protocol	201309	6	1	0	0	5	3	1	0	935	587	94	469	269	12
38893	Border_Gateway_Protocol	201310	3	0	0	0	3	1	0	0	938	590	94	470	270	12
38893	Border_Gateway_Protocol	201311	12	0	0	0	11	9	0	0	950	597	94	480	275	12
38893	Border_Gateway_Protocol	201312	6	1	0	0	6	4	1	0	956	602	95	484	278	12
38893	Border_Gateway_Protocol	201401	9	0	0	0	6	3	0	0	965	606	95	488	279	12
38893	Border_Gateway_Protocol	201402	3	0	0	0	3	1	0	0	968	609	95	489	280	12
38893	Border_Gateway_Protocol	201403	4	0	0	0	3	1	0	0	972	611	95	490	280	12
38893	Border_Gateway_Protocol	201404	8	2	0	0	7	4	2	0	980	615	97	494	281	12
38893	Border_Gateway_Protocol	201405	2	0	0	0	2	2	0	0	982	616	97	496	282	12
38893	Border_Gateway_Protocol	201406	6	1	0	0	5	4	1	0	988	618	98	501	283	12
38893	Border_Gateway_Protocol	201407	4	0	0	0	3	2	0	0	992	620	98	504	284	12
38893	Border_Gateway_Protocol	201408	3	0	0	0	3	2	0	0	995	622	98	506	285	12
38893	Border_Gateway_Protocol	201409	16	0	0	0	7	5	0	0	1011	627	98	519	288	12
38893	Border_Gateway_Protocol	201410	14	3	0	0	8	4	3	0	1025	633	101	524	290	12
38893	Border_Gateway_Protocol	201411	1	0	0	0	1	1	0	0	1026	634	101	525	291	12
38893	Border_Gateway_Protocol	201412	7	1	0	0	5	3	1	0	1033	639	102	528	294	12
38893	Border_Gateway_Protocol	201501	3	1	0	0	2	1	1	0	1036	641	103	530	295	12
38893	Border_Gateway_Protocol	201502	18	1	0	0	7	6	1	0	1054	647	104	547	300	12
38893	Border_Gateway_Protocol	201503	5	0	0	0	4	3	0	0	1059	650	104	551	302	12
38893	Border_Gateway_Protocol	201504	9	1	0	0	7	4	1	0	1068	657	105	556	306	12
38893	Border_Gateway_Protocol	201505	8	2	0	0	7	4	2	0	1076	662	107	561	308	12
38893	Border_Gateway_Protocol	201506	5	1	0	0	4	2	1	0	1081	665	108	563	309	12
38893	Border_Gateway_Protocol	201507	4	0	0	0	4	2	0	0	1085	668	108	565	310	12
38893	Border_Gateway_Protocol	201508	4	0	0	0	4	0	0	0	1089	672	108	565	310	12
38893	Border_Gateway_Protocol	201509	5	1	0	0	5	4	1	0	1094	673	109	569	311	13
38893	Border_Gateway_Protocol	201510	2	1	0	0	2	1	1	0	1096	674	110	570	311	13
38893	Border_Gateway_Protocol	201511	2	0	0	0	2	1	0	0	1098	675	110	571	311	13
38893	Border_Gateway_Protocol	201512	11	1	0	0	6	3	1	0	1109	679	111	578	312	13
38893	Border_Gateway_Protocol	201601	10	3	0	0	7	5	2	0	1119	685	114	584	316	14
38893	Border_Gateway_Protocol	201602	4	0	0	0	4	2	0	0	1123	688	114	586	317	14
38893	Border_Gateway_Protocol	201603	12	0	0	0	8	2	0	0	1135	695	114	588	318	14
38893	Border_Gateway_Protocol	201604	5	1	0	0	5	3	1	0	1140	700	115	591	321	14
38893	Border_Gateway_Protocol	201605	2	1	0	0	2	1	1	0	1142	702	116	592	322	14
38893	Border_Gateway_Protocol	201606	2	0	0	0	2	2	0	0	1144	704	116	594	324	14
38893	Border_Gateway_Protocol	201607	7	2	1	0	4	4	2	1	1151	708	118	601	326	16
38893	Border_Gateway_Protocol	201608	2	1	0	0	2	1	1	0	1153	710	119	602	327	17
38893	Border_Gateway_Protocol	201609	3	1	0	0	3	0	1	0	1156	713	120	602	327	17
38893	Border_Gateway_Protocol	201610	1	0	0	0	1	1	0	0	1157	714	120	603	327	17
38893	Border_Gateway_Protocol	201611	7	0	0	0	2	2	0	0	1164	716	120	610	328	17
38893	Border_Gateway_Protocol	201612	14	5	0	0	10	6	3	0	1178	723	125	618	331	17
38893	Border_Gateway_Protocol	201701	6	0	0	0	6	5	0	0	1184	729	125	623	334	17
38893	Border_Gateway_Protocol	201702	4	0	0	0	3	3	0	0	1188	731	125	627	336	17
38893	Border_Gateway_Protocol	201703	2	0	0	0	2	0	0	0	1190	733	125	627	336	17
38893	Border_Gateway_Protocol	201705	1	0	0	0	1	1	0	0	1191	734	125	628	337	17
38893	Border_Gateway_Protocol	201706	5	2	0	0	3	2	1	0	1196	736	127	631	337	18
38893	Border_Gateway_Protocol	201707	4	0	0	0	4	3	0	0	1200	740	127	634	340	18
38893	Border_Gateway_Protocol	201708	11	1	0	0	9	5	1	0	1211	747	128	639	343	18
38893	Border_Gateway_Protocol	201709	3	1	0	0	3	2	1	0	1214	749	129	641	344	18
38893	Border_Gateway_Protocol	201710	1	0	0	0	1	0	0	0	1215	750	129	641	344	18
38893	Border_Gateway_Protocol	201711	8	0	0	0	4	3	0	0	1223	753	129	647	346	18
38893	Border_Gateway_Protocol	201712	2	0	0	0	1	0	0	0	1225	754	129	647	346	18
38893	Border_Gateway_Protocol	201801	2	0	0	0	2	2	0	0	1227	756	129	649	348	18
38893	Border_Gateway_Protocol	201802	1	0	0	0	1	1	0	0	1228	757	129	650	349	18
38893	Border_Gateway_Protocol	201803	3	0	0	0	2	2	0	0	1231	759	129	653	351	18
38893	Border_Gateway_Protocol	201804	6	0	0	0	5	5	0	0	1237	764	129	659	355	18
38893	Border_Gateway_Protocol	201805	8	0	0	0	6	3	0	0	1245	770	129	662	358	18
38893	Border_Gateway_Protocol	201806	7	1	0	0	6	5	1	0	1252	775	130	668	362	18
38893	Border_Gateway_Protocol	201807	5	0	0	0	3	3	0	0	1257	777	130	673	364	18
636268	Botnet	200408	1	0	0	0	1	1	0	0	1	1	0	1	1	0
636268	Botnet	200409	5	0	0	0	1	1	0	0	6	2	0	6	2	0
636268	Botnet	200410	2	0	0	0	2	1	0	0	8	4	0	7	3	0
636268	Botnet	200411	1	0	0	0	1	1	0	0	9	5	0	8	4	0
636268	Botnet	200412	1	0	0	0	1	1	0	0	10	6	0	9	5	0
636268	Botnet	200501	24	0	0	0	8	2	0	0	34	13	0	25	6	0
636268	Botnet	200502	4	0	0	0	3	2	0	0	38	15	0	28	7	0
636268	Botnet	200503	1	0	0	0	1	0	0	0	39	16	0	28	7	0
636268	Botnet	200504	14	0	0	0	10	4	0	0	53	26	0	33	11	0
636268	Botnet	200505	3	0	0	0	3	2	0	0	56	29	0	35	13	0
636268	Botnet	200506	5	0	0	0	5	3	0	0	61	32	0	38	14	0
636268	Botnet	200508	3	0	0	0	2	1	0	0	64	34	0	40	15	0
636268	Botnet	200509	5	1	0	0	4	1	1	0	69	38	1	41	16	0
636268	Botnet	200510	1	0	0	0	1	0	0	0	70	39	1	41	16	0
636268	Botnet	200511	1	0	0	0	1	0	0	0	71	40	1	41	16	0
636268	Botnet	200512	8	0	0	0	5	1	0	0	79	45	1	44	17	0
636268	Botnet	200601	11	0	0	0	5	4	0	0	90	50	1	54	21	0
636268	Botnet	200602	8	0	0	0	7	4	0	0	98	57	1	58	25	0
636268	Botnet	200603	8	1	0	0	8	3	1	0	106	65	2	61	28	0
636268	Botnet	200604	2	1	0	0	2	1	1	0	108	67	3	62	29	0
636268	Botnet	200605	4	0	0	0	4	3	0	0	112	71	3	65	32	0
636268	Botnet	200606	9	0	0	0	4	1	0	0	121	75	3	66	33	0
636268	Botnet	200607	5	0	0	0	4	1	0	0	126	79	3	67	34	0
636268	Botnet	200608	3	0	0	0	3	2	0	0	129	82	3	69	36	0
636268	Botnet	200609	7	0	0	0	5	2	0	0	136	87	3	72	38	0
636268	Botnet	200610	28	7	2	1	15	12	6	2	164	98	10	92	47	3
636268	Botnet	200611	14	1	0	0	12	3	1	0	178	108	11	95	50	3
636268	Botnet	200612	7	1	0	0	7	2	1	0	185	115	12	97	52	3
636268	Botnet	200701	17	1	0	0	12	6	1	0	202	125	13	106	58	3
636268	Botnet	200702	18	3	0	0	14	8	3	0	220	138	16	116	65	3
636268	Botnet	200703	26	6	0	0	12	4	3	0	246	147	22	123	67	4
636268	Botnet	200704	6	1	0	0	6	3	1	0	252	151	23	126	69	4
636268	Botnet	200705	9	1	0	0	8	6	1	0	261	157	24	133	73	4
636268	Botnet	200706	11	0	0	0	9	6	0	0	272	166	24	140	79	4
636268	Botnet	200707	11	4	0	0	8	4	3	0	283	173	28	145	82	4
636268	Botnet	200708	9	1	0	0	8	4	1	0	292	180	29	149	86	4
636268	Botnet	200709	7	2	0	0	5	3	2	0	299	184	31	152	88	4
636268	Botnet	200710	22	3	0	0	14	7	1	0	321	196	34	165	93	5
636268	Botnet	200711	13	4	0	0	10	6	3	0	334	206	38	172	99	5
636268	Botnet	200712	16	3	0	0	12	6	3	0	350	216	41	179	103	5
636268	Botnet	200801	5	0	0	0	5	4	0	0	355	220	41	183	106	5
636268	Botnet	200802	8	1	0	0	7	1	1	0	363	227	42	184	107	5
636268	Botnet	200803	19	9	3	2	15	9	6	2	382	240	51	197	114	10
636268	Botnet	200804	30	7	0	0	25	15	6	0	412	263	58	215	127	12
636268	Botnet	200805	15	3	0	0	10	7	3	0	427	268	61	223	129	13
636268	Botnet	200806	7	1	0	0	5	4	1	0	434	273	62	228	133	13
636268	Botnet	200807	9	0	0	0	5	3	0	0	443	278	62	233	136	13
636268	Botnet	200808	25	5	0	0	14	9	5	0	468	288	67	247	141	13
636268	Botnet	200809	14	6	0	0	7	6	5	0	482	295	73	254	147	13
636268	Botnet	200810	13	5	0	0	11	7	4	0	495	303	78	262	151	14
636268	Botnet	200811	20	2	0	0	12	7	2	0	515	312	80	271	155	15
636268	Botnet	200812	14	4	0	0	11	6	4	0	529	321	84	278	159	17
636268	Botnet	200901	16	3	0	0	11	7	2	0	545	330	87	289	164	18
636268	Botnet	200902	9	0	0	0	6	4	0	0	554	336	87	295	168	18
636268	Botnet	200903	12	1	0	0	9	5	1	0	566	343	88	303	171	18
636268	Botnet	200904	14	2	0	0	12	3	2	0	580	353	90	306	172	18
636268	Botnet	200905	9	1	0	0	7	3	1	0	589	358	91	309	173	18
636268	Botnet	200906	20	6	0	0	13	6	5	0	609	368	97	316	176	18
636268	Botnet	200907	12	1	0	0	6	2	1	0	621	373	98	318	177	18
636268	Botnet	200908	20	7	4	2	11	7	4	2	641	382	105	327	183	21
636268	Botnet	200909	33	15	6	4	19	9	6	3	674	398	120	343	189	24
636268	Botnet	200910	9	4	0	0	6	2	2	0	683	402	124	347	189	24
636268	Botnet	200911	21	7	0	0	13	6	4	0	704	410	131	356	190	27
636268	Botnet	200912	8	3	0	0	6	2	2	0	712	414	134	359	190	27
636268	Botnet	201001	3	1	0	0	3	1	1	0	715	416	135	360	190	27
636268	Botnet	201002	8	3	0	0	8	5	3	0	723	422	138	365	193	28
636268	Botnet	201003	12	0	0	0	9	3	0	0	735	429	138	369	194	28
636268	Botnet	201004	34	10	0	0	16	9	4	0	769	442	148	389	200	34
636268	Botnet	201006	8	1	0	0	5	3	1	0	777	446	149	393	202	34
636268	Botnet	201007	8	2	0	0	7	4	2	0	785	453	151	397	206	34
636268	Botnet	201008	28	0	0	0	7	6	0	0	813	458	151	424	210	34
636268	Botnet	201009	8	2	0	0	6	4	2	0	821	462	153	430	212	35
636268	Botnet	201010	8	3	0	0	6	4	2	0	829	466	156	436	214	36
636268	Botnet	201011	13	2	0	0	9	4	2	0	842	474	158	442	217	36
636268	Botnet	201012	22	4	0	0	14	9	3	0	864	486	162	459	224	37
636268	Botnet	201101	7	2	0	0	6	4	2	0	871	492	164	463	228	37
636268	Botnet	201102	5	0	0	0	5	2	0	0	876	497	164	465	230	37
636268	Botnet	201103	10	2	0	0	7	1	2	0	886	503	166	466	230	37
636268	Botnet	201104	15	7	0	0	13	6	7	0	901	514	173	474	234	40
636268	Botnet	201105	17	1	0	0	10	4	1	0	918	523	174	483	237	40
636268	Botnet	201106	8	1	0	0	7	3	1	0	926	529	175	486	239	40
636268	Botnet	201107	10	1	0	0	9	4	1	0	936	536	176	490	241	40
636268	Botnet	201108	20	3	0	0	17	9	3	0	956	550	179	500	247	41
636268	Botnet	201109	57	14	1	0	30	12	12	1	1013	576	193	525	255	43
636268	Botnet	201110	10	2	0	0	7	5	1	0	1023	582	195	533	259	43
636268	Botnet	201111	7	0	0	0	6	4	0	0	1030	588	195	537	263	43
636268	Botnet	201112	18	1	0	0	15	9	1	0	1048	601	196	548	270	43
636268	Botnet	201201	13	1	0	0	7	3	1	0	1061	608	197	551	273	43
636268	Botnet	201202	20	3	0	0	12	9	3	0	1081	617	200	568	279	43
636268	Botnet	201203	21	6	0	0	13	6	3	0	1102	626	206	576	281	43
636268	Botnet	201204	9	2	0	0	8	4	2	0	1111	632	208	581	283	43
636268	Botnet	201205	6	0	0	0	4	1	0	0	1117	636	208	584	284	43
636268	Botnet	201206	9	4	0	0	8	5	3	0	1126	642	212	590	287	44
636268	Botnet	201207	39	1	0	0	6	5	1	0	1165	647	213	628	291	44
636268	Botnet	201208	24	6	0	0	15	10	4	0	1189	659	219	646	298	44
636268	Botnet	201209	15	4	0	0	12	8	4	0	1204	667	223	654	302	44
636268	Botnet	201210	7	2	0	0	6	2	2	0	1211	672	225	656	303	44
636268	Botnet	201211	7	2	0	0	7	3	2	0	1218	678	227	659	305	44
636268	Botnet	201212	2	0	0	0	2	2	0	0	1220	680	227	661	307	44
636268	Botnet	201301	12	2	0	0	10	5	2	0	1232	689	229	667	311	44
636268	Botnet	201302	5	1	0	0	5	3	1	0	1237	693	230	670	313	44
636268	Botnet	201303	8	1	0	0	7	5	1	0	1245	699	231	676	317	44
636268	Botnet	201304	11	1	0	0	10	4	1	0	1256	709	232	680	321	44
636268	Botnet	201305	2	0	0	0	2	1	0	0	1258	711	232	681	322	44
636268	Botnet	201306	12	4	0	0	11	4	4	0	1270	720	236	685	324	44
636268	Botnet	201307	4	1	0	0	4	1	1	0	1274	724	237	686	325	44
636268	Botnet	201308	6	2	0	0	6	4	2	0	1280	728	239	690	327	45
636268	Botnet	201309	4	1	0	0	4	2	1	0	1284	731	240	692	328	45
636268	Botnet	201310	2	0	0	0	2	1	0	0	1286	733	240	693	329	45
636268	Botnet	201311	10	1	0	0	8	4	1	0	1296	738	241	697	330	45
636268	Botnet	201312	9	1	0	0	5	2	1	0	1305	742	242	700	331	45
636268	Botnet	201401	12	3	0	0	10	3	3	0	1317	751	245	703	333	45
636268	Botnet	201402	6	1	0	0	5	3	1	0	1323	754	246	707	334	45
636268	Botnet	201403	4	1	0	0	4	2	1	0	1327	757	247	709	335	45
636268	Botnet	201404	11	4	0	0	9	5	3	0	1338	764	251	715	337	45
636268	Botnet	201405	8	2	0	0	7	4	2	0	1346	769	253	720	339	46
636268	Botnet	201406	4	2	0	0	2	1	1	0	1350	770	255	722	339	46
636268	Botnet	201407	21	4	0	0	9	7	4	0	1371	775	259	737	342	46
636268	Botnet	201409	4	0	0	0	4	4	0	0	1375	779	259	741	346	46
636268	Botnet	201410	6	1	0	0	6	3	1	0	1381	782	260	744	346	46
636268	Botnet	201411	2	1	0	0	2	1	1	0	1383	784	261	745	347	46
636268	Botnet	201501	2	0	0	0	2	2	0	0	1385	785	261	747	348	46
636268	Botnet	201502	4	2	0	0	4	2	2	0	1389	789	263	749	350	46
636268	Botnet	201503	8	0	0	0	7	4	0	0	1397	795	263	754	353	46
636268	Botnet	201504	8	1	0	0	7	3	1	0	1405	801	264	757	355	46
636268	Botnet	201505	10	3	0	0	8	5	3	0	1415	808	267	764	358	47
636268	Botnet	201506	5	1	0	0	4	3	1	0	1420	811	268	768	360	47
636268	Botnet	201507	13	1	0	0	9	4	1	0	1433	817	269	774	361	47
636268	Botnet	201508	3	0	0	0	3	2	0	0	1436	819	269	776	362	47
636268	Botnet	201509	29	14	9	5	10	7	6	3	1465	827	283	794	364	60
636268	Botnet	201510	8	3	0	0	7	5	2	0	1473	833	286	800	366	62
636268	Botnet	201511	6	1	0	0	5	5	1	0	1479	837	287	806	369	63
636268	Botnet	201512	4	3	1	0	3	2	3	1	1483	840	290	808	371	64
636268	Botnet	201601	9	2	0	0	6	6	2	0	1492	845	292	817	376	66
636268	Botnet	201602	7	2	0	0	6	4	2	0	1499	850	294	821	379	67
636268	Botnet	201603	7	1	0	0	6	5	1	0	1506	853	295	827	381	67
636268	Botnet	201604	21	0	0	0	10	8	0	0	1527	858	295	846	383	67
636268	Botnet	201605	10	0	0	0	8	5	0	0	1537	864	295	853	386	67
636268	Botnet	201606	7	0	0	0	3	3	0	0	1544	866	295	860	387	67
636268	Botnet	201607	31	5	0	0	12	9	3	0	1575	875	300	887	393	69
636268	Botnet	201608	4	0	0	0	4	3	0	0	1579	878	300	890	395	69
636268	Botnet	201609	5	0	0	0	5	3	0	0	1584	881	300	893	396	69
636268	Botnet	201610	3	0	0	0	2	2	0	0	1587	882	300	896	397	69
636268	Botnet	201611	4	1	0	0	4	2	1	0	1591	885	301	898	398	69
636268	Botnet	201612	2	1	0	0	2	2	1	0	1593	886	302	900	399	70
636268	Botnet	201701	13	3	0	0	9	6	3	0	1606	894	305	909	404	71
636268	Botnet	201702	4	1	0	0	3	2	1	0	1610	895	306	911	404	71
636268	Botnet	201703	10	3	0	0	9	7	3	0	1620	902	309	919	409	72
636268	Botnet	201704	1	0	0	0	1	1	0	0	1621	903	309	920	410	72
636268	Botnet	201705	5	2	0	0	5	2	2	0	1626	907	311	922	411	72
636268	Botnet	201706	67	0	0	0	8	7	0	0	1693	912	311	988	415	72
636268	Botnet	201707	12	0	0	0	7	7	0	0	1705	917	311	1000	420	72
636268	Botnet	201708	8	2	0	0	6	6	2	0	1713	922	313	1008	425	74
636268	Botnet	201709	8	0	0	0	8	7	0	0	1721	928	313	1015	430	74
636268	Botnet	201710	4	1	0	0	4	4	1	0	1725	930	314	1019	431	75
636268	Botnet	201711	6	0	0	0	5	5	0	0	1731	935	314	1025	435	75
636268	Botnet	201712	4	1	0	0	4	3	1	0	1735	937	315	1028	436	75
636268	Botnet	201801	11	3	0	0	9	5	3	0	1746	946	318	1035	440	77
636268	Botnet	201802	1	0	0	0	1	0	0	0	1747	947	318	1035	440	77
636268	Botnet	201803	8	2	0	0	6	5	2	0	1755	952	320	1040	441	78
636268	Botnet	201804	4	0	0	0	3	1	0	0	1759	954	320	1041	441	78
636268	Botnet	201806	8	3	0	0	6	5	3	0	1767	959	323	1048	444	81
636268	Botnet	201807	8	3	0	0	7	3	3	0	1775	965	326	1051	445	81
23553163	Brain-computer_interface	201002	1	0	0	0	1	1	0	0	1	1	0	1	1	0
30862029	C-RAN	201103	2	0	0	0	2	2	0	0	2	2	0	2	2	0
30862029	C-RAN	201104	1	0	0	0	1	1	0	0	3	3	0	3	3	0
30862029	C-RAN	201107	2	0	0	0	2	2	0	0	5	5	0	5	5	0
30862029	C-RAN	201201	1	0	0	0	1	0	0	0	6	6	0	5	5	0
30862029	C-RAN	201203	3	0	0	0	2	2	0	0	9	8	0	8	7	0
30862029	C-RAN	201206	1	0	0	0	1	1	0	0	10	9	0	9	8	0
30862029	C-RAN	201207	7	0	0	0	2	2	0	0	17	10	0	16	9	0
30862029	C-RAN	201208	1	0	0	0	1	0	0	0	18	11	0	16	9	0
30862029	C-RAN	201209	2	0	0	0	1	1	0	0	20	12	0	18	10	0
30862029	C-RAN	201211	3	0	0	0	3	2	0	0	23	14	0	20	11	0
30862029	C-RAN	201212	3	0	0	0	3	2	0	0	26	17	0	22	13	0
30862029	C-RAN	201301	1	0	0	0	1	1	0	0	27	18	0	23	14	0
30862029	C-RAN	201302	10	0	0	0	4	4	0	0	37	22	0	33	18	0
30862029	C-RAN	201304	1	0	0	0	1	1	0	0	38	23	0	34	19	0
30862029	C-RAN	201305	1	0	0	0	1	0	0	0	39	24	0	34	19	0
30862029	C-RAN	201312	6	0	0	0	3	2	0	0	45	26	0	39	20	0
30862029	C-RAN	201401	15	0	0	0	3	2	0	0	60	27	0	49	21	0
30862029	C-RAN	201402	1	0	0	0	1	1	0	0	61	28	0	50	22	0
30862029	C-RAN	201403	5	0	0	0	5	4	0	0	66	33	0	54	26	0
30862029	C-RAN	201404	1	0	0	0	1	1	0	0	67	34	0	55	27	0
30862029	C-RAN	201405	3	0	0	0	3	1	0	0	70	35	0	56	27	0
30862029	C-RAN	201406	1	0	0	0	1	0	0	0	71	36	0	56	27	0
30862029	C-RAN	201407	3	1	0	0	3	2	1	0	74	39	1	58	29	0
30862029	C-RAN	201408	1	0	0	0	1	0	0	0	75	39	1	58	29	0
30862029	C-RAN	201411	2	1	0	0	2	1	1	0	77	41	2	59	30	0
30862029	C-RAN	201501	1	0	0	0	1	0	0	0	78	42	2	59	30	0
30862029	C-RAN	201503	2	0	0	0	1	0	0	0	80	43	2	59	30	0
30862029	C-RAN	201504	1	0	0	0	1	1	0	0	81	44	2	60	31	0
30862029	C-RAN	201506	1	0	0	0	1	0	0	0	82	45	2	60	31	0
30862029	C-RAN	201508	1	0	0	0	1	1	0	0	83	46	2	61	32	0
30862029	C-RAN	201509	1	0	0	0	1	0	0	0	84	47	2	61	32	0
30862029	C-RAN	201511	1	0	0	0	1	0	0	0	85	48	2	61	32	0
30862029	C-RAN	201512	12	0	0	0	2	1	0	0	97	50	2	72	33	0
30862029	C-RAN	201601	1	0	0	0	1	0	0	0	98	51	2	72	33	0
30862029	C-RAN	201602	5	0	0	0	1	0	0	0	103	52	2	72	33	0
30862029	C-RAN	201605	3	0	0	0	3	3	0	0	106	55	2	75	36	0
30862029	C-RAN	201606	1	0	0	0	1	1	0	0	107	56	2	76	37	0
30862029	C-RAN	201607	6	0	0	0	3	3	0	0	113	58	2	82	39	0
30862029	C-RAN	201610	1	0	0	0	1	0	0	0	114	59	2	82	39	0
30862029	C-RAN	201611	3	0	0	0	1	1	0	0	117	60	2	85	40	0
30862029	C-RAN	201702	1	0	0	0	1	1	0	0	118	61	2	86	41	0
30862029	C-RAN	201703	1	0	0	0	1	1	0	0	119	62	2	87	42	0
30862029	C-RAN	201704	1	0	0	0	1	1	0	0	120	63	2	88	43	0
30862029	C-RAN	201705	1	0	0	0	1	0	0	0	121	64	2	88	43	0
30862029	C-RAN	201710	2	0	0	0	2	1	0	0	123	66	2	89	44	0
30862029	C-RAN	201712	1	0	0	0	1	0	0	0	124	67	2	89	44	0
30862029	C-RAN	201801	2	0	0	0	1	0	0	0	126	68	2	89	44	0
30862029	C-RAN	201802	12	0	0	0	3	2	0	0	138	71	2	99	46	0
1731315	C2Net	200511	1	0	0	0	1	0	0	0	1	1	0	0	0	0
1731315	C2Net	200601	2	0	0	0	2	1	0	0	3	3	0	1	1	0
1731315	C2Net	200603	1	0	0	0	1	1	0	0	4	4	0	2	2	0
1731315	C2Net	200606	3	1	0	0	3	2	1	0	7	6	1	4	3	0
1731315	C2Net	200611	1	0	0	0	1	1	0	0	8	7	1	5	4	0
1731315	C2Net	200701	7	0	0	0	4	4	0	0	15	10	1	12	7	0
1731315	C2Net	200703	1	0	0	0	1	1	0	0	16	11	1	13	8	0
1731315	C2Net	200705	1	0	0	0	1	0	0	0	17	12	1	13	8	0
1731315	C2Net	200709	1	0	0	0	1	1	0	0	18	13	1	14	9	0
1731315	C2Net	200711	1	0	0	0	1	1	0	0	19	14	1	15	10	0
1731315	C2Net	200805	1	0	0	0	1	1	0	0	20	15	1	16	11	0
1731315	C2Net	200908	3	0	0	0	2	2	0	0	23	17	1	19	13	0
1731315	C2Net	201202	3	0	0	0	3	2	0	0	26	20	1	21	15	0
1731315	C2Net	201505	1	0	0	0	1	1	0	0	27	21	1	22	16	0
1731315	C2Net	201708	1	0	0	0	1	1	0	0	28	22	1	23	17	0
1731315	C2Net	201709	12	0	0	0	4	3	0	0	40	26	1	34	20	0
1731315	C2Net	201711	3	0	0	0	2	2	0	0	43	28	1	37	22	0
1731315	C2Net	201802	1	0	0	0	1	1	0	0	44	29	1	38	23	0
1731315	C2Net	201804	1	0	0	0	1	1	0	0	45	30	1	39	24	0
51407038	CBOR	201612	9	0	0	0	6	5	0	0	9	6	0	8	5	0
51407038	CBOR	201703	1	0	0	0	1	0	0	0	10	7	0	8	5	0
51407038	CBOR	201704	3	0	0	0	2	2	0	0	13	9	0	11	7	0
51407038	CBOR	201705	1	0	0	0	1	1	0	0	14	10	0	12	8	0
51407038	CBOR	201707	2	0	0	0	1	1	0	0	16	11	0	14	9	0
51407038	CBOR	201708	13	0	0	0	2	1	0	0	29	13	0	26	10	0
51407038	CBOR	201709	1	0	0	0	1	1	0	0	30	14	0	27	11	0
51407038	CBOR	201802	1	0	0	0	1	1	0	0	31	15	0	28	12	0
51407038	CBOR	201804	8	0	0	0	3	3	0	0	39	18	0	36	14	0
51407038	CBOR	201805	6	0	0	0	3	2	0	0	45	20	0	41	15	0
51407038	CBOR	201807	1	0	0	0	1	1	0	0	46	21	0	42	16	0
15656695	Carrier_Ethernet	200803	6	0	0	0	2	1	0	0	6	2	0	4	1	0
15656695	Carrier_Ethernet	200804	13	3	0	0	6	5	2	0	19	8	3	12	6	0
15656695	Carrier_Ethernet	200807	1	0	0	0	1	1	0	0	20	9	3	13	7	0
15656695	Carrier_Ethernet	200808	1	0	0	0	1	1	0	0	21	10	3	14	8	0
15656695	Carrier_Ethernet	200902	1	0	0	0	1	1	0	0	22	11	3	15	9	0
15656695	Carrier_Ethernet	200904	2	0	0	0	1	1	0	0	24	12	3	17	10	0
15656695	Carrier_Ethernet	200906	2	0	0	0	2	2	0	0	26	14	3	19	12	0
15656695	Carrier_Ethernet	200909	3	0	0	0	2	1	0	0	29	16	3	20	13	0
15656695	Carrier_Ethernet	200910	4	0	0	0	3	3	0	0	33	18	3	24	15	0
15656695	Carrier_Ethernet	200911	1	0	0	0	1	0	0	0	34	19	3	24	15	0
15656695	Carrier_Ethernet	201002	9	0	0	0	3	2	0	0	43	22	3	31	17	0
15656695	Carrier_Ethernet	201004	2	1	0	0	2	2	1	0	45	24	4	33	19	1
15656695	Carrier_Ethernet	201006	5	0	0	0	1	1	0	0	50	25	4	38	20	1
15656695	Carrier_Ethernet	201007	2	0	0	0	1	1	0	0	52	26	4	40	21	1
15656695	Carrier_Ethernet	201008	1	0	0	0	1	1	0	0	53	27	4	41	22	1
15656695	Carrier_Ethernet	201009	1	0	0	0	1	0	0	0	54	28	4	41	22	1
15656695	Carrier_Ethernet	201011	2	0	0	0	2	1	0	0	56	30	4	42	23	1
15656695	Carrier_Ethernet	201012	1	0	0	0	1	0	0	0	57	31	4	42	23	1
15656695	Carrier_Ethernet	201101	3	0	0	0	3	3	0	0	60	34	4	45	26	1
15656695	Carrier_Ethernet	201104	3	0	0	0	2	1	0	0	63	36	4	46	27	1
15656695	Carrier_Ethernet	201105	3	1	0	0	2	0	1	0	66	38	5	46	27	1
15656695	Carrier_Ethernet	201106	9	0	0	0	3	1	0	0	75	41	5	53	28	1
15656695	Carrier_Ethernet	201107	1	0	0	0	1	1	0	0	76	42	5	54	29	1
15656695	Carrier_Ethernet	201108	2	0	0	0	2	2	0	0	78	43	5	56	30	1
15656695	Carrier_Ethernet	201109	1	0	0	0	1	1	0	0	79	43	5	57	30	1
15656695	Carrier_Ethernet	201110	1	0	0	0	1	0	0	0	80	44	5	57	30	1
15656695	Carrier_Ethernet	201111	3	1	0	0	3	1	1	0	83	47	6	58	31	1
15656695	Carrier_Ethernet	201201	1	0	0	0	1	0	0	0	84	48	6	58	31	1
15656695	Carrier_Ethernet	201202	1	0	0	0	1	1	0	0	85	49	6	59	32	1
15656695	Carrier_Ethernet	201205	3	0	0	0	2	2	0	0	88	51	6	62	34	1
15656695	Carrier_Ethernet	201207	4	0	0	0	3	2	0	0	92	54	6	65	36	1
15656695	Carrier_Ethernet	201209	2	0	0	0	2	2	0	0	94	56	6	67	38	1
15656695	Carrier_Ethernet	201210	5	1	0	0	4	3	1	0	99	60	7	71	41	1
15656695	Carrier_Ethernet	201211	2	0	0	0	2	1	0	0	101	62	7	72	42	1
15656695	Carrier_Ethernet	201212	2	0	0	0	2	1	0	0	103	64	7	73	43	1
15656695	Carrier_Ethernet	201303	9	0	0	0	1	1	0	0	112	64	7	82	43	1
15656695	Carrier_Ethernet	201305	3	0	0	0	3	3	0	0	115	67	7	85	46	1
15656695	Carrier_Ethernet	201308	1	0	0	0	1	1	0	0	116	68	7	86	47	1
15656695	Carrier_Ethernet	201310	3	0	0	0	2	0	0	0	119	70	7	86	47	1
15656695	Carrier_Ethernet	201311	1	0	0	0	1	0	0	0	120	71	7	86	47	1
15656695	Carrier_Ethernet	201312	1	1	0	0	1	1	1	0	121	72	8	87	48	1
15656695	Carrier_Ethernet	201405	3	0	0	0	2	2	0	0	124	73	8	90	49	1
15656695	Carrier_Ethernet	201406	1	0	0	0	1	0	0	0	125	74	8	90	49	1
15656695	Carrier_Ethernet	201411	1	0	0	0	1	0	0	0	126	75	8	90	49	1
15656695	Carrier_Ethernet	201501	1	0	0	0	1	0	0	0	127	76	8	90	49	1
15656695	Carrier_Ethernet	201502	1	0	0	0	1	1	0	0	128	76	8	91	49	1
15656695	Carrier_Ethernet	201503	1	0	0	0	1	0	0	0	129	77	8	91	49	1
15656695	Carrier_Ethernet	201509	1	0	0	0	1	1	0	0	130	77	8	92	49	1
15656695	Carrier_Ethernet	201510	1	0	0	0	1	1	0	0	131	78	8	93	50	1
15656695	Carrier_Ethernet	201602	1	0	0	0	1	1	0	0	132	79	8	94	51	1
15656695	Carrier_Ethernet	201603	1	0	0	0	1	1	0	0	133	80	8	95	52	1
15656695	Carrier_Ethernet	201604	3	0	0	0	2	2	0	0	136	80	8	98	52	1
15656695	Carrier_Ethernet	201605	3	1	0	0	2	1	1	0	139	82	9	99	53	1
15656695	Carrier_Ethernet	201606	1	1	0	0	1	1	1	0	140	82	10	100	53	1
15656695	Carrier_Ethernet	201611	1	0	0	0	1	0	0	0	141	83	10	100	53	1
15656695	Carrier_Ethernet	201702	2	0	0	0	2	2	0	0	143	84	10	102	54	1
15656695	Carrier_Ethernet	201703	1	0	0	0	1	1	0	0	144	85	10	103	55	1
15656695	Carrier_Ethernet	201706	1	0	0	0	1	1	0	0	145	86	10	104	56	1
15656695	Carrier_Ethernet	201707	1	0	0	0	1	0	0	0	146	87	10	104	56	1
15656695	Carrier_Ethernet	201712	1	0	0	0	1	1	0	0	147	87	10	105	56	1
15656695	Carrier_Ethernet	201806	2	0	0	0	2	2	0	0	149	89	10	107	58	1
148349	Chatbot	200212	5	0	0	0	3	2	0	0	5	3	0	4	2	0
148349	Chatbot	200301	2	0	0	0	1	1	0	0	7	4	0	6	3	0
148349	Chatbot	200305	1	0	0	0	1	1	0	0	8	5	0	7	4	0
148349	Chatbot	200306	1	0	0	0	1	1	0	0	9	6	0	8	5	0
148349	Chatbot	200308	3	1	0	0	3	2	1	0	12	9	1	10	7	0
148349	Chatbot	200309	5	0	0	0	2	2	0	0	17	11	1	15	9	0
148349	Chatbot	200310	2	0	0	0	1	1	0	0	19	12	1	17	10	0
148349	Chatbot	200311	4	0	0	0	2	0	0	0	23	14	1	17	10	0
148349	Chatbot	200402	2	0	0	0	1	0	0	0	25	15	1	17	10	0
148349	Chatbot	200403	3	0	0	0	3	1	0	0	28	18	1	18	11	0
148349	Chatbot	200406	2	0	0	0	2	2	0	0	30	20	1	20	13	0
148349	Chatbot	200407	7	0	0	0	2	2	0	0	37	21	1	27	14	0
148349	Chatbot	200409	3	0	0	0	2	1	0	0	40	22	1	29	14	0
148349	Chatbot	200410	2	0	0	0	2	2	0	0	42	24	1	31	16	0
148349	Chatbot	200411	1	0	0	0	1	0	0	0	43	25	1	31	16	0
148349	Chatbot	200501	5	0	0	0	4	1	0	0	48	29	1	32	17	0
148349	Chatbot	200502	7	0	0	0	4	3	0	0	55	32	1	37	19	0
148349	Chatbot	200503	1	0	0	0	1	1	0	0	56	33	1	38	20	0
148349	Chatbot	200504	3	0	0	0	2	1	0	0	59	35	1	40	21	0
148349	Chatbot	200505	14	0	0	0	8	1	0	0	73	43	1	42	22	0
148349	Chatbot	200506	1	0	0	0	1	0	0	0	74	44	1	42	22	0
148349	Chatbot	200507	3	0	0	0	3	1	0	0	77	47	1	43	23	0
148349	Chatbot	200509	6	0	0	0	2	1	0	0	83	48	1	44	24	0
148349	Chatbot	200510	3	0	0	0	3	1	0	0	86	51	1	45	25	0
148349	Chatbot	200511	7	0	0	0	3	2	0	0	93	53	1	51	26	0
148349	Chatbot	200512	8	0	0	0	7	4	0	0	101	58	1	56	29	0
148349	Chatbot	200601	15	1	0	0	10	4	1	0	116	68	2	60	33	0
148349	Chatbot	200602	8	0	0	0	7	1	0	0	124	75	2	62	34	0
148349	Chatbot	200603	6	0	0	0	6	4	0	0	130	80	2	66	37	0
148349	Chatbot	200604	14	0	0	0	11	3	0	0	144	91	2	71	40	0
148349	Chatbot	200605	13	1	0	0	11	7	1	0	157	100	3	78	45	0
148349	Chatbot	200606	7	0	0	0	4	2	0	0	164	103	3	80	46	0
148349	Chatbot	200607	5	0	0	0	4	2	0	0	169	107	3	82	48	0
148349	Chatbot	200608	10	0	0	0	7	7	0	0	179	113	3	92	54	0
148349	Chatbot	200609	10	1	0	0	7	2	1	0	189	119	4	94	55	0
148349	Chatbot	200610	20	2	0	0	8	3	1	0	209	126	6	107	57	0
148349	Chatbot	200611	12	0	0	0	7	4	0	0	221	132	6	112	61	0
148349	Chatbot	200612	9	0	0	0	6	3	0	0	230	136	6	115	62	0
148349	Chatbot	200701	22	0	0	0	15	9	0	0	252	151	6	126	71	0
148349	Chatbot	200702	18	3	0	0	15	8	3	0	270	164	9	136	78	0
148349	Chatbot	200703	8	1	0	0	6	3	1	0	278	168	10	140	80	0
148349	Chatbot	200705	16	1	0	0	11	8	1	0	294	177	11	151	86	0
148349	Chatbot	200706	23	2	0	0	13	3	2	0	317	189	13	154	89	1
148349	Chatbot	200707	11	6	1	0	10	6	5	1	328	198	19	160	95	4
148349	Chatbot	200708	11	3	0	0	7	1	3	0	339	204	22	161	96	4
148349	Chatbot	200709	11	2	0	0	10	3	2	0	350	213	24	165	99	5
148349	Chatbot	200710	7	1	0	0	5	2	1	0	357	218	25	168	101	5
148349	Chatbot	200712	8	0	0	0	5	3	0	0	365	222	25	174	103	5
148349	Chatbot	200801	4	0	0	0	4	4	0	0	369	225	25	178	106	5
148349	Chatbot	200802	6	0	0	0	6	5	0	0	375	231	25	183	111	5
148349	Chatbot	200803	11	2	0	0	6	4	2	0	386	236	27	191	114	5
148349	Chatbot	200804	14	1	0	0	8	3	1	0	400	242	28	197	115	5
148349	Chatbot	200805	9	2	0	0	7	3	2	0	409	248	30	200	117	5
148349	Chatbot	200806	15	2	0	0	10	5	2	0	424	258	32	208	122	5
148349	Chatbot	200807	12	6	0	0	8	3	4	0	436	264	38	213	124	6
148349	Chatbot	200808	10	1	0	0	5	1	1	0	446	268	39	214	124	6
148349	Chatbot	200809	14	2	0	0	11	5	2	0	460	276	41	221	126	7
148349	Chatbot	200810	8	1	0	0	5	2	1	0	468	281	42	224	128	7
148349	Chatbot	200811	9	2	0	0	6	3	2	0	477	286	44	230	130	7
148349	Chatbot	200901	5	1	0	0	5	4	1	0	482	290	45	234	133	7
148349	Chatbot	200902	24	11	4	0	14	6	8	1	506	302	56	250	137	14
148349	Chatbot	200903	2	0	0	0	2	2	0	0	508	304	56	252	139	14
148349	Chatbot	200904	13	4	0	0	9	6	3	0	521	312	60	260	144	14
148349	Chatbot	200905	4	0	0	0	4	2	0	0	525	316	60	262	146	14
148349	Chatbot	200907	3	1	0	0	3	3	1	0	528	319	61	265	149	15
148349	Chatbot	200908	26	2	0	0	6	3	2	0	554	322	63	284	150	15
148349	Chatbot	200909	7	2	0	0	6	4	2	0	561	325	65	289	151	15
148349	Chatbot	200911	7	2	0	0	6	3	2	0	568	328	67	292	152	15
148349	Chatbot	200912	9	0	0	0	3	2	0	0	577	330	67	298	153	15
148349	Chatbot	201001	3	0	0	0	1	0	0	0	580	331	67	298	153	15
148349	Chatbot	201002	22	2	0	0	5	4	2	0	602	335	69	319	156	15
148349	Chatbot	201004	7	1	0	0	6	3	1	0	609	340	70	322	158	15
148349	Chatbot	201005	4	0	0	0	4	2	0	0	613	344	70	324	160	15
148349	Chatbot	201006	4	2	0	0	4	2	2	0	617	347	72	326	161	15
148349	Chatbot	201007	3	0	0	0	3	2	0	0	620	350	72	328	163	15
148349	Chatbot	201008	4	1	0	0	3	1	1	0	624	353	73	329	164	15
148349	Chatbot	201010	2	1	0	0	2	1	1	0	626	355	74	330	165	15
148349	Chatbot	201011	5	0	0	0	2	2	0	0	631	355	74	335	165	15
148349	Chatbot	201012	1	0	0	0	1	1	0	0	632	356	74	336	166	15
148349	Chatbot	201101	7	2	0	0	5	3	2	0	639	361	76	339	169	15
148349	Chatbot	201102	1	0	0	0	1	1	0	0	640	361	76	340	169	15
148349	Chatbot	201103	1	0	0	0	1	1	0	0	641	362	76	341	170	15
148349	Chatbot	201104	17	0	0	0	4	4	0	0	658	365	76	358	173	15
148349	Chatbot	201105	1	0	0	0	1	1	0	0	659	365	76	359	173	15
148349	Chatbot	201106	3	0	0	0	3	2	0	0	662	367	76	361	174	15
148349	Chatbot	201107	1	0	0	0	1	0	0	0	663	368	76	361	174	15
148349	Chatbot	201108	2	0	0	0	2	1	0	0	665	369	76	362	174	15
148349	Chatbot	201109	3	0	0	0	3	2	0	0	668	372	76	364	176	15
148349	Chatbot	201110	7	2	0	0	6	6	2	0	675	378	78	371	182	17
148349	Chatbot	201111	2	0	0	0	2	2	0	0	677	379	78	373	183	17
148349	Chatbot	201112	2	1	0	0	2	1	1	0	679	380	79	374	183	17
148349	Chatbot	201201	5	1	0	0	3	1	1	0	684	383	80	375	184	17
148349	Chatbot	201202	2	0	0	0	2	1	0	0	686	385	80	376	185	17
148349	Chatbot	201203	1	0	0	0	1	1	0	0	687	386	80	377	186	17
148349	Chatbot	201205	2	0	0	0	1	1	0	0	689	386	80	379	186	17
148349	Chatbot	201206	3	0	0	0	3	1	0	0	692	389	80	380	187	17
148349	Chatbot	201207	3	0	0	0	3	3	0	0	695	392	80	383	190	17
148349	Chatbot	201208	1	0	0	0	1	1	0	0	696	393	80	384	191	17
148349	Chatbot	201209	1	0	0	0	1	1	0	0	697	394	80	385	192	17
148349	Chatbot	201301	2	0	0	0	2	2	0	0	699	396	80	387	194	17
148349	Chatbot	201302	2	1	0	0	2	0	1	0	701	398	81	387	194	18
148349	Chatbot	201304	1	0	0	0	1	1	0	0	702	399	81	388	195	18
148349	Chatbot	201305	2	1	0	0	2	1	1	0	704	400	82	389	195	18
148349	Chatbot	201306	2	1	0	0	2	2	1	0	706	402	83	391	197	19
148349	Chatbot	201307	5	2	0	0	5	3	2	0	711	406	85	394	199	20
148349	Chatbot	201308	1	0	0	0	1	1	0	0	712	407	85	395	200	20
148349	Chatbot	201309	1	0	0	0	1	1	0	0	713	407	85	396	200	20
148349	Chatbot	201310	1	0	0	0	1	1	0	0	714	408	85	397	201	20
148349	Chatbot	201312	3	1	0	0	3	2	1	0	717	410	86	399	202	20
148349	Chatbot	201401	5	0	0	0	2	2	0	0	722	412	86	404	204	20
148349	Chatbot	201402	1	0	0	0	1	1	0	0	723	413	86	405	205	20
148349	Chatbot	201404	5	1	0	0	5	3	1	0	728	418	87	408	208	20
148349	Chatbot	201405	1	0	0	0	1	1	0	0	729	419	87	409	209	20
148349	Chatbot	201406	3	1	0	0	2	1	1	0	732	420	88	410	209	20
148349	Chatbot	201408	4	0	0	0	3	3	0	0	736	423	88	414	212	20
148349	Chatbot	201409	1	0	0	0	1	1	0	0	737	424	88	415	213	20
148349	Chatbot	201410	1	0	0	0	1	0	0	0	738	425	88	415	213	20
148349	Chatbot	201411	7	1	0	0	3	3	1	0	745	428	89	422	216	21
148349	Chatbot	201412	3	0	0	0	2	2	0	0	748	430	89	425	218	21
148349	Chatbot	201501	2	1	0	0	2	2	1	0	750	432	90	427	219	22
148349	Chatbot	201502	2	0	0	0	2	0	0	0	752	434	90	427	219	22
148349	Chatbot	201503	1	0	0	0	1	1	0	0	753	434	90	428	219	22
148349	Chatbot	201504	6	0	0	0	3	3	0	0	759	437	90	434	222	22
148349	Chatbot	201505	3	0	0	0	3	3	0	0	762	440	90	437	225	22
148349	Chatbot	201506	3	0	0	0	1	1	0	0	765	440	90	440	225	22
148349	Chatbot	201507	1	0	0	0	1	0	0	0	766	441	90	440	225	22
148349	Chatbot	201508	1	0	0	0	1	0	0	0	767	442	90	440	225	22
148349	Chatbot	201509	1	0	0	0	1	1	0	0	768	443	90	441	226	22
148349	Chatbot	201511	6	2	0	0	5	3	2	0	774	446	92	445	227	22
148349	Chatbot	201512	7	0	0	0	3	3	0	0	781	447	92	452	228	22
148349	Chatbot	201602	2	0	0	0	1	1	0	0	783	448	92	454	229	22
148349	Chatbot	201603	2	0	0	0	2	2	0	0	785	450	92	456	231	22
148349	Chatbot	201604	2	0	0	0	2	1	0	0	787	452	92	457	232	22
148349	Chatbot	201605	1	0	0	0	1	1	0	0	788	453	92	458	233	22
148349	Chatbot	201606	4	2	0	0	4	3	2	0	792	455	94	461	234	23
148349	Chatbot	201607	2	0	0	0	2	2	0	0	794	457	94	463	236	23
148349	Chatbot	201608	3	1	0	0	3	3	1	0	797	459	95	466	238	24
148349	Chatbot	201609	12	1	0	0	3	2	1	0	809	461	96	477	239	24
148349	Chatbot	201610	2	0	0	0	2	1	0	0	811	463	96	478	240	24
148349	Chatbot	201611	7	0	0	0	4	4	0	0	818	466	96	485	242	24
148349	Chatbot	201612	13	4	0	0	6	5	3	0	831	469	100	491	244	25
148349	Chatbot	201701	7	0	0	0	3	3	0	0	838	471	100	498	246	25
148349	Chatbot	201702	17	1	0	0	14	13	1	0	855	481	101	514	255	26
148349	Chatbot	201703	15	6	1	0	10	8	3	1	870	489	107	527	261	30
148349	Chatbot	201704	3	0	0	0	3	2	0	0	873	490	107	529	261	30
148349	Chatbot	201705	28	4	0	0	6	4	2	0	901	494	111	544	263	33
148349	Chatbot	201706	11	4	0	0	8	7	4	0	912	500	115	551	268	34
148349	Chatbot	201707	14	2	0	0	11	7	2	0	926	509	117	559	273	35
148349	Chatbot	201708	8	0	0	0	5	4	0	0	934	513	117	565	276	35
148349	Chatbot	201709	16	2	0	0	15	12	2	0	950	527	119	578	286	36
148349	Chatbot	201710	23	2	0	0	15	11	2	0	973	536	121	596	291	37
148349	Chatbot	201711	14	1	0	0	7	6	1	0	987	542	122	608	296	37
148349	Chatbot	201712	14	0	0	0	9	6	0	0	1001	551	122	615	301	37
148349	Chatbot	201801	17	2	0	0	7	4	2	0	1018	557	124	626	304	38
148349	Chatbot	201802	7	3	0	0	5	3	2	0	1025	562	127	631	307	38
148349	Chatbot	201803	2	0	0	0	2	2	0	0	1027	563	127	633	308	38
148349	Chatbot	201804	20	2	0	0	11	8	2	0	1047	570	129	648	312	40
148349	Chatbot	201805	11	3	0	0	8	5	2	0	1058	576	132	656	315	41
148349	Chatbot	201806	22	7	0	0	15	10	7	0	1080	587	139	670	321	43
148349	Chatbot	201807	5	1	0	0	4	3	1	0	1085	591	140	674	324	43
38404	Classless_Inter-Domain_Routing	200202	1	0	0	0	1	1	0	0	1	1	0	1	1	0
38404	Classless_Inter-Domain_Routing	200203	16	0	0	0	3	1	0	0	17	4	0	2	2	0
38404	Classless_Inter-Domain_Routing	200205	2	0	0	0	1	1	0	0	19	5	0	4	3	0
38404	Classless_Inter-Domain_Routing	200210	1	0	0	0	1	0	0	0	20	6	0	4	3	0
38404	Classless_Inter-Domain_Routing	200301	1	0	0	0	1	1	0	0	21	7	0	5	4	0
38404	Classless_Inter-Domain_Routing	200302	1	0	0	0	1	1	0	0	22	8	0	6	5	0
38404	Classless_Inter-Domain_Routing	200308	2	0	0	0	1	0	0	0	24	9	0	6	5	0
38404	Classless_Inter-Domain_Routing	200310	2	0	0	0	2	1	0	0	26	11	0	7	6	0
38404	Classless_Inter-Domain_Routing	200403	1	0	0	0	1	1	0	0	27	12	0	8	7	0
38404	Classless_Inter-Domain_Routing	200404	3	0	0	0	3	1	0	0	30	14	0	9	8	0
38404	Classless_Inter-Domain_Routing	200407	2	0	0	0	2	1	0	0	32	16	0	10	9	0
38404	Classless_Inter-Domain_Routing	200409	5	0	0	0	4	4	0	0	37	20	0	15	13	0
38404	Classless_Inter-Domain_Routing	200410	3	0	0	0	3	2	0	0	40	23	0	17	15	0
38404	Classless_Inter-Domain_Routing	200411	5	0	0	0	2	2	0	0	45	25	0	22	17	0
38404	Classless_Inter-Domain_Routing	200412	1	0	0	0	1	0	0	0	46	26	0	22	17	0
38404	Classless_Inter-Domain_Routing	200501	1	0	0	0	1	0	0	0	47	27	0	22	17	0
38404	Classless_Inter-Domain_Routing	200503	1	0	0	0	1	1	0	0	48	28	0	23	18	0
38404	Classless_Inter-Domain_Routing	200504	7	1	0	0	4	3	1	0	55	32	1	29	21	0
38404	Classless_Inter-Domain_Routing	200505	4	1	0	0	3	2	1	0	59	35	2	32	23	0
38404	Classless_Inter-Domain_Routing	200506	4	2	0	0	4	3	2	0	63	38	4	35	25	1
38404	Classless_Inter-Domain_Routing	200507	1	0	0	0	1	1	0	0	64	39	4	36	26	1
38404	Classless_Inter-Domain_Routing	200508	7	2	0	0	7	5	2	0	71	46	6	41	31	1
38404	Classless_Inter-Domain_Routing	200509	5	0	0	0	4	2	0	0	76	50	6	43	33	1
38404	Classless_Inter-Domain_Routing	200510	3	0	0	0	2	0	0	0	79	52	6	43	33	1
38404	Classless_Inter-Domain_Routing	200511	5	0	0	0	5	2	0	0	84	57	6	45	35	1
38404	Classless_Inter-Domain_Routing	200512	22	0	0	0	3	1	0	0	106	60	6	65	36	1
38404	Classless_Inter-Domain_Routing	200601	9	0	0	0	6	4	0	0	115	66	6	70	40	1
38404	Classless_Inter-Domain_Routing	200602	8	1	0	0	7	5	1	0	123	72	7	76	44	1
38404	Classless_Inter-Domain_Routing	200603	4	0	0	0	3	1	0	0	127	74	7	77	45	1
38404	Classless_Inter-Domain_Routing	200604	4	0	0	0	4	2	0	0	131	77	7	79	46	1
38404	Classless_Inter-Domain_Routing	200605	10	2	0	0	7	2	2	0	141	83	9	82	47	1
38404	Classless_Inter-Domain_Routing	200606	15	3	1	0	10	4	3	1	156	93	12	86	51	2
38404	Classless_Inter-Domain_Routing	200607	2	0	0	0	1	1	0	0	158	94	12	88	52	2
38404	Classless_Inter-Domain_Routing	200608	2	0	0	0	1	0	0	0	160	95	12	88	52	2
38404	Classless_Inter-Domain_Routing	200609	5	1	0	0	5	2	1	0	165	99	13	90	53	2
38404	Classless_Inter-Domain_Routing	200610	6	1	0	0	4	2	1	0	171	103	14	93	55	2
38404	Classless_Inter-Domain_Routing	200611	1	0	0	0	1	1	0	0	172	104	14	94	56	2
38404	Classless_Inter-Domain_Routing	200612	2	0	0	0	1	1	0	0	174	105	14	96	57	2
38404	Classless_Inter-Domain_Routing	200701	6	0	0	0	5	5	0	0	180	110	14	102	62	2
38404	Classless_Inter-Domain_Routing	200702	10	2	0	0	7	4	2	0	190	116	16	106	65	2
38404	Classless_Inter-Domain_Routing	200703	6	1	0	0	6	3	1	0	196	122	17	109	68	2
38404	Classless_Inter-Domain_Routing	200704	2	0	0	0	2	2	0	0	198	124	17	111	70	2
38404	Classless_Inter-Domain_Routing	200705	12	2	0	0	9	4	2	0	210	133	19	115	74	2
38404	Classless_Inter-Domain_Routing	200706	11	1	0	0	6	4	1	0	221	138	20	119	77	2
38404	Classless_Inter-Domain_Routing	200707	2	0	0	0	2	2	0	0	223	139	20	121	78	2
38404	Classless_Inter-Domain_Routing	200708	7	1	0	0	5	4	1	0	230	144	21	127	82	3
38404	Classless_Inter-Domain_Routing	200709	3	0	0	0	1	0	0	0	233	145	21	127	82	3
38404	Classless_Inter-Domain_Routing	200710	4	1	0	0	4	2	1	0	237	149	22	129	84	3
38404	Classless_Inter-Domain_Routing	200711	5	0	0	0	4	3	0	0	242	153	22	133	87	3
38404	Classless_Inter-Domain_Routing	200712	11	1	0	0	11	4	1	0	253	162	23	137	89	3
38404	Classless_Inter-Domain_Routing	200801	3	0	0	0	3	0	0	0	256	165	23	137	89	3
38404	Classless_Inter-Domain_Routing	200802	6	0	0	0	6	4	0	0	262	171	23	141	93	3
38404	Classless_Inter-Domain_Routing	200804	5	1	0	0	5	4	1	0	267	176	24	145	97	3
38404	Classless_Inter-Domain_Routing	200805	4	1	0	0	4	1	1	0	271	180	25	146	98	3
38404	Classless_Inter-Domain_Routing	200806	6	0	0	0	6	6	0	0	277	184	25	152	102	3
38404	Classless_Inter-Domain_Routing	200807	7	2	0	0	4	2	2	0	284	187	27	154	103	3
38404	Classless_Inter-Domain_Routing	200808	12	1	0	0	5	1	1	0	296	192	28	159	104	3
38404	Classless_Inter-Domain_Routing	200809	2	0	0	0	1	1	0	0	298	192	28	161	104	3
38404	Classless_Inter-Domain_Routing	200811	17	6	1	0	12	7	6	1	315	202	34	168	109	4
38404	Classless_Inter-Domain_Routing	200812	8	2	0	0	6	3	2	0	323	207	36	171	111	4
38404	Classless_Inter-Domain_Routing	200901	4	0	0	0	4	3	0	0	327	210	36	174	113	4
38404	Classless_Inter-Domain_Routing	200902	2	0	0	0	2	2	0	0	329	212	36	176	115	4
38404	Classless_Inter-Domain_Routing	200903	1	0	0	0	1	0	0	0	330	213	36	176	115	4
38404	Classless_Inter-Domain_Routing	200904	11	4	1	0	6	5	4	1	341	217	40	184	118	5
38404	Classless_Inter-Domain_Routing	200905	2	0	0	0	2	2	0	0	343	219	40	186	120	5
38404	Classless_Inter-Domain_Routing	200906	11	0	0	0	7	3	0	0	354	224	40	189	121	5
38404	Classless_Inter-Domain_Routing	200907	5	1	0	0	5	3	1	0	359	227	41	192	122	5
38404	Classless_Inter-Domain_Routing	200908	2	0	0	0	1	0	0	0	361	228	41	192	122	5
38404	Classless_Inter-Domain_Routing	200909	7	1	0	0	5	2	1	0	368	232	42	195	123	5
38404	Classless_Inter-Domain_Routing	200910	26	5	1	0	10	7	3	1	394	240	47	218	128	8
38404	Classless_Inter-Domain_Routing	200911	7	2	0	0	5	3	1	0	401	245	49	223	131	8
38404	Classless_Inter-Domain_Routing	200912	5	2	0	0	4	2	2	0	406	247	51	225	131	8
38404	Classless_Inter-Domain_Routing	201001	7	1	0	0	6	4	1	0	413	251	52	229	133	8
38404	Classless_Inter-Domain_Routing	201002	4	1	0	0	4	2	1	0	417	254	53	231	134	8
38404	Classless_Inter-Domain_Routing	201003	7	1	0	0	6	4	1	0	424	258	54	236	136	8
38404	Classless_Inter-Domain_Routing	201004	14	0	0	0	8	3	0	0	438	266	54	242	139	8
38404	Classless_Inter-Domain_Routing	201006	12	1	0	0	7	3	1	0	450	273	55	245	142	8
38404	Classless_Inter-Domain_Routing	201008	3	0	0	0	3	2	0	0	453	275	55	247	143	8
38404	Classless_Inter-Domain_Routing	201009	10	2	0	0	5	2	2	0	463	278	57	253	143	8
38404	Classless_Inter-Domain_Routing	201010	6	0	0	0	2	2	0	0	469	279	57	259	144	8
38404	Classless_Inter-Domain_Routing	201011	9	1	0	0	6	3	1	0	478	284	58	263	146	9
38404	Classless_Inter-Domain_Routing	201012	9	1	0	0	4	1	1	0	487	287	59	264	146	9
38404	Classless_Inter-Domain_Routing	201101	1	0	0	0	1	1	0	0	488	288	59	265	147	9
38404	Classless_Inter-Domain_Routing	201102	9	4	0	0	8	5	3	0	497	294	63	271	150	10
38404	Classless_Inter-Domain_Routing	201103	7	0	0	0	3	2	0	0	504	297	63	276	152	10
38404	Classless_Inter-Domain_Routing	201104	13	1	0	0	8	6	1	0	517	303	64	287	156	10
38404	Classless_Inter-Domain_Routing	201105	2	0	0	0	2	1	0	0	519	305	64	288	157	10
38404	Classless_Inter-Domain_Routing	201109	4	0	0	0	4	4	0	0	523	307	64	292	159	10
38404	Classless_Inter-Domain_Routing	201111	5	1	0	0	3	2	1	0	528	309	65	295	160	10
38404	Classless_Inter-Domain_Routing	201112	3	1	0	0	2	0	1	0	531	311	66	295	160	10
38404	Classless_Inter-Domain_Routing	201201	80	1	0	0	8	6	1	0	611	316	67	366	163	11
38404	Classless_Inter-Domain_Routing	201202	2	0	0	0	2	0	0	0	613	318	67	366	163	11
38404	Classless_Inter-Domain_Routing	201203	2	1	0	0	2	2	1	0	615	320	68	368	165	12
38404	Classless_Inter-Domain_Routing	201204	94	11	9	8	11	8	3	2	709	326	79	454	168	23
38404	Classless_Inter-Domain_Routing	201205	3	1	0	0	3	2	1	0	712	329	80	456	170	23
38404	Classless_Inter-Domain_Routing	201206	4	1	0	0	4	0	1	0	716	333	81	456	170	23
38404	Classless_Inter-Domain_Routing	201207	5	1	0	0	4	3	1	0	721	336	82	460	172	23
38404	Classless_Inter-Domain_Routing	201208	3	1	0	0	3	2	1	0	724	338	83	462	173	23
38404	Classless_Inter-Domain_Routing	201209	2	0	0	0	2	1	0	0	726	340	83	463	174	23
38404	Classless_Inter-Domain_Routing	201210	7	1	0	0	6	2	1	0	733	344	84	465	174	23
38404	Classless_Inter-Domain_Routing	201211	6	1	0	0	5	2	1	0	739	348	85	467	175	23
38404	Classless_Inter-Domain_Routing	201301	1	0	0	0	1	0	0	0	740	349	85	467	175	23
38404	Classless_Inter-Domain_Routing	201302	2	0	0	0	1	1	0	0	742	349	85	469	175	23
38404	Classless_Inter-Domain_Routing	201303	3	1	0	0	3	2	1	0	745	351	86	471	176	23
38404	Classless_Inter-Domain_Routing	201304	7	0	0	0	3	2	0	0	752	352	86	477	176	23
38404	Classless_Inter-Domain_Routing	201306	2	0	0	0	1	0	0	0	754	353	86	477	176	23
38404	Classless_Inter-Domain_Routing	201307	9	3	1	0	5	4	2	1	763	356	89	484	178	26
38404	Classless_Inter-Domain_Routing	201309	2	0	0	0	1	1	0	0	765	357	89	486	179	26
38404	Classless_Inter-Domain_Routing	201310	6	2	0	0	6	3	2	0	771	362	91	489	181	26
38404	Classless_Inter-Domain_Routing	201311	3	1	0	0	3	1	1	0	774	364	92	490	181	26
38404	Classless_Inter-Domain_Routing	201312	3	1	0	0	3	1	1	0	777	367	93	491	182	26
38404	Classless_Inter-Domain_Routing	201401	2	1	0	0	2	1	1	0	779	368	94	492	182	26
38404	Classless_Inter-Domain_Routing	201402	2	0	0	0	1	0	0	0	781	369	94	492	182	26
38404	Classless_Inter-Domain_Routing	201403	9	1	0	0	4	3	1	0	790	371	95	500	183	26
38404	Classless_Inter-Domain_Routing	201404	5	1	0	0	4	3	1	0	795	374	96	504	185	27
38404	Classless_Inter-Domain_Routing	201405	7	2	0	0	3	1	1	0	802	376	98	506	185	27
38404	Classless_Inter-Domain_Routing	201407	2	1	0	0	2	2	1	0	804	377	99	508	186	28
38404	Classless_Inter-Domain_Routing	201408	4	0	0	0	3	0	0	0	808	380	99	508	186	28
38404	Classless_Inter-Domain_Routing	201409	3	2	0	0	3	2	2	0	811	381	101	510	186	28
38404	Classless_Inter-Domain_Routing	201410	8	0	0	0	6	3	0	0	819	385	101	514	187	28
38404	Classless_Inter-Domain_Routing	201411	5	1	0	0	4	2	1	0	824	388	102	516	188	29
38404	Classless_Inter-Domain_Routing	201412	4	2	0	0	4	2	2	0	828	390	104	518	188	29
38404	Classless_Inter-Domain_Routing	201501	6	1	0	0	4	2	1	0	834	394	105	521	190	29
38404	Classless_Inter-Domain_Routing	201503	1	0	0	0	1	1	0	0	835	395	105	522	191	29
38404	Classless_Inter-Domain_Routing	201504	7	2	0	0	6	2	2	0	842	401	107	524	193	29
38404	Classless_Inter-Domain_Routing	201506	3	1	0	0	3	3	1	0	845	403	108	527	194	30
38404	Classless_Inter-Domain_Routing	201507	2	1	0	0	2	1	1	0	847	404	109	528	194	30
38404	Classless_Inter-Domain_Routing	201508	5	0	0	0	2	1	0	0	852	405	109	532	194	30
38404	Classless_Inter-Domain_Routing	201509	8	3	0	0	5	2	2	0	860	409	112	535	195	30
38404	Classless_Inter-Domain_Routing	201510	4	2	0	0	3	2	2	0	864	412	114	537	197	30
38404	Classless_Inter-Domain_Routing	201511	8	3	0	0	6	3	2	0	872	416	117	542	198	30
38404	Classless_Inter-Domain_Routing	201601	6	1	0	0	6	5	1	0	878	420	118	547	201	31
38404	Classless_Inter-Domain_Routing	201603	2	1	0	0	2	1	1	0	880	421	119	548	201	31
38404	Classless_Inter-Domain_Routing	201604	6	2	0	0	5	4	2	0	886	425	121	552	204	32
38404	Classless_Inter-Domain_Routing	201605	5	1	0	0	4	3	1	0	891	428	122	555	206	32
38404	Classless_Inter-Domain_Routing	201606	7	3	0	0	5	3	2	0	898	431	125	559	207	33
38404	Classless_Inter-Domain_Routing	201607	4	1	0	0	4	1	1	0	902	434	126	560	207	33
38404	Classless_Inter-Domain_Routing	201608	6	1	0	0	3	2	1	0	908	437	127	564	209	34
38404	Classless_Inter-Domain_Routing	201609	15	0	0	0	4	4	0	0	923	438	127	579	210	34
38404	Classless_Inter-Domain_Routing	201610	31	7	0	0	13	9	5	0	954	445	134	595	212	36
38404	Classless_Inter-Domain_Routing	201611	6	2	0	0	5	4	2	0	960	447	136	600	213	37
38404	Classless_Inter-Domain_Routing	201612	8	2	0	0	5	2	2	0	968	450	138	605	213	37
38404	Classless_Inter-Domain_Routing	201701	4	0	0	0	3	3	0	0	972	452	138	609	215	37
38404	Classless_Inter-Domain_Routing	201703	1	0	0	0	1	0	0	0	973	453	138	609	215	37
38404	Classless_Inter-Domain_Routing	201705	7	3	0	0	7	6	3	0	980	456	141	615	217	39
38404	Classless_Inter-Domain_Routing	201706	1	0	0	0	1	0	0	0	981	457	141	615	217	39
38404	Classless_Inter-Domain_Routing	201707	10	4	0	0	9	4	4	0	991	465	145	620	220	39
38404	Classless_Inter-Domain_Routing	201708	6	2	1	0	5	4	2	1	997	468	147	625	222	40
38404	Classless_Inter-Domain_Routing	201709	13	3	1	1	8	5	3	1	1010	472	150	635	223	41
38404	Classless_Inter-Domain_Routing	201710	4	1	0	0	3	2	1	0	1014	474	151	638	224	41
38404	Classless_Inter-Domain_Routing	201711	13	2	0	0	5	3	1	0	1027	478	153	643	226	41
38404	Classless_Inter-Domain_Routing	201712	6	1	0	0	5	2	1	0	1033	481	154	645	226	41
38404	Classless_Inter-Domain_Routing	201801	1	0	0	0	1	1	0	0	1034	481	154	646	226	41
38404	Classless_Inter-Domain_Routing	201802	5	1	0	0	4	3	1	0	1039	483	155	650	227	41
38404	Classless_Inter-Domain_Routing	201803	3	0	0	0	2	1	0	0	1042	485	155	651	228	41
38404	Classless_Inter-Domain_Routing	201804	8	1	0	0	5	3	1	0	1050	489	156	656	230	42
38404	Classless_Inter-Domain_Routing	201805	1	1	0	0	1	1	1	0	1051	489	157	657	230	42
38404	Classless_Inter-Domain_Routing	201806	9	1	0	0	5	4	1	0	1060	491	158	665	231	42
38404	Classless_Inter-Domain_Routing	201807	3	1	0	0	3	2	1	0	1063	494	159	667	233	42
19541494	Cloud_computing	200709	1	0	0	0	1	1	0	0	1	1	0	1	1	0
19541494	Cloud_computing	200710	21	0	0	0	6	6	0	0	22	7	0	22	7	0
19541494	Cloud_computing	200711	15	1	0	0	9	5	1	0	37	16	1	31	12	1
19541494	Cloud_computing	200712	14	0	0	0	7	2	0	0	51	22	1	37	13	1
19541494	Cloud_computing	200801	20	0	0	0	10	5	0	0	71	31	1	51	18	1
19541494	Cloud_computing	200802	14	1	0	0	10	4	1	0	85	38	2	56	20	1
19541494	Cloud_computing	200803	29	2	0	0	18	12	2	0	114	56	4	78	32	2
19541494	Cloud_computing	200804	21	1	0	0	17	10	1	0	135	71	5	92	41	3
19541494	Cloud_computing	200805	45	2	0	0	33	19	2	0	180	98	7	118	54	4
19541494	Cloud_computing	200806	47	4	0	0	33	13	3	0	227	128	11	133	64	4
19541494	Cloud_computing	200807	60	8	0	0	30	15	4	0	287	154	19	163	75	6
19541494	Cloud_computing	200808	272	14	0	0	58	29	5	0	559	202	33	389	95	13
19541494	Cloud_computing	200809	356	29	2	1	77	34	16	2	915	268	62	663	121	24
19541494	Cloud_computing	200810	134	10	1	0	43	23	7	1	1049	299	72	758	134	28
19541494	Cloud_computing	200811	70	8	0	0	43	22	5	0	1119	338	80	801	153	31
19541494	Cloud_computing	200812	102	14	0	0	60	33	9	0	1221	389	94	867	179	36
19541494	Cloud_computing	200901	117	10	1	0	57	26	8	1	1338	436	104	928	196	39
19541494	Cloud_computing	200902	131	21	0	0	62	31	17	0	1469	488	125	998	217	48
19541494	Cloud_computing	200903	141	16	0	0	64	27	9	0	1610	544	141	1094	236	52
19541494	Cloud_computing	200904	168	26	2	1	71	33	14	2	1778	605	167	1211	260	64
19541494	Cloud_computing	200905	116	15	0	0	61	23	7	0	1894	658	182	1272	276	68
19541494	Cloud_computing	200906	100	23	3	0	50	24	11	2	1994	697	205	1327	289	77
19541494	Cloud_computing	200907	125	15	0	0	58	30	9	0	2119	745	220	1395	310	84
19541494	Cloud_computing	200908	95	14	2	1	51	25	10	2	2214	789	234	1452	329	90
19541494	Cloud_computing	200909	119	7	0	0	73	34	7	0	2333	847	241	1517	349	92
19541494	Cloud_computing	200910	106	16	0	0	67	34	15	0	2439	906	257	1570	375	96
19541494	Cloud_computing	200911	176	13	0	0	63	30	10	0	2615	960	270	1699	396	101
19541494	Cloud_computing	200912	138	15	0	0	66	32	11	0	2753	1012	285	1784	414	102
19541494	Cloud_computing	201001	97	16	0	0	68	33	11	0	2850	1069	301	1839	439	107
19541494	Cloud_computing	201002	150	24	0	0	81	37	17	0	3000	1136	325	1909	465	113
19541494	Cloud_computing	201003	244	20	2	0	83	38	14	2	3244	1204	345	2069	491	117
19541494	Cloud_computing	201004	160	20	2	1	71	31	13	2	3404	1261	365	2169	511	122
19541494	Cloud_computing	201005	115	23	4	2	60	30	17	3	3519	1306	388	2239	530	130
19541494	Cloud_computing	201006	105	17	1	1	56	23	13	1	3624	1346	405	2299	541	133
19541494	Cloud_computing	201007	86	16	0	0	55	24	12	0	3710	1387	421	2334	553	133
19541494	Cloud_computing	201008	88	19	0	0	58	29	15	0	3798	1436	440	2373	573	135
19541494	Cloud_computing	201009	69	12	0	0	43	22	8	0	3867	1470	452	2404	587	136
19541494	Cloud_computing	201010	99	19	0	0	64	26	14	0	3966	1524	471	2449	603	138
19541494	Cloud_computing	201011	89	25	0	0	69	27	17	0	4055	1582	496	2490	620	139
19541494	Cloud_computing	201012	120	30	0	0	74	41	21	0	4175	1641	526	2554	647	145
19541494	Cloud_computing	201101	141	34	3	2	89	42	17	2	4316	1714	560	2631	674	152
19541494	Cloud_computing	201102	140	29	0	0	83	38	12	0	4456	1783	589	2714	698	157
19541494	Cloud_computing	201103	118	29	0	0	62	29	13	0	4574	1832	618	2789	714	160
19541494	Cloud_computing	201104	155	37	0	0	73	32	13	0	4729	1892	655	2885	733	169
19541494	Cloud_computing	201105	137	32	0	0	84	39	20	0	4866	1963	687	2967	760	176
19541494	Cloud_computing	201106	126	26	0	0	80	41	18	0	4992	2027	713	3034	787	181
19541494	Cloud_computing	201107	150	30	0	0	91	48	18	0	5142	2099	743	3127	817	191
19541494	Cloud_computing	201108	196	27	3	0	72	45	17	2	5338	2150	770	3290	842	203
19541494	Cloud_computing	201109	109	22	0	0	61	37	18	0	5447	2192	792	3366	861	207
19541494	Cloud_computing	201110	112	27	0	0	69	28	16	0	5559	2247	819	3424	875	212
19541494	Cloud_computing	201111	119	31	1	0	69	33	18	1	5678	2300	850	3477	893	218
19541494	Cloud_computing	201112	90	17	0	0	55	31	13	0	5768	2345	867	3526	914	220
19541494	Cloud_computing	201201	26	2	0	0	19	17	2	0	5794	2356	869	3549	923	222
19541494	Cloud_computing	201202	86	17	0	0	67	35	13	0	5880	2408	886	3599	943	225
19541494	Cloud_computing	201203	170	45	0	0	99	52	29	0	6050	2485	931	3693	973	232
19541494	Cloud_computing	201204	70	16	0	0	51	28	10	0	6120	2521	947	3736	986	233
19541494	Cloud_computing	201205	80	22	0	0	57	29	15	0	6200	2568	969	3782	1005	236
19541494	Cloud_computing	201206	70	11	0	0	50	27	10	0	6270	2604	980	3822	1019	237
19541494	Cloud_computing	201207	79	14	0	0	53	24	10	0	6349	2647	994	3864	1035	238
19541494	Cloud_computing	201208	77	15	0	0	57	31	11	0	6426	2689	1009	3912	1051	240
19541494	Cloud_computing	201209	101	16	0	0	54	29	9	0	6527	2730	1025	3977	1068	243
19541494	Cloud_computing	201210	74	17	0	0	46	19	10	0	6601	2766	1042	4008	1077	243
19541494	Cloud_computing	201211	142	35	0	0	70	31	18	0	6743	2824	1077	4099	1097	249
19541494	Cloud_computing	201212	73	30	3	0	47	23	15	3	6816	2864	1107	4141	1113	259
19541494	Cloud_computing	201301	88	22	2	0	49	29	12	1	6904	2900	1129	4203	1129	269
19541494	Cloud_computing	201302	130	30	1	0	70	41	16	1	7034	2956	1159	4288	1157	275
19541494	Cloud_computing	201303	75	17	0	0	56	30	11	0	7109	2999	1176	4332	1175	275
19541494	Cloud_computing	201304	76	13	1	0	48	25	8	1	7185	3038	1189	4373	1190	278
19541494	Cloud_computing	201305	85	13	0	0	62	32	10	0	7270	3092	1202	4420	1213	279
19541494	Cloud_computing	201306	98	20	0	0	66	38	18	0	7368	3149	1222	4482	1242	286
19541494	Cloud_computing	201307	107	24	0	0	76	34	17	0	7475	3213	1246	4533	1264	290
19541494	Cloud_computing	201308	117	26	0	0	82	34	20	0	7592	3274	1272	4584	1277	291
19541494	Cloud_computing	201309	117	23	0	0	74	40	11	0	7709	3333	1295	4658	1303	293
19541494	Cloud_computing	201310	111	32	0	0	72	39	21	0	7820	3381	1327	4724	1319	296
19541494	Cloud_computing	201311	144	44	0	0	88	41	25	0	7964	3451	1371	4804	1343	307
19541494	Cloud_computing	201312	82	17	0	0	57	27	12	0	8046	3494	1388	4848	1356	309
19541494	Cloud_computing	201401	65	19	0	0	49	22	15	0	8111	3532	1407	4879	1367	313
19541494	Cloud_computing	201402	83	30	1	0	58	29	22	1	8194	3575	1437	4923	1382	317
19541494	Cloud_computing	201403	103	21	1	0	60	29	15	1	8297	3620	1458	4981	1396	319
19541494	Cloud_computing	201404	76	19	0	0	54	24	12	0	8373	3657	1477	5018	1402	320
19541494	Cloud_computing	201405	70	17	0	0	53	23	11	0	8443	3701	1494	5054	1416	322
19541494	Cloud_computing	201406	99	17	1	0	51	30	11	1	8542	3736	1511	5119	1429	326
19541494	Cloud_computing	201407	62	15	1	0	38	20	9	1	8604	3765	1526	5156	1440	330
19541494	Cloud_computing	201408	131	31	5	1	52	28	18	5	8735	3802	1557	5256	1453	346
19541494	Cloud_computing	201409	65	17	0	0	50	26	15	0	8800	3838	1574	5291	1466	349
19541494	Cloud_computing	201410	74	29	1	0	46	21	16	1	8874	3871	1603	5333	1476	357
19541494	Cloud_computing	201411	73	15	0	0	43	24	11	0	8947	3904	1618	5372	1490	360
19541494	Cloud_computing	201412	12	1	0	0	8	8	1	0	8959	3910	1619	5384	1496	361
19541494	Cloud_computing	201501	73	19	0	0	44	22	12	0	9032	3943	1638	5421	1507	365
19541494	Cloud_computing	201502	77	18	0	0	46	22	11	0	9109	3978	1656	5456	1518	365
19541494	Cloud_computing	201503	27	4	0	0	23	12	4	0	9136	3995	1660	5469	1524	365
19541494	Cloud_computing	201504	53	16	1	0	34	21	13	1	9189	4021	1676	5504	1536	370
19541494	Cloud_computing	201505	51	16	0	0	35	19	8	0	9240	4049	1692	5532	1548	375
19541494	Cloud_computing	201506	55	11	0	0	36	21	10	0	9295	4075	1703	5566	1559	378
19541494	Cloud_computing	201507	39	10	0	0	32	15	9	0	9334	4101	1713	5583	1566	379
19541494	Cloud_computing	201508	44	7	0	0	28	19	7	0	9378	4121	1720	5608	1576	381
19541494	Cloud_computing	201509	31	7	0	0	21	13	7	0	9409	4137	1727	5622	1584	382
19541494	Cloud_computing	201510	76	20	0	0	44	20	11	0	9485	4168	1747	5656	1591	387
19541494	Cloud_computing	201511	71	21	0	0	50	30	13	0	9556	4205	1768	5699	1607	396
19541494	Cloud_computing	201512	38	6	0	0	33	21	6	0	9594	4231	1774	5723	1621	397
19541494	Cloud_computing	201601	39	11	0	0	33	19	10	0	9633	4252	1785	5743	1627	400
19541494	Cloud_computing	201602	49	12	0	0	31	18	11	0	9682	4273	1797	5771	1635	405
19541494	Cloud_computing	201603	54	13	0	0	36	20	9	0	9736	4294	1810	5804	1642	410
19541494	Cloud_computing	201604	41	12	0	0	31	19	9	0	9777	4317	1822	5826	1653	410
19541494	Cloud_computing	201605	35	6	1	0	21	14	6	1	9812	4333	1828	5845	1659	414
19541494	Cloud_computing	201606	27	8	0	0	20	8	6	0	9839	4348	1836	5857	1661	416
19541494	Cloud_computing	201607	30	5	0	0	22	13	4	0	9869	4363	1841	5872	1665	416
19541494	Cloud_computing	201608	17	0	0	0	8	8	0	0	9886	4368	1841	5889	1670	416
19541494	Cloud_computing	201609	17	2	0	0	9	9	2	0	9903	4374	1843	5906	1676	418
19541494	Cloud_computing	201610	5	0	0	0	3	3	0	0	9908	4376	1843	5911	1678	418
19541494	Cloud_computing	201611	11	0	0	0	6	6	0	0	9919	4379	1843	5922	1681	418
19541494	Cloud_computing	201612	10	0	0	0	8	8	0	0	9929	4384	1843	5932	1686	418
19541494	Cloud_computing	201701	11	4	1	0	8	7	4	1	9940	4390	1847	5942	1691	421
19541494	Cloud_computing	201702	37	12	0	0	25	12	7	0	9977	4411	1859	5962	1699	424
19541494	Cloud_computing	201703	50	16	0	0	29	17	13	0	10027	4431	1875	5986	1706	430
19541494	Cloud_computing	201704	16	5	2	1	10	9	4	2	10043	4437	1880	5998	1711	432
19541494	Cloud_computing	201705	2	1	0	0	2	2	1	0	10045	4438	1881	6000	1712	433
19541494	Cloud_computing	201706	42	12	2	1	25	15	9	2	10087	4457	1893	6020	1721	436
19541494	Cloud_computing	201707	20	3	0	0	14	8	3	0	10107	4468	1896	6029	1727	438
19541494	Cloud_computing	201708	35	12	2	1	24	14	8	2	10142	4487	1908	6049	1735	441
19541494	Cloud_computing	201709	39	6	0	0	25	19	5	0	10181	4504	1914	6080	1743	445
19541494	Cloud_computing	201710	41	13	0	0	25	16	10	0	10222	4519	1927	6104	1748	450
19541494	Cloud_computing	201711	29	10	1	0	20	15	8	1	10251	4532	1937	6125	1756	455
19541494	Cloud_computing	201712	74	13	0	0	37	26	11	0	10325	4557	1950	6179	1772	459
19541494	Cloud_computing	201801	26	6	0	0	20	11	6	0	10351	4568	1956	6191	1775	459
19541494	Cloud_computing	201802	26	6	0	0	16	13	6	0	10377	4579	1962	6214	1781	463
19541494	Cloud_computing	201803	30	10	0	0	21	15	9	0	10407	4592	1972	6235	1786	468
19541494	Cloud_computing	201804	19	5	0	0	15	12	5	0	10426	4600	1977	6250	1791	470
19541494	Cloud_computing	201805	2	0	0	0	2	2	0	0	10428	4600	1977	6252	1791	470
19541494	Cloud_computing	201806	9	2	0	0	6	6	1	0	10437	4603	1979	6261	1794	472
19541494	Cloud_computing	201807	1	0	0	0	1	1	0	0	10438	4604	1979	6262	1795	472
46467242	Cloudlet	201505	4	0	0	0	3	3	0	0	4	3	0	4	3	0
46467242	Cloudlet	201509	3	0	0	0	3	2	0	0	7	5	0	6	4	0
46467242	Cloudlet	201601	3	0	0	0	2	1	0	0	10	7	0	7	5	0
46467242	Cloudlet	201603	2	0	0	0	1	1	0	0	12	8	0	9	6	0
46467242	Cloudlet	201605	1	0	0	0	1	1	0	0	13	9	0	10	7	0
46467242	Cloudlet	201606	4	0	0	0	1	1	0	0	17	10	0	14	8	0
46467242	Cloudlet	201607	4	1	0	0	3	3	1	0	21	13	1	18	11	1
46467242	Cloudlet	201608	1	0	0	0	1	1	0	0	22	14	1	19	12	1
46467242	Cloudlet	201611	1	0	0	0	1	0	0	0	23	15	1	19	12	1
46467242	Cloudlet	201703	1	0	0	0	1	1	0	0	24	15	1	20	12	1
46467242	Cloudlet	201704	25	7	0	0	7	7	3	0	49	20	8	45	17	8
46467242	Cloudlet	201706	2	1	0	0	2	2	1	0	51	22	9	47	19	9
46467242	Cloudlet	201711	1	0	0	0	1	1	0	0	52	23	9	48	20	9
46467242	Cloudlet	201712	3	1	0	0	3	2	1	0	55	25	10	50	21	10
46467242	Cloudlet	201804	5	0	0	0	3	3	0	0	60	26	10	55	22	10
2934910	Cognitive_robotics	200511	3	0	0	0	1	1	0	0	3	1	0	3	1	0
2934910	Cognitive_robotics	200601	4	0	0	0	4	4	0	0	7	4	0	7	4	0
2934910	Cognitive_robotics	200602	7	0	0	0	4	2	0	0	14	7	0	11	5	0
2934910	Cognitive_robotics	200603	2	0	0	0	2	1	0	0	16	9	0	12	6	0
2934910	Cognitive_robotics	200608	10	1	0	0	5	3	1	0	26	13	1	18	8	0
2934910	Cognitive_robotics	200610	1	0	0	0	1	1	0	0	27	14	1	19	9	0
2934910	Cognitive_robotics	200611	1	0	0	0	1	0	0	0	28	15	1	19	9	0
2934910	Cognitive_robotics	200701	1	0	0	0	1	1	0	0	29	16	1	20	10	0
2934910	Cognitive_robotics	200702	3	0	0	0	3	2	0	0	32	19	1	22	12	0
2934910	Cognitive_robotics	200704	1	0	0	0	1	1	0	0	33	20	1	23	13	0
2934910	Cognitive_robotics	200706	5	0	0	0	3	1	0	0	38	23	1	25	14	0
2934910	Cognitive_robotics	200707	4	0	0	0	3	2	0	0	42	26	1	28	16	0
2934910	Cognitive_robotics	200708	4	1	0	0	3	2	1	0	46	29	2	31	18	1
2934910	Cognitive_robotics	200709	3	1	0	0	3	2	1	0	49	32	3	33	20	1
2934910	Cognitive_robotics	200711	1	0	0	0	1	0	0	0	50	33	3	33	20	1
2934910	Cognitive_robotics	200801	13	0	0	0	3	2	0	0	63	36	3	42	22	1
2934910	Cognitive_robotics	200805	7	0	0	0	1	1	0	0	70	37	3	49	23	1
2934910	Cognitive_robotics	200806	3	1	0	0	3	2	1	0	73	40	4	51	25	1
2934910	Cognitive_robotics	200809	2	0	0	0	1	1	0	0	75	41	4	53	26	1
2934910	Cognitive_robotics	200810	4	2	0	0	2	1	1	0	79	43	6	55	27	1
2934910	Cognitive_robotics	200811	1	0	0	0	1	1	0	0	80	44	6	56	28	1
2934910	Cognitive_robotics	200902	1	0	0	0	1	0	0	0	81	45	6	56	28	1
2934910	Cognitive_robotics	200904	1	0	0	0	1	1	0	0	82	46	6	57	29	1
2934910	Cognitive_robotics	200909	1	0	0	0	1	0	0	0	83	47	6	57	29	1
2934910	Cognitive_robotics	200910	4	0	0	0	1	0	0	0	87	48	6	57	29	1
2934910	Cognitive_robotics	201001	4	0	0	0	2	1	0	0	91	50	6	59	30	1
2934910	Cognitive_robotics	201002	1	0	0	0	1	1	0	0	92	51	6	60	31	1
2934910	Cognitive_robotics	201004	1	0	0	0	1	1	0	0	93	52	6	61	32	1
2934910	Cognitive_robotics	201005	1	0	0	0	1	1	0	0	94	52	6	62	32	1
2934910	Cognitive_robotics	201010	3	0	0	0	2	1	0	0	97	53	6	64	32	1
2934910	Cognitive_robotics	201103	2	0	0	0	1	0	0	0	99	54	6	64	32	1
2934910	Cognitive_robotics	201105	1	0	0	0	1	1	0	0	100	55	6	65	33	1
2934910	Cognitive_robotics	201108	3	0	0	0	2	2	0	0	103	56	6	68	34	1
2934910	Cognitive_robotics	201109	1	0	0	0	1	0	0	0	104	57	6	68	34	1
2934910	Cognitive_robotics	201110	1	0	0	0	1	1	0	0	105	58	6	69	35	1
2934910	Cognitive_robotics	201202	1	0	0	0	1	1	0	0	106	59	6	70	36	1
2934910	Cognitive_robotics	201204	3	0	0	0	2	2	0	0	109	61	6	73	38	1
2934910	Cognitive_robotics	201207	1	0	0	0	1	0	0	0	110	62	6	73	38	1
2934910	Cognitive_robotics	201209	4	1	0	0	4	1	1	0	114	66	7	74	39	1
2934910	Cognitive_robotics	201210	1	0	0	0	1	0	0	0	115	67	7	74	39	1
2934910	Cognitive_robotics	201211	3	0	0	0	2	2	0	0	118	69	7	77	41	1
2934910	Cognitive_robotics	201302	1	0	0	0	1	1	0	0	119	70	7	78	42	1
2934910	Cognitive_robotics	201303	1	0	0	0	1	1	0	0	120	71	7	79	43	1
2934910	Cognitive_robotics	201305	2	0	0	0	1	0	0	0	122	72	7	79	43	1
2934910	Cognitive_robotics	201310	2	1	0	0	2	2	1	0	124	74	8	81	45	2
2934910	Cognitive_robotics	201311	3	0	0	0	1	1	0	0	127	75	8	84	46	2
2934910	Cognitive_robotics	201402	1	0	0	0	1	1	0	0	128	76	8	85	47	2
2934910	Cognitive_robotics	201403	2	0	0	0	1	1	0	0	130	77	8	87	48	2
2934910	Cognitive_robotics	201404	6	0	0	0	3	1	0	0	136	80	8	88	49	2
2934910	Cognitive_robotics	201408	1	0	0	0	1	1	0	0	137	80	8	89	49	2
2934910	Cognitive_robotics	201412	1	0	0	0	1	0	0	0	138	81	8	89	49	2
2934910	Cognitive_robotics	201502	1	0	0	0	1	1	0	0	139	82	8	90	50	2
2934910	Cognitive_robotics	201504	2	1	0	0	2	1	1	0	141	84	9	91	51	2
2934910	Cognitive_robotics	201509	1	0	0	0	1	0	0	0	142	85	9	91	51	2
2934910	Cognitive_robotics	201510	1	0	0	0	1	1	0	0	143	86	9	92	52	2
2934910	Cognitive_robotics	201512	5	0	0	0	3	3	0	0	148	89	9	97	55	2
2934910	Cognitive_robotics	201606	2	0	0	0	1	0	0	0	150	90	9	97	55	2
2934910	Cognitive_robotics	201702	2	0	0	0	1	1	0	0	152	91	9	99	56	2
2934910	Cognitive_robotics	201708	3	0	0	0	1	1	0	0	155	92	9	102	57	2
2934910	Cognitive_robotics	201801	1	0	0	0	1	1	0	0	156	93	9	103	58	2
2934910	Cognitive_robotics	201802	1	0	0	0	1	1	0	0	157	94	9	104	59	2
2934910	Cognitive_robotics	201803	2	0	0	0	1	1	0	0	159	95	9	106	60	2
35211810	Community_cloud	201207	4	0	0	0	3	3	0	0	4	3	0	4	3	0
35211810	Community_cloud	201303	6	0	0	0	2	2	0	0	10	5	0	10	5	0
35211810	Community_cloud	201402	1	0	0	0	1	1	0	0	11	6	0	11	6	0
35211810	Community_cloud	201409	3	1	0	0	3	2	1	0	14	9	1	13	8	0
35211810	Community_cloud	201512	3	1	0	0	2	1	1	0	17	11	2	14	9	0
35211810	Community_cloud	201602	2	0	0	0	2	1	0	0	19	13	2	15	10	0
35211810	Community_cloud	201607	1	0	0	0	1	0	0	0	20	14	2	15	10	0
18715559	Computational_trust	200809	45	1	0	0	9	7	1	0	45	9	1	43	7	1
18715559	Computational_trust	200810	6	0	0	0	4	2	0	0	51	12	1	46	9	1
18715559	Computational_trust	200902	2	0	0	0	2	2	0	0	53	13	1	48	10	1
18715559	Computational_trust	200908	1	0	0	0	1	1	0	0	54	14	1	49	11	1
18715559	Computational_trust	200912	7	0	0	0	1	1	0	0	61	15	1	56	12	1
18715559	Computational_trust	201001	3	0	0	0	3	0	0	0	64	18	1	56	12	1
18715559	Computational_trust	201006	1	0	0	0	1	1	0	0	65	19	1	57	13	1
18715559	Computational_trust	201008	1	0	0	0	1	1	0	0	66	20	1	58	14	1
18715559	Computational_trust	201010	1	0	0	0	1	1	0	0	67	21	1	59	15	1
18715559	Computational_trust	201012	1	0	0	0	1	1	0	0	68	21	1	60	15	1
18715559	Computational_trust	201101	1	0	0	0	1	1	0	0	69	22	1	61	16	1
18715559	Computational_trust	201102	1	0	0	0	1	1	0	0	70	23	1	62	17	1
18715559	Computational_trust	201103	1	0	0	0	1	1	0	0	71	24	1	63	18	1
18715559	Computational_trust	201106	2	0	0	0	2	2	0	0	73	25	1	65	19	1
18715559	Computational_trust	201108	3	0	0	0	2	1	0	0	76	27	1	66	20	1
18715559	Computational_trust	201202	1	0	0	0	1	1	0	0	77	28	1	67	21	1
18715559	Computational_trust	201209	1	0	0	0	1	1	0	0	78	29	1	68	22	1
18715559	Computational_trust	201305	12	0	0	0	2	1	0	0	90	30	1	78	22	1
18715559	Computational_trust	201306	1	0	0	0	1	1	0	0	91	31	1	79	23	1
18715559	Computational_trust	201308	1	0	0	0	1	0	0	0	92	32	1	79	23	1
18715559	Computational_trust	201309	1	0	0	0	1	1	0	0	93	32	1	80	23	1
18715559	Computational_trust	201310	1	0	0	0	1	1	0	0	94	32	1	81	23	1
18715559	Computational_trust	201311	1	0	0	0	1	1	0	0	95	33	1	82	24	1
18715559	Computational_trust	201312	1	0	0	0	1	1	0	0	96	34	1	83	25	1
18715559	Computational_trust	201402	1	0	0	0	1	1	0	0	97	35	1	84	26	1
18715559	Computational_trust	201403	4	0	0	0	3	1	0	0	101	38	1	85	27	1
18715559	Computational_trust	201405	2	0	0	0	2	2	0	0	103	40	1	87	29	1
18715559	Computational_trust	201408	1	0	0	0	1	1	0	0	104	41	1	88	30	1
18715559	Computational_trust	201410	1	0	0	0	1	1	0	0	105	42	1	89	31	1
18715559	Computational_trust	201412	1	0	0	0	1	0	0	0	106	43	1	89	31	1
18715559	Computational_trust	201504	1	0	0	0	1	1	0	0	107	43	1	90	31	1
18715559	Computational_trust	201511	1	0	0	0	1	1	0	0	108	44	1	91	32	1
18715559	Computational_trust	201601	2	1	0	0	2	2	1	0	110	46	2	93	34	2
18715559	Computational_trust	201603	6	0	0	0	3	3	0	0	116	48	2	99	36	2
18715559	Computational_trust	201605	1	0	0	0	1	1	0	0	117	49	2	100	37	2
18715559	Computational_trust	201607	1	0	0	0	1	1	0	0	118	50	2	101	38	2
18715559	Computational_trust	201706	1	0	0	0	1	1	0	0	119	50	2	102	38	2
18715559	Computational_trust	201707	1	0	0	0	1	1	0	0	120	51	2	103	39	2
18715559	Computational_trust	201708	1	0	0	0	1	0	0	0	121	52	2	103	39	2
18715559	Computational_trust	201710	2	0	0	0	2	2	0	0	123	54	2	105	41	2
18715559	Computational_trust	201805	1	0	0	0	1	1	0	0	124	55	2	106	42	2
4122592	Computer_network	200612	1	0	0	0	1	1	0	0	1	1	0	1	1	0
4122592	Computer_network	200701	68	12	2	1	21	9	6	2	69	22	12	49	10	1
4122592	Computer_network	200702	84	18	0	0	51	17	10	0	153	73	30	81	27	3
4122592	Computer_network	200703	75	21	0	0	51	15	12	0	228	123	51	113	42	3
4122592	Computer_network	200704	89	24	0	0	62	22	18	0	317	183	75	144	62	3
4122592	Computer_network	200705	88	17	0	0	40	20	12	0	405	219	92	174	78	7
4122592	Computer_network	200706	104	27	0	0	65	29	18	0	509	280	119	217	103	11
4122592	Computer_network	200707	94	19	0	0	51	20	15	0	603	327	138	250	119	11
4122592	Computer_network	200708	93	20	0	0	53	21	12	0	696	376	158	288	136	14
4122592	Computer_network	200709	100	23	0	0	49	23	14	0	796	420	181	338	154	16
4122592	Computer_network	200710	128	26	0	0	67	17	20	0	924	483	207	381	167	17
4122592	Computer_network	200711	112	22	0	0	61	23	19	0	1036	537	229	417	184	18
4122592	Computer_network	200712	81	23	1	0	48	18	15	1	1117	580	252	453	197	19
4122592	Computer_network	200801	39	6	0	0	21	8	4	0	1156	598	258	470	203	19
4122592	Computer_network	200802	66	16	0	0	33	11	10	0	1222	625	274	487	208	19
4122592	Computer_network	200803	78	27	1	0	50	23	17	1	1300	668	301	525	224	21
4122592	Computer_network	200804	88	29	1	0	57	21	16	1	1388	715	330	565	235	25
4122592	Computer_network	200805	82	22	0	0	52	20	14	0	1470	759	352	598	247	27
4122592	Computer_network	200806	64	27	2	0	50	19	19	2	1534	802	379	626	261	28
4122592	Computer_network	200807	72	27	2	1	50	17	15	2	1606	844	406	659	270	29
4122592	Computer_network	200808	76	20	0	0	53	18	16	0	1682	893	426	688	284	30
4122592	Computer_network	200809	80	26	0	0	49	18	15	0	1762	935	452	721	295	30
4122592	Computer_network	200810	118	38	0	0	81	30	24	0	1880	1005	490	765	314	31
4122592	Computer_network	200811	118	34	2	1	68	27	18	2	1998	1061	524	817	331	34
4122592	Computer_network	200812	82	35	0	0	58	24	24	0	2080	1110	559	853	346	37
4122592	Computer_network	200901	85	30	0	0	57	24	20	0	2165	1157	589	887	361	37
4122592	Computer_network	200902	93	30	0	0	58	22	17	0	2258	1204	619	930	375	39
4122592	Computer_network	200903	93	35	1	0	49	19	17	1	2351	1245	654	974	386	40
4122592	Computer_network	200904	101	34	0	0	54	22	20	0	2452	1291	688	1018	401	40
4122592	Computer_network	200905	60	17	0	0	38	13	8	0	2512	1320	705	1041	407	40
4122592	Computer_network	200906	89	36	0	0	52	22	22	0	2601	1360	741	1080	418	44
4122592	Computer_network	200907	65	22	0	0	41	15	15	0	2666	1389	763	1104	424	44
4122592	Computer_network	200908	72	24	0	0	47	21	20	0	2738	1424	787	1134	433	44
4122592	Computer_network	200909	57	25	2	1	35	13	10	2	2795	1453	812	1164	440	48
4122592	Computer_network	200910	77	30	0	0	51	20	17	0	2872	1497	842	1197	453	48
4122592	Computer_network	200911	66	18	0	0	39	19	11	0	2938	1528	860	1233	464	50
4122592	Computer_network	200912	83	36	1	0	50	18	19	1	3021	1571	896	1269	475	52
4122592	Computer_network	201001	75	18	1	0	44	22	14	1	3096	1606	914	1302	489	53
4122592	Computer_network	201002	173	39	0	0	65	25	17	0	3269	1657	953	1363	501	55
4122592	Computer_network	201003	117	37	0	0	59	20	12	0	3386	1704	990	1416	510	57
4122592	Computer_network	201004	120	34	0	0	55	23	19	0	3506	1748	1024	1459	524	58
4122592	Computer_network	201005	67	15	0	0	36	13	6	0	3573	1779	1039	1493	532	58
4122592	Computer_network	201006	70	17	0	0	43	21	11	0	3643	1813	1056	1526	545	59
4122592	Computer_network	201007	49	14	0	0	39	16	10	0	3692	1847	1070	1548	556	60
4122592	Computer_network	201008	55	16	0	0	38	19	11	0	3747	1881	1086	1580	571	61
4122592	Computer_network	201009	67	19	0	0	37	16	12	0	3814	1909	1105	1611	579	61
4122592	Computer_network	201010	75	26	0	0	51	23	15	0	3889	1949	1131	1645	592	64
4122592	Computer_network	201011	98	34	0	0	60	20	18	0	3987	1997	1165	1683	600	65
4122592	Computer_network	201012	81	23	0	0	52	20	16	0	4068	2041	1188	1714	612	67
4122592	Computer_network	201101	80	31	0	0	48	18	15	0	4148	2077	1219	1755	618	69
4122592	Computer_network	201102	77	29	0	0	47	16	14	0	4225	2118	1248	1789	628	69
4122592	Computer_network	201103	66	25	1	0	41	14	12	1	4291	2150	1273	1817	633	73
4122592	Computer_network	201104	56	18	0	0	36	13	8	0	4347	2180	1291	1842	640	73
4122592	Computer_network	201105	35	10	0	0	24	10	7	0	4382	2200	1301	1856	646	73
4122592	Computer_network	201106	69	19	0	0	39	18	13	0	4451	2233	1320	1897	658	74
4122592	Computer_network	201107	75	8	0	0	27	12	7	0	4526	2254	1328	1929	664	75
4122592	Computer_network	201108	65	14	0	0	41	21	11	0	4591	2287	1342	1964	677	75
4122592	Computer_network	201109	57	14	0	0	37	22	10	0	4648	2316	1356	2006	691	78
4122592	Computer_network	201110	58	20	0	0	40	20	12	0	4706	2348	1376	2040	703	81
4122592	Computer_network	201111	42	12	0	0	33	15	9	0	4748	2372	1388	2061	711	81
4122592	Computer_network	201112	36	14	0	0	27	11	7	0	4784	2391	1402	2079	714	81
4122592	Computer_network	201201	36	10	0	0	29	12	7	0	4820	2412	1412	2097	718	81
4122592	Computer_network	201202	40	14	0	0	26	9	8	0	4860	2433	1426	2114	722	81
4122592	Computer_network	201203	42	10	0	0	25	14	8	0	4902	2453	1436	2143	732	81
4122592	Computer_network	201204	36	14	0	0	27	11	10	0	4938	2473	1450	2159	736	81
4122592	Computer_network	201205	41	11	0	0	22	9	7	0	4979	2487	1461	2175	738	81
4122592	Computer_network	201206	31	10	0	0	23	11	4	0	5010	2506	1471	2192	745	81
4122592	Computer_network	201207	38	6	0	0	22	9	3	0	5048	2522	1477	2211	748	81
4122592	Computer_network	201208	31	11	0	0	24	11	9	0	5079	2543	1488	2225	756	81
4122592	Computer_network	201209	28	10	1	0	20	7	7	1	5107	2559	1498	2235	759	83
4122592	Computer_network	201210	42	14	0	0	28	13	10	0	5149	2582	1512	2254	767	83
4122592	Computer_network	201211	35	14	0	0	25	11	8	0	5184	2601	1526	2273	772	84
4122592	Computer_network	201212	56	21	1	0	38	16	14	1	5240	2632	1547	2298	781	86
4122592	Computer_network	201301	30	11	0	0	21	7	6	0	5270	2648	1558	2310	783	86
4122592	Computer_network	201302	60	19	1	0	36	17	11	1	5330	2675	1577	2343	791	90
4122592	Computer_network	201303	51	19	1	0	36	22	15	1	5381	2701	1596	2371	803	92
4122592	Computer_network	201304	66	15	0	0	36	18	9	0	5447	2726	1611	2413	810	93
4122592	Computer_network	201305	84	13	0	0	34	17	11	0	5531	2750	1624	2474	817	94
4122592	Computer_network	201306	67	22	0	0	42	19	14	0	5598	2783	1646	2511	827	94
4122592	Computer_network	201307	35	16	0	0	26	10	10	0	5633	2802	1662	2527	831	94
4122592	Computer_network	201308	34	8	0	0	22	11	6	0	5667	2821	1670	2547	839	94
4122592	Computer_network	201309	38	8	0	0	21	9	5	0	5705	2838	1678	2571	844	94
4122592	Computer_network	201310	75	14	0	0	34	16	11	0	5780	2859	1692	2620	847	95
4122592	Computer_network	201311	71	27	0	0	49	19	16	0	5851	2898	1719	2655	857	95
4122592	Computer_network	201312	45	12	0	0	23	13	11	0	5896	2911	1731	2685	860	95
4122592	Computer_network	201401	46	14	0	0	34	15	10	0	5942	2937	1745	2705	867	96
4122592	Computer_network	201402	49	14	0	0	27	14	9	0	5991	2953	1759	2734	871	96
4122592	Computer_network	201403	69	30	2	0	44	24	22	2	6060	2982	1789	2768	881	102
4122592	Computer_network	201404	59	22	0	0	35	18	13	0	6119	3010	1811	2798	892	104
4122592	Computer_network	201405	25	8	0	0	24	11	8	0	6144	3025	1819	2810	894	104
4122592	Computer_network	201406	35	16	0	0	24	14	12	0	6179	3040	1835	2828	899	104
4122592	Computer_network	201407	17	5	0	0	13	5	4	0	6196	3049	1840	2835	900	104
4122592	Computer_network	201408	25	9	0	0	18	10	9	0	6221	3062	1849	2847	905	104
4122592	Computer_network	201409	33	12	0	0	18	10	8	0	6254	3075	1861	2863	910	105
4122592	Computer_network	201410	32	14	0	0	25	12	9	0	6286	3092	1875	2882	915	108
4122592	Computer_network	201411	29	12	0	0	21	10	9	0	6315	3108	1887	2896	920	110
4122592	Computer_network	201412	48	19	0	0	32	16	11	0	6363	3128	1906	2921	925	112
4122592	Computer_network	201501	35	15	4	2	19	9	11	3	6398	3139	1921	2934	927	114
4122592	Computer_network	201502	55	15	2	1	24	11	7	2	6453	3155	1936	2970	930	117
4122592	Computer_network	201503	30	11	0	0	21	9	8	0	6483	3168	1947	2984	931	118
4122592	Computer_network	201504	22	8	0	0	15	8	5	0	6505	3178	1955	2996	934	119
4122592	Computer_network	201505	40	13	0	0	24	7	6	0	6545	3197	1968	3011	936	120
4122592	Computer_network	201506	34	16	0	0	22	9	9	0	6579	3212	1984	3027	938	120
4122592	Computer_network	201507	24	4	0	0	12	7	2	0	6603	3220	1988	3042	941	122
4122592	Computer_network	201508	44	13	0	0	25	12	8	0	6647	3236	2001	3063	945	122
4122592	Computer_network	201509	36	12	0	0	21	10	4	0	6683	3253	2013	3083	950	122
4122592	Computer_network	201510	29	11	0	0	21	8	7	0	6712	3266	2024	3095	950	122
4122592	Computer_network	201511	34	16	0	0	24	7	8	0	6746	3283	2040	3111	951	123
4122592	Computer_network	201512	49	12	0	0	23	13	6	0	6795	3298	2052	3140	956	127
4122592	Computer_network	201601	27	12	0	0	16	6	5	0	6822	3310	2064	3153	958	128
4122592	Computer_network	201602	32	9	0	0	18	10	7	0	6854	3320	2073	3168	959	129
4122592	Computer_network	201603	31	11	0	0	17	11	4	0	6885	3331	2084	3189	964	131
4122592	Computer_network	201604	25	10	0	0	19	13	7	0	6910	3344	2094	3206	970	136
4122592	Computer_network	201605	40	18	0	0	23	13	5	0	6950	3362	2112	3233	978	143
4122592	Computer_network	201606	41	18	2	1	24	14	12	2	6991	3378	2130	3254	984	148
4122592	Computer_network	201607	28	12	0	0	13	6	6	0	7019	3385	2142	3266	984	148
4122592	Computer_network	201608	24	8	0	0	17	11	6	0	7043	3397	2150	3280	990	152
4122592	Computer_network	201609	55	23	0	0	28	10	9	0	7098	3417	2173	3307	992	153
4122592	Computer_network	201610	26	12	1	0	19	10	9	1	7124	3429	2185	3322	993	156
4122592	Computer_network	201611	36	14	2	1	20	10	8	2	7160	3441	2199	3339	995	158
4122592	Computer_network	201612	60	29	2	1	38	18	15	2	7220	3468	2228	3372	1001	165
4122592	Computer_network	201701	29	9	0	0	19	12	6	0	7249	3483	2237	3391	1008	168
4122592	Computer_network	201702	18	7	0	0	13	9	6	0	7267	3492	2244	3401	1013	171
4122592	Computer_network	201703	19	8	0	0	15	6	6	0	7286	3502	2252	3409	1014	171
4122592	Computer_network	201704	22	10	0	0	15	9	6	0	7308	3512	2262	3422	1017	173
4122592	Computer_network	201705	37	12	0	0	21	10	7	0	7345	3525	2274	3440	1019	175
4122592	Computer_network	201706	10	5	0	0	9	6	4	0	7355	3532	2279	3447	1021	177
4122592	Computer_network	201707	30	12	0	0	23	15	7	0	7385	3549	2291	3467	1028	179
4122592	Computer_network	201708	29	6	0	0	17	14	5	0	7414	3559	2297	3493	1034	183
4122592	Computer_network	201709	31	10	0	0	23	15	7	0	7445	3576	2307	3514	1042	186
4122592	Computer_network	201710	29	11	0	0	21	11	8	0	7474	3590	2318	3533	1044	189
4122592	Computer_network	201711	24	9	0	0	17	8	5	0	7498	3600	2327	3548	1045	190
4122592	Computer_network	201712	32	14	0	0	23	15	9	0	7530	3619	2341	3569	1053	195
4122592	Computer_network	201801	26	12	0	0	23	16	10	0	7556	3632	2353	3588	1055	200
4122592	Computer_network	201802	57	22	0	0	34	20	13	0	7613	3658	2375	3619	1064	204
4122592	Computer_network	201803	20	9	0	0	14	10	6	0	7633	3666	2384	3633	1066	207
4122592	Computer_network	201804	8	2	0	0	8	7	2	0	7641	3669	2386	3640	1068	208
4122592	Computer_network	201805	22	9	0	0	17	11	8	0	7663	3681	2395	3654	1074	211
4122592	Computer_network	201806	28	9	0	0	21	14	6	0	7691	3694	2404	3674	1079	213
4122592	Computer_network	201807	27	12	0	0	21	13	8	0	7718	3710	2416	3691	1085	217
7398	Computer_security	200112	1	0	0	0	1	1	0	0	1	1	0	1	1	0
7398	Computer_security	200201	7	0	0	0	4	4	0	0	8	4	0	8	4	0
7398	Computer_security	200202	4	0	0	0	3	3	0	0	12	7	0	12	7	0
7398	Computer_security	200203	18	1	0	0	7	4	1	0	30	14	1	24	10	0
7398	Computer_security	200204	1	0	0	0	1	0	0	0	31	15	1	24	10	0
7398	Computer_security	200205	4	0	0	0	3	2	0	0	35	18	1	26	12	0
7398	Computer_security	200206	1	0	0	0	1	1	0	0	36	19	1	27	13	0
7398	Computer_security	200207	43	0	0	0	10	4	0	0	79	28	1	48	16	0
7398	Computer_security	200208	1	0	0	0	1	0	0	0	80	29	1	48	16	0
7398	Computer_security	200209	1	0	0	0	1	1	0	0	81	30	1	49	17	0
7398	Computer_security	200211	3	0	0	0	3	3	0	0	84	33	1	52	20	0
7398	Computer_security	200304	3	0	0	0	2	2	0	0	87	34	1	55	21	0
7398	Computer_security	200305	1	0	0	0	1	1	0	0	88	35	1	56	22	0
7398	Computer_security	200306	1	0	0	0	1	0	0	0	89	36	1	56	22	0
7398	Computer_security	200311	2	0	0	0	1	0	0	0	91	37	1	56	22	0
7398	Computer_security	200312	2	0	0	0	2	2	0	0	93	39	1	58	24	0
7398	Computer_security	200401	1	0	0	0	1	1	0	0	94	40	1	59	25	0
7398	Computer_security	200402	8	0	0	0	6	5	0	0	102	44	1	66	28	0
7398	Computer_security	200403	11	1	0	0	7	6	1	0	113	50	2	74	33	0
7398	Computer_security	200404	4	1	0	0	4	3	1	0	117	54	3	77	36	1
7398	Computer_security	200405	4	0	0	0	3	2	0	0	121	57	3	79	38	1
7398	Computer_security	200406	12	0	0	0	7	6	0	0	133	62	3	90	42	1
7398	Computer_security	200407	6	1	0	0	4	2	1	0	139	66	4	94	44	1
7398	Computer_security	200408	13	0	0	0	11	9	0	0	152	72	4	105	48	1
7398	Computer_security	200409	2	0	0	0	2	2	0	0	154	74	4	107	50	1
7398	Computer_security	200410	20	4	0	0	16	8	4	0	174	89	8	117	57	1
7398	Computer_security	200411	9	0	0	0	6	6	0	0	183	92	8	126	60	1
7398	Computer_security	200412	19	1	0	0	12	7	1	0	202	103	9	136	66	1
7398	Computer_security	200501	13	0	0	0	5	5	0	0	215	108	9	149	71	1
7398	Computer_security	200502	4	1	0	0	4	3	1	0	219	112	10	152	74	1
7398	Computer_security	200503	7	1	0	0	6	4	1	0	226	117	11	157	77	1
7398	Computer_security	200504	16	0	0	0	7	6	0	0	242	122	11	172	81	1
7398	Computer_security	200505	9	0	0	0	8	5	0	0	251	128	11	177	84	1
7398	Computer_security	200506	7	0	0	0	6	2	0	0	258	133	11	179	85	1
7398	Computer_security	200507	7	0	0	0	6	3	0	0	265	138	11	183	87	1
7398	Computer_security	200508	27	2	0	0	21	9	2	0	292	156	13	195	94	1
7398	Computer_security	200509	17	3	0	0	11	6	3	0	309	167	16	204	100	1
7398	Computer_security	200510	12	2	0	0	12	7	2	0	321	177	18	211	105	1
7398	Computer_security	200511	20	3	0	0	14	6	3	0	341	188	21	219	108	1
7398	Computer_security	200512	13	1	0	0	12	6	1	0	354	197	22	225	112	1
7398	Computer_security	200601	43	6	0	0	28	10	6	0	397	224	28	237	121	1
7398	Computer_security	200602	22	2	0	0	15	9	2	0	419	237	30	247	129	1
7398	Computer_security	200603	27	9	4	3	13	8	5	2	446	248	39	265	135	4
7398	Computer_security	200604	17	2	0	0	17	11	2	0	463	261	41	276	143	4
7398	Computer_security	200605	21	6	1	0	14	6	4	1	484	273	47	285	147	6
7398	Computer_security	200606	23	7	0	0	17	9	4	0	507	287	54	297	153	7
7398	Computer_security	200607	17	1	0	0	9	5	1	0	524	294	55	302	157	7
7398	Computer_security	200608	16	2	0	0	8	6	2	0	540	300	57	311	162	8
7398	Computer_security	200609	17	3	0	0	17	12	3	0	557	315	60	323	172	9
7398	Computer_security	200610	41	4	0	0	31	17	4	0	598	340	64	345	184	9
7398	Computer_security	200611	23	8	0	0	20	11	6	0	621	357	72	358	192	11
7398	Computer_security	200612	47	6	0	0	27	15	5	0	668	384	78	391	207	15
7398	Computer_security	200701	19	3	0	0	14	8	3	0	687	396	81	402	214	16
7398	Computer_security	200702	26	3	0	0	24	12	3	0	713	418	84	416	224	16
7398	Computer_security	200703	12	4	0	0	11	6	4	0	725	427	88	422	228	16
7398	Computer_security	200704	26	3	0	0	19	12	2	0	751	443	91	437	238	17
7398	Computer_security	200705	35	8	0	0	25	15	5	0	786	463	99	461	248	19
7398	Computer_security	200706	26	3	0	0	13	9	3	0	812	475	102	471	256	20
7398	Computer_security	200707	15	2	0	0	10	4	2	0	827	485	104	480	260	20
7398	Computer_security	200708	22	5	0	0	15	9	4	0	849	498	109	494	267	21
7398	Computer_security	200709	30	6	0	0	17	9	5	0	879	509	115	512	270	23
7398	Computer_security	200710	43	11	0	0	27	16	9	0	922	534	126	537	284	24
7398	Computer_security	200711	30	2	0	0	19	11	2	0	952	548	128	554	291	25
7398	Computer_security	200712	22	8	0	0	17	9	5	0	974	563	136	567	298	26
7398	Computer_security	200801	16	5	0	0	12	3	2	0	990	573	141	574	299	26
7398	Computer_security	200802	23	6	0	0	14	9	5	0	1013	584	147	590	305	27
7398	Computer_security	200803	25	3	0	0	16	10	3	0	1038	597	150	607	313	28
7398	Computer_security	200804	33	9	0	0	20	10	6	0	1071	611	159	621	317	28
7398	Computer_security	200805	21	5	0	0	14	7	5	0	1092	623	164	634	322	28
7398	Computer_security	200806	24	9	0	0	16	7	7	0	1116	637	173	643	327	28
7398	Computer_security	200807	7	2	0	0	5	4	2	0	1123	641	175	649	330	29
7398	Computer_security	200808	13	3	0	0	13	8	3	0	1136	653	178	657	337	30
7398	Computer_security	200809	12	2	0	0	10	9	2	0	1148	661	180	668	344	31
7398	Computer_security	200810	30	9	0	0	22	12	6	0	1178	678	189	683	351	32
7398	Computer_security	200811	18	4	0	0	12	7	4	0	1196	688	193	692	356	32
7398	Computer_security	200812	14	4	0	0	8	3	2	0	1210	694	197	698	358	32
7398	Computer_security	200901	7	2	0	0	6	4	2	0	1217	698	199	702	360	32
7398	Computer_security	200902	32	8	0	0	21	12	6	0	1249	716	207	721	369	34
7398	Computer_security	200903	12	0	0	0	8	5	0	0	1261	721	207	728	371	34
7398	Computer_security	200904	13	5	0	0	12	6	5	0	1274	731	212	735	375	35
7398	Computer_security	200905	7	1	0	0	7	6	1	0	1281	735	213	741	378	35
7398	Computer_security	200906	9	1	0	0	7	4	1	0	1290	741	214	747	381	35
7398	Computer_security	200907	12	2	0	0	10	7	2	0	1302	749	216	755	386	36
7398	Computer_security	200908	1	0	0	0	1	0	0	0	1303	750	216	755	386	36
7398	Computer_security	200909	21	0	0	0	13	8	0	0	1324	760	216	763	391	36
7398	Computer_security	200910	33	7	0	0	14	6	6	0	1357	770	223	771	393	37
7398	Computer_security	200911	12	2	0	0	10	5	2	0	1369	778	225	776	396	37
7398	Computer_security	200912	29	8	0	0	15	7	7	0	1398	790	233	783	400	38
7398	Computer_security	201001	5	1	0	0	3	1	1	0	1403	792	234	784	400	38
7398	Computer_security	201002	9	4	0	0	9	3	4	0	1412	800	238	787	402	38
7398	Computer_security	201003	17	3	0	0	14	6	2	0	1429	811	241	796	405	38
7398	Computer_security	201004	14	4	0	0	12	6	4	0	1443	821	245	803	409	38
7398	Computer_security	201005	30	3	0	0	15	8	3	0	1473	833	248	816	414	38
7398	Computer_security	201006	12	2	0	0	11	7	2	0	1485	843	250	823	420	39
7398	Computer_security	201007	48	7	0	0	20	12	4	0	1533	861	257	860	430	40
7398	Computer_security	201008	6	2	0	0	6	4	2	0	1539	865	259	864	432	41
7398	Computer_security	201009	34	7	0	0	19	12	7	0	1573	881	266	889	441	42
7398	Computer_security	201010	14	6	0	0	11	8	4	0	1587	888	272	899	445	44
7398	Computer_security	201011	24	7	0	0	20	12	7	0	1611	905	279	915	454	46
7398	Computer_security	201012	19	5	0	0	14	8	5	0	1630	914	284	923	457	46
7398	Computer_security	201101	15	3	0	0	11	5	2	0	1645	922	287	932	459	46
7398	Computer_security	201102	17	6	0	0	12	4	3	0	1662	932	293	939	461	47
7398	Computer_security	201103	6	2	0	0	6	2	2	0	1668	937	295	941	462	47
7398	Computer_security	201104	3	0	0	0	2	2	0	0	1671	938	295	944	463	47
7398	Computer_security	201105	8	2	0	0	7	5	2	0	1679	943	297	950	466	47
7398	Computer_security	201106	14	2	0	0	9	7	2	0	1693	951	299	962	472	48
7398	Computer_security	201107	5	1	0	0	5	1	1	0	1698	955	300	963	472	48
7398	Computer_security	201108	12	2	0	0	10	8	2	0	1710	963	302	972	478	49
7398	Computer_security	201109	12	4	0	0	10	5	3	0	1722	972	306	979	482	49
7398	Computer_security	201110	10	2	0	0	8	3	1	0	1732	980	308	984	485	49
7398	Computer_security	201111	14	2	0	0	11	9	2	0	1746	987	310	996	490	50
7398	Computer_security	201112	23	4	0	0	17	10	3	0	1769	1000	314	1010	496	50
7398	Computer_security	201201	8	3	0	0	7	6	3	0	1777	1002	317	1017	497	51
7398	Computer_security	201202	21	7	0	0	15	8	7	0	1798	1013	324	1025	501	51
7398	Computer_security	201203	7	2	0	0	6	4	2	0	1805	1016	326	1029	502	52
7398	Computer_security	201204	6	1	0	0	4	3	1	0	1811	1019	327	1034	504	52
7398	Computer_security	201205	17	7	1	0	9	6	5	1	1828	1026	334	1046	508	55
7398	Computer_security	201206	10	2	0	0	10	7	2	0	1838	1034	336	1053	513	55
7398	Computer_security	201207	3	0	0	0	3	2	0	0	1841	1037	336	1055	515	55
7398	Computer_security	201209	11	2	0	0	9	7	2	0	1852	1045	338	1063	521	56
7398	Computer_security	201210	7	0	0	0	5	3	0	0	1859	1049	338	1066	523	56
7398	Computer_security	201211	24	8	0	0	14	5	6	0	1883	1061	346	1075	526	56
7398	Computer_security	201212	34	9	0	0	19	12	6	0	1917	1077	355	1095	535	57
7398	Computer_security	201301	8	1	0	0	6	3	1	0	1925	1082	356	1098	537	57
7398	Computer_security	201302	11	2	0	0	8	5	2	0	1936	1088	358	1103	540	58
7398	Computer_security	201303	18	1	0	0	12	8	1	0	1954	1097	359	1117	545	58
7398	Computer_security	201304	11	2	0	0	10	4	1	0	1965	1105	361	1122	547	58
7398	Computer_security	201305	22	5	0	0	13	6	3	0	1987	1116	366	1134	551	58
7398	Computer_security	201306	11	1	0	0	9	4	1	0	1998	1124	367	1139	554	58
7398	Computer_security	201307	18	6	0	0	14	8	4	0	2016	1134	373	1150	558	58
7398	Computer_security	201308	8	3	0	0	7	5	3	0	2024	1139	376	1156	561	59
7398	Computer_security	201309	13	0	0	0	11	4	0	0	2037	1148	376	1160	563	59
7398	Computer_security	201310	16	3	0	0	13	7	3	0	2053	1161	379	1169	570	59
7398	Computer_security	201311	20	10	2	1	14	10	8	2	2073	1172	389	1182	577	62
7398	Computer_security	201312	14	1	0	0	8	6	1	0	2087	1179	390	1193	582	62
7398	Computer_security	201401	24	4	0	0	12	7	3	0	2111	1189	394	1209	587	62
7398	Computer_security	201402	5	0	0	0	4	2	0	0	2116	1192	394	1212	588	62
7398	Computer_security	201403	26	8	0	0	16	8	5	0	2142	1204	402	1228	592	63
7398	Computer_security	201404	50	3	0	0	9	6	2	0	2192	1209	405	1275	594	64
7398	Computer_security	201405	28	5	1	0	19	14	4	1	2220	1220	410	1296	600	66
7398	Computer_security	201406	13	5	0	0	10	5	5	0	2233	1228	415	1301	603	66
7398	Computer_security	201407	7	1	0	0	7	6	1	0	2240	1233	416	1307	607	67
7398	Computer_security	201408	20	3	0	0	10	6	3	0	2260	1239	419	1323	609	67
7398	Computer_security	201409	12	1	0	0	9	3	1	0	2272	1246	420	1326	610	67
7398	Computer_security	201410	14	2	0	0	8	5	1	0	2286	1253	422	1333	614	67
7398	Computer_security	201411	27	3	0	0	13	10	3	0	2313	1262	425	1357	620	67
7398	Computer_security	201412	44	8	0	0	21	11	7	0	2357	1278	433	1388	627	68
7398	Computer_security	201501	24	1	0	0	13	6	1	0	2381	1287	434	1397	629	68
7398	Computer_security	201502	20	3	0	0	11	6	2	0	2401	1296	437	1410	632	69
7398	Computer_security	201503	25	1	0	0	12	10	1	0	2426	1305	438	1433	639	70
7398	Computer_security	201504	6	2	0	0	5	3	2	0	2432	1308	440	1436	640	70
7398	Computer_security	201505	17	2	0	0	12	9	2	0	2449	1319	442	1449	648	70
7398	Computer_security	201506	19	4	0	0	12	6	4	0	2468	1327	446	1455	650	70
7398	Computer_security	201507	60	4	0	0	19	11	4	0	2528	1341	450	1500	656	70
7398	Computer_security	201508	40	3	0	0	10	7	3	0	2568	1348	453	1536	660	71
7398	Computer_security	201509	17	1	0	0	13	10	1	0	2585	1356	454	1549	665	72
7398	Computer_security	201510	53	5	0	0	13	10	5	0	2638	1363	459	1597	669	74
7398	Computer_security	201511	10	3	0	0	9	6	2	0	2648	1370	462	1604	673	74
7398	Computer_security	201512	23	7	0	0	16	10	6	0	2671	1382	469	1619	678	75
7398	Computer_security	201601	25	2	0	0	12	10	2	0	2696	1387	471	1642	681	75
7398	Computer_security	201602	3	1	0	0	3	2	1	0	2699	1390	472	1644	683	75
7398	Computer_security	201603	17	4	0	0	12	7	3	0	2716	1400	476	1653	688	76
7398	Computer_security	201604	6	2	0	0	6	5	2	0	2722	1406	478	1658	693	77
7398	Computer_security	201605	19	4	0	0	14	9	4	0	2741	1416	482	1671	698	77
7398	Computer_security	201606	38	1	0	0	20	15	1	0	2779	1429	483	1704	706	77
7398	Computer_security	201607	39	11	0	0	26	18	7	0	2818	1449	494	1729	718	77
7398	Computer_security	201608	26	2	0	0	12	12	2	0	2844	1456	496	1755	724	79
7398	Computer_security	201609	28	3	0	0	17	13	3	0	2872	1468	499	1778	731	79
7398	Computer_security	201610	27	5	0	0	19	10	3	0	2899	1482	504	1791	736	80
7398	Computer_security	201611	15	4	0	0	12	9	3	0	2914	1492	508	1803	743	83
7398	Computer_security	201612	29	6	0	0	21	14	6	0	2943	1508	514	1822	750	85
7398	Computer_security	201701	16	5	0	0	9	7	3	0	2959	1515	519	1834	755	87
7398	Computer_security	201702	19	4	0	0	12	6	4	0	2978	1523	523	1841	757	88
7398	Computer_security	201703	44	15	0	0	23	17	9	0	3022	1540	538	1866	768	92
7398	Computer_security	201704	26	5	0	0	14	12	4	0	3048	1549	543	1888	774	95
7398	Computer_security	201705	15	4	0	0	14	9	4	0	3063	1556	547	1898	776	95
7398	Computer_security	201706	26	6	0	0	19	15	5	0	3089	1572	553	1920	785	98
7398	Computer_security	201707	50	3	0	0	17	14	3	0	3139	1582	556	1967	791	99
7398	Computer_security	201708	21	6	0	0	19	13	6	0	3160	1594	562	1980	796	101
7398	Computer_security	201709	28	6	0	0	20	12	6	0	3188	1607	568	1993	801	102
7398	Computer_security	201710	23	5	0	0	19	14	5	0	3211	1620	573	2011	809	104
7398	Computer_security	201711	32	5	0	0	20	15	4	0	3243	1634	578	2038	816	106
7398	Computer_security	201712	31	6	0	0	19	13	5	0	3274	1648	584	2059	823	106
7398	Computer_security	201801	21	4	0	0	18	14	3	0	3295	1660	588	2074	831	106
7398	Computer_security	201802	34	13	0	0	21	16	7	0	3329	1674	601	2101	836	113
7398	Computer_security	201803	17	3	0	0	15	11	3	0	3346	1685	604	2114	842	115
7398	Computer_security	201804	32	9	0	0	21	13	5	0	3378	1703	613	2136	848	117
7398	Computer_security	201805	26	8	1	0	19	15	6	1	3404	1715	621	2158	856	122
7398	Computer_security	201806	19	2	0	0	14	10	2	0	3423	1728	623	2173	865	122
7398	Computer_security	201807	11	2	0	0	9	7	1	0	3434	1734	625	2182	868	123
6596	Computer_vision	200111	1	0	0	0	1	1	0	0	1	1	0	1	1	0
6596	Computer_vision	200112	1	0	0	0	1	1	0	0	2	2	0	2	1	0
6596	Computer_vision	200202	4	0	0	0	2	2	0	0	6	4	0	6	3	0
6596	Computer_vision	200204	3	0	0	0	2	2	0	0	9	6	0	9	4	0
6596	Computer_vision	200212	2	0	0	0	1	0	0	0	11	7	0	9	4	0
6596	Computer_vision	200301	3	0	0	0	3	2	0	0	14	10	0	11	6	0
6596	Computer_vision	200303	6	0	0	0	3	2	0	0	20	13	0	16	8	0
6596	Computer_vision	200305	1	0	0	0	1	0	0	0	21	14	0	16	8	0
6596	Computer_vision	200307	1	0	0	0	1	1	0	0	22	15	0	17	9	0
6596	Computer_vision	200312	1	0	0	0	1	0	0	0	23	16	0	17	9	0
6596	Computer_vision	200402	1	0	0	0	1	0	0	0	24	17	0	17	9	0
6596	Computer_vision	200403	1	0	0	0	1	1	0	0	25	18	0	18	10	0
6596	Computer_vision	200404	1	0	0	0	1	0	0	0	26	19	0	18	10	0
6596	Computer_vision	200405	5	1	0	0	4	3	1	0	31	23	1	21	13	0
6596	Computer_vision	200406	3	0	0	0	2	1	0	0	34	25	1	22	14	0
6596	Computer_vision	200407	7	0	0	0	4	3	0	0	41	29	1	28	17	0
6596	Computer_vision	200408	5	1	0	0	3	3	1	0	46	32	2	33	20	1
6596	Computer_vision	200409	3	1	0	0	2	1	1	0	49	34	3	34	21	1
6596	Computer_vision	200410	2	0	0	0	2	1	0	0	51	36	3	35	22	1
6596	Computer_vision	200411	2	0	0	0	1	0	0	0	53	37	3	35	22	1
6596	Computer_vision	200412	1	0	0	0	1	1	0	0	54	38	3	36	23	1
6596	Computer_vision	200501	3	0	0	0	2	1	0	0	57	40	3	37	24	1
6596	Computer_vision	200502	1	0	0	0	1	1	0	0	58	41	3	38	25	1
6596	Computer_vision	200503	2	0	0	0	1	1	0	0	60	42	3	40	26	1
6596	Computer_vision	200504	3	0	0	0	3	2	0	0	63	43	3	42	26	1
6596	Computer_vision	200505	5	0	0	0	3	3	0	0	68	45	3	47	28	1
6596	Computer_vision	200506	2	0	0	0	2	2	0	0	70	47	3	49	30	1
6596	Computer_vision	200507	1	0	0	0	1	1	0	0	71	48	3	50	31	1
6596	Computer_vision	200508	2	0	0	0	2	0	0	0	73	50	3	50	31	1
6596	Computer_vision	200509	6	0	0	0	6	2	0	0	79	56	3	52	33	1
6596	Computer_vision	200510	12	0	0	0	6	4	0	0	91	61	3	57	36	1
6596	Computer_vision	200511	30	0	0	0	13	3	0	0	121	73	3	72	38	1
6596	Computer_vision	200512	35	0	0	0	20	9	0	0	156	92	3	89	46	1
6596	Computer_vision	200601	4	0	0	0	3	2	0	0	160	94	3	92	47	1
6596	Computer_vision	200602	13	0	0	0	5	2	0	0	173	98	3	95	48	1
6596	Computer_vision	200603	34	0	0	0	8	5	0	0	207	104	3	125	51	1
6596	Computer_vision	200604	12	0	0	0	7	4	0	0	219	108	3	134	52	1
6596	Computer_vision	200605	17	1	0	0	8	6	1	0	236	114	4	147	56	1
6596	Computer_vision	200606	17	0	0	0	12	8	0	0	253	125	4	159	63	1
6596	Computer_vision	200607	5	1	0	0	3	2	1	0	258	127	5	163	64	2
6596	Computer_vision	200608	23	0	0	0	6	5	0	0	281	131	5	185	67	2
6596	Computer_vision	200609	42	3	0	0	15	9	3	0	323	144	8	219	74	2
6596	Computer_vision	200610	4	1	0	0	3	1	1	0	327	147	9	220	75	2
6596	Computer_vision	200611	11	1	0	0	10	4	1	0	338	155	10	225	77	2
6596	Computer_vision	200612	9	1	0	0	7	3	1	0	347	161	11	228	79	3
6596	Computer_vision	200701	10	1	0	0	10	7	1	0	357	169	12	235	84	3
6596	Computer_vision	200702	13	0	0	0	8	3	0	0	370	176	12	241	86	3
6596	Computer_vision	200703	46	1	0	0	11	5	1	0	416	185	13	278	90	3
6596	Computer_vision	200704	45	1	0	0	10	4	1	0	461	193	14	308	92	3
6596	Computer_vision	200705	7	2	0	0	7	4	2	0	468	199	16	312	95	3
6596	Computer_vision	200706	12	2	0	0	9	4	2	0	480	207	18	316	98	3
6596	Computer_vision	200707	6	1	0	0	4	1	1	0	486	211	19	317	99	3
6596	Computer_vision	200708	23	6	0	0	12	9	4	0	509	221	25	334	106	7
6596	Computer_vision	200709	11	1	0	0	5	4	1	0	520	225	26	344	109	8
6596	Computer_vision	200710	3	0	0	0	3	0	0	0	523	228	26	344	109	8
6596	Computer_vision	200711	3	1	0	0	3	1	1	0	526	230	27	345	109	8
6596	Computer_vision	200712	11	1	0	0	7	3	1	0	537	236	28	350	111	8
6596	Computer_vision	200801	12	0	0	0	2	1	0	0	549	238	28	360	112	8
6596	Computer_vision	200803	17	3	0	0	8	5	2	0	566	245	31	373	116	9
6596	Computer_vision	200804	11	4	0	0	8	3	2	0	577	252	35	379	118	9
6596	Computer_vision	200805	9	2	0	0	6	4	1	0	586	257	37	384	121	10
6596	Computer_vision	200806	4	1	0	0	3	1	1	0	590	259	38	385	121	10
6596	Computer_vision	200807	2	0	0	0	2	1	0	0	592	261	38	386	122	10
6596	Computer_vision	200808	7	1	0	0	5	3	1	0	599	265	39	391	124	10
6596	Computer_vision	200809	12	4	0	0	9	5	3	0	611	273	43	397	128	10
6596	Computer_vision	200810	8	1	0	0	7	5	1	0	619	279	44	403	132	11
6596	Computer_vision	200811	11	3	0	0	7	4	3	0	630	285	47	409	135	11
6596	Computer_vision	200812	2	0	0	0	2	2	0	0	632	287	47	411	137	11
6596	Computer_vision	200901	2	0	0	0	2	1	0	0	634	288	47	412	137	11
6596	Computer_vision	200902	18	2	0	0	7	5	2	0	652	295	49	418	142	12
6596	Computer_vision	200903	5	1	0	0	4	3	1	0	657	298	50	422	144	12
6596	Computer_vision	200904	7	2	0	0	4	2	2	0	664	301	52	424	145	12
6596	Computer_vision	200905	3	0	0	0	2	1	0	0	667	302	52	425	145	12
6596	Computer_vision	200906	9	2	0	0	5	4	1	0	676	306	54	433	148	13
6596	Computer_vision	200908	11	1	0	0	7	5	1	0	687	310	55	441	150	14
6596	Computer_vision	200909	17	3	0	0	8	6	2	0	704	316	58	455	154	15
6596	Computer_vision	200910	3	1	0	0	3	2	1	0	707	318	59	457	155	15
6596	Computer_vision	200911	15	0	0	0	5	4	0	0	722	320	59	471	156	15
6596	Computer_vision	200912	10	0	0	0	5	3	0	0	732	323	59	478	157	15
6596	Computer_vision	201001	24	5	0	0	11	6	3	0	756	331	64	489	160	15
6596	Computer_vision	201002	16	3	0	0	11	9	3	0	772	339	67	503	166	17
6596	Computer_vision	201003	4	1	0	0	4	2	1	0	776	342	68	505	167	17
6596	Computer_vision	201004	9	2	0	0	7	2	2	0	785	349	70	508	169	17
6596	Computer_vision	201005	5	0	0	0	2	0	0	0	790	351	70	508	169	17
6596	Computer_vision	201006	15	5	1	0	12	4	3	1	805	361	75	514	171	19
6596	Computer_vision	201007	6	1	0	0	4	3	1	0	811	364	76	518	173	19
6596	Computer_vision	201008	6	0	0	0	5	4	0	0	817	369	76	522	177	19
6596	Computer_vision	201010	3	0	0	0	3	3	0	0	820	371	76	525	179	19
6596	Computer_vision	201011	7	2	0	0	7	5	2	0	827	377	78	530	183	20
6596	Computer_vision	201012	6	2	0	0	6	3	2	0	833	380	80	533	183	20
6596	Computer_vision	201101	8	4	0	0	7	4	3	0	841	385	84	538	185	21
6596	Computer_vision	201102	8	1	0	0	5	3	1	0	849	387	85	543	186	21
6596	Computer_vision	201103	10	2	0	0	7	6	2	0	859	391	87	552	189	22
6596	Computer_vision	201105	4	0	0	0	3	1	0	0	863	393	87	554	189	22
6596	Computer_vision	201106	18	7	0	0	12	5	5	0	881	404	94	561	193	22
6596	Computer_vision	201107	14	2	0	0	11	7	2	0	895	409	96	569	195	22
6596	Computer_vision	201108	4	0	0	0	4	4	0	0	899	412	96	573	198	22
6596	Computer_vision	201109	8	1	0	0	6	3	1	0	907	416	97	576	200	22
6596	Computer_vision	201110	77	1	0	0	8	7	1	0	984	421	98	650	204	23
6596	Computer_vision	201111	7	1	0	0	6	3	1	0	991	426	99	653	206	23
6596	Computer_vision	201112	29	4	1	0	9	6	3	1	1020	431	103	679	208	25
6596	Computer_vision	201201	7	1	0	0	5	4	1	0	1027	435	104	684	211	26
6596	Computer_vision	201202	5	1	0	0	3	2	1	0	1032	436	105	688	211	26
6596	Computer_vision	201203	1	0	0	0	1	0	0	0	1033	437	105	688	211	26
6596	Computer_vision	201204	5	1	0	0	5	3	1	0	1038	441	106	691	213	26
6596	Computer_vision	201205	11	2	0	0	8	7	2	0	1049	446	108	701	217	27
6596	Computer_vision	201206	1	0	0	0	1	1	0	0	1050	447	108	702	218	27
6596	Computer_vision	201207	2	1	0	0	2	1	1	0	1052	448	109	703	218	27
6596	Computer_vision	201208	5	1	0	0	5	4	1	0	1057	451	110	707	220	27
6596	Computer_vision	201210	3	0	0	0	2	1	0	0	1060	453	110	709	221	27
6596	Computer_vision	201302	2	1	0	0	2	1	1	0	1062	454	111	710	221	27
6596	Computer_vision	201303	6	1	0	0	5	4	1	0	1068	458	112	715	224	27
6596	Computer_vision	201305	5	0	0	0	2	2	0	0	1073	459	112	720	225	27
6596	Computer_vision	201306	8	3	0	0	3	2	1	0	1081	462	115	727	227	30
6596	Computer_vision	201307	9	0	0	0	3	3	0	0	1090	464	115	736	229	30
6596	Computer_vision	201308	4	1	0	0	4	4	1	0	1094	466	116	740	231	31
6596	Computer_vision	201309	1	0	0	0	1	1	0	0	1095	467	116	741	232	31
6596	Computer_vision	201310	4	1	0	0	2	2	1	0	1099	468	117	745	233	32
6596	Computer_vision	201311	5	0	0	0	4	3	0	0	1104	470	117	749	234	32
6596	Computer_vision	201401	9	2	0	0	6	6	2	0	1113	475	119	758	239	34
6596	Computer_vision	201402	14	3	1	0	7	4	3	1	1127	480	122	767	241	37
6596	Computer_vision	201403	6	1	0	0	3	2	1	0	1133	482	123	769	242	38
6596	Computer_vision	201404	16	4	0	0	11	7	3	0	1149	489	127	779	245	38
6596	Computer_vision	201405	2	1	0	0	2	2	1	0	1151	490	128	781	246	39
6596	Computer_vision	201406	4	0	0	0	2	0	0	0	1155	492	128	781	246	39
6596	Computer_vision	201407	1	0	0	0	1	1	0	0	1156	493	128	782	247	39
6596	Computer_vision	201408	3	0	0	0	2	2	0	0	1159	495	128	785	249	39
6596	Computer_vision	201409	1	0	0	0	1	1	0	0	1160	496	128	786	250	39
6596	Computer_vision	201410	5	1	0	0	4	4	1	0	1165	498	129	791	252	40
6596	Computer_vision	201411	2	0	0	0	1	0	0	0	1167	499	129	791	252	40
6596	Computer_vision	201412	2	1	0	0	2	1	1	0	1169	500	130	792	252	40
6596	Computer_vision	201501	10	1	0	0	4	3	1	0	1179	503	131	797	254	40
6596	Computer_vision	201502	4	1	0	0	3	3	1	0	1183	505	132	801	256	41
6596	Computer_vision	201503	3	1	0	0	3	2	1	0	1186	507	133	803	257	41
6596	Computer_vision	201504	2	1	0	0	2	2	1	0	1188	509	134	805	259	42
6596	Computer_vision	201505	5	1	0	0	4	3	1	0	1193	513	135	809	261	43
6596	Computer_vision	201507	4	2	0	0	3	2	2	0	1197	515	137	811	262	43
6596	Computer_vision	201508	1	0	0	0	1	1	0	0	1198	516	137	812	263	43
6596	Computer_vision	201509	1	0	0	0	1	1	0	0	1199	517	137	813	264	43
6596	Computer_vision	201510	4	2	0	0	4	1	2	0	1203	521	139	814	264	43
6596	Computer_vision	201511	4	0	0	0	3	2	0	0	1207	524	139	817	266	43
6596	Computer_vision	201512	3	0	0	0	1	0	0	0	1210	525	139	817	266	43
6596	Computer_vision	201601	2	0	0	0	2	1	0	0	1212	527	139	818	267	43
6596	Computer_vision	201602	3	0	0	0	2	2	0	0	1215	529	139	821	267	43
6596	Computer_vision	201604	5	1	0	0	5	4	1	0	1220	534	140	825	271	43
6596	Computer_vision	201605	1	0	0	0	1	1	0	0	1221	535	140	826	272	43
6596	Computer_vision	201606	10	0	0	0	6	5	0	0	1231	540	140	834	276	43
6596	Computer_vision	201607	8	1	0	0	6	3	1	0	1239	545	141	838	278	43
6596	Computer_vision	201608	7	0	0	0	3	3	0	0	1246	546	141	845	279	43
6596	Computer_vision	201609	13	1	0	0	8	8	1	0	1259	551	142	858	284	44
6596	Computer_vision	201610	1	0	0	0	1	1	0	0	1260	551	142	859	284	44
6596	Computer_vision	201611	1	0	0	0	1	1	0	0	1261	552	142	860	285	44
6596	Computer_vision	201612	4	1	0	0	2	2	1	0	1265	553	143	864	286	45
6596	Computer_vision	201701	2	0	0	0	1	0	0	0	1267	554	143	864	286	45
6596	Computer_vision	201702	4	0	0	0	2	2	0	0	1271	555	143	868	287	45
6596	Computer_vision	201704	34	1	0	0	8	8	1	0	1305	559	144	902	291	46
6596	Computer_vision	201705	5	2	0	0	3	2	1	0	1310	562	146	905	293	46
6596	Computer_vision	201707	1	0	0	0	1	1	0	0	1311	563	146	906	294	46
6596	Computer_vision	201708	4	0	0	0	2	2	0	0	1315	565	146	910	296	46
6596	Computer_vision	201709	5	0	0	0	4	4	0	0	1320	567	146	915	298	46
6596	Computer_vision	201710	2	0	0	0	2	2	0	0	1322	568	146	917	299	46
6596	Computer_vision	201711	2	0	0	0	2	2	0	0	1324	570	146	919	301	46
6596	Computer_vision	201712	1	0	0	0	1	1	0	0	1325	571	146	920	301	46
6596	Computer_vision	201801	10	2	0	0	6	5	2	0	1335	575	148	929	304	47
6596	Computer_vision	201802	13	1	0	0	12	10	1	0	1348	583	149	940	310	47
6596	Computer_vision	201803	2	0	0	0	1	0	0	0	1350	584	149	940	310	47
6596	Computer_vision	201804	2	0	0	0	1	1	0	0	1352	584	149	942	310	47
6596	Computer_vision	201805	7	0	0	0	1	1	0	0	1359	585	149	949	311	47
6596	Computer_vision	201806	2	0	0	0	2	2	0	0	1361	587	149	951	313	47
6596	Computer_vision	201807	8	0	0	0	7	3	0	0	1369	593	149	954	315	47
31250501	Connected_car	201104	4	0	0	0	2	2	0	0	4	2	0	4	2	0
31250501	Connected_car	201105	1	0	0	0	1	1	0	0	5	3	0	5	3	0
31250501	Connected_car	201109	1	0	0	0	1	0	0	0	6	4	0	5	3	0
31250501	Connected_car	201204	1	0	0	0	1	1	0	0	7	5	0	6	4	0
31250501	Connected_car	201205	1	0	0	0	1	1	0	0	8	6	0	7	5	0
31250501	Connected_car	201209	1	0	0	0	1	1	0	0	9	7	0	8	6	0
31250501	Connected_car	201301	4	0	0	0	4	3	0	0	13	11	0	11	9	0
31250501	Connected_car	201304	1	0	0	0	1	1	0	0	14	12	0	12	10	0
31250501	Connected_car	201306	1	0	0	0	1	0	0	0	15	13	0	12	10	0
31250501	Connected_car	201308	1	0	0	0	1	1	0	0	16	14	0	13	11	0
31250501	Connected_car	201309	5	0	0	0	4	1	0	0	21	18	0	14	12	0
31250501	Connected_car	201310	1	0	0	0	1	0	0	0	22	19	0	14	12	0
31250501	Connected_car	201404	6	1	0	0	4	3	1	0	28	23	1	18	15	1
31250501	Connected_car	201405	4	0	0	0	1	1	0	0	32	24	1	22	16	1
31250501	Connected_car	201407	1	0	0	0	1	1	0	0	33	25	1	23	17	1
31250501	Connected_car	201409	5	0	0	0	4	2	0	0	38	29	1	26	19	1
31250501	Connected_car	201410	4	1	0	0	3	1	1	0	42	31	2	27	20	1
31250501	Connected_car	201411	2	0	0	0	1	0	0	0	44	32	2	27	20	1
31250501	Connected_car	201501	4	1	0	0	4	4	1	0	48	36	3	31	24	2
31250501	Connected_car	201505	1	0	0	0	1	1	0	0	49	37	3	32	25	2
31250501	Connected_car	201507	2	0	0	0	2	2	0	0	51	39	3	34	27	2
31250501	Connected_car	201508	1	0	0	0	1	0	0	0	52	40	3	34	27	2
31250501	Connected_car	201510	1	0	0	0	1	0	0	0	53	41	3	34	27	2
31250501	Connected_car	201511	1	0	0	0	1	0	0	0	54	42	3	34	27	2
31250501	Connected_car	201602	2	1	0	0	2	2	1	0	56	44	4	36	29	3
31250501	Connected_car	201603	1	0	0	0	1	0	0	0	57	45	4	36	29	3
31250501	Connected_car	201604	2	0	0	0	2	2	0	0	59	47	4	38	31	3
31250501	Connected_car	201605	8	1	0	0	6	3	1	0	67	52	5	42	33	3
31250501	Connected_car	201606	1	0	0	0	1	0	0	0	68	53	5	42	33	3
31250501	Connected_car	201607	1	1	0	0	1	1	1	0	69	54	6	43	34	3
31250501	Connected_car	201608	2	0	0	0	2	2	0	0	71	55	6	45	35	3
31250501	Connected_car	201609	1	0	0	0	1	0	0	0	72	56	6	45	35	3
31250501	Connected_car	201610	4	0	0	0	1	1	0	0	76	57	6	49	36	3
31250501	Connected_car	201612	14	0	0	0	9	6	0	0	90	63	6	58	40	3
31250501	Connected_car	201701	8	0	0	0	4	4	0	0	98	66	6	66	43	3
31250501	Connected_car	201702	2	0	0	0	2	1	0	0	100	68	6	67	44	3
31250501	Connected_car	201703	1	0	0	0	1	1	0	0	101	68	6	68	44	3
31250501	Connected_car	201704	1	0	0	0	1	0	0	0	102	69	6	68	44	3
31250501	Connected_car	201705	8	0	0	0	6	4	0	0	110	74	6	74	48	3
31250501	Connected_car	201706	12	1	0	0	9	9	1	0	122	81	7	86	55	4
31250501	Connected_car	201707	4	1	0	0	4	2	1	0	126	84	8	88	56	4
31250501	Connected_car	201708	1	0	0	0	1	1	0	0	127	84	8	89	56	4
31250501	Connected_car	201710	3	0	0	0	3	1	0	0	130	87	8	90	57	4
31250501	Connected_car	201711	8	1	0	0	4	2	1	0	138	90	9	96	58	5
31250501	Connected_car	201712	14	1	0	0	9	7	1	0	152	99	10	108	65	6
31250501	Connected_car	201801	3	0	0	0	2	2	0	0	155	101	10	111	67	6
31250501	Connected_car	201802	1	0	0	0	1	0	0	0	156	102	10	111	67	6
31250501	Connected_car	201803	2	0	0	0	1	0	0	0	158	103	10	111	67	6
31250501	Connected_car	201804	2	0	0	0	2	1	0	0	160	103	10	112	67	6
31250501	Connected_car	201805	3	0	0	0	2	2	0	0	163	105	10	115	69	6
31250501	Connected_car	201807	2	0	0	0	2	2	0	0	165	107	10	117	71	6
40950	Connectionless_communication	200205	1	0	0	0	1	0	0	0	1	1	0	0	0	0
40950	Connectionless_communication	200403	2	0	0	0	2	0	0	0	3	3	0	0	0	0
40950	Connectionless_communication	200405	1	0	0	0	1	1	0	0	4	4	0	1	1	0
40950	Connectionless_communication	200407	1	0	0	0	1	1	0	0	5	5	0	2	2	0
40950	Connectionless_communication	200410	1	0	0	0	1	1	0	0	6	6	0	3	3	0
40950	Connectionless_communication	200412	2	0	0	0	2	2	0	0	8	8	0	5	5	0
40950	Connectionless_communication	200501	2	0	0	0	1	1	0	0	10	9	0	7	6	0
40950	Connectionless_communication	200503	2	0	0	0	1	0	0	0	12	10	0	7	6	0
40950	Connectionless_communication	200506	1	0	0	0	1	1	0	0	13	11	0	8	7	0
40950	Connectionless_communication	200509	2	0	0	0	1	1	0	0	15	12	0	10	8	0
40950	Connectionless_communication	200511	2	0	0	0	2	2	0	0	17	14	0	12	10	0
40950	Connectionless_communication	200512	1	0	0	0	1	1	0	0	18	15	0	13	11	0
40950	Connectionless_communication	200601	4	0	0	0	3	2	0	0	22	18	0	15	13	0
40950	Connectionless_communication	200602	1	0	0	0	1	1	0	0	23	19	0	16	14	0
40950	Connectionless_communication	200604	1	0	0	0	1	0	0	0	24	20	0	16	14	0
40950	Connectionless_communication	200610	1	0	0	0	1	1	0	0	25	21	0	17	15	0
40950	Connectionless_communication	200612	1	0	0	0	1	1	0	0	26	22	0	18	16	0
40950	Connectionless_communication	200707	2	1	0	0	2	1	1	0	28	23	1	19	16	0
40950	Connectionless_communication	200709	2	0	0	0	2	2	0	0	30	25	1	21	18	0
40950	Connectionless_communication	200804	6	1	0	0	3	2	1	0	36	27	2	23	19	0
40950	Connectionless_communication	200805	1	0	0	0	1	0	0	0	37	28	2	23	19	0
40950	Connectionless_communication	200809	2	0	0	0	2	1	0	0	39	30	2	24	20	0
40950	Connectionless_communication	200901	1	0	0	0	1	1	0	0	40	31	2	25	21	0
40950	Connectionless_communication	200903	1	0	0	0	1	1	0	0	41	32	2	26	22	0
40950	Connectionless_communication	200910	1	0	0	0	1	1	0	0	42	33	2	27	23	0
40950	Connectionless_communication	200912	1	0	0	0	1	1	0	0	43	34	2	28	24	0
40950	Connectionless_communication	201004	2	0	0	0	1	1	0	0	45	35	2	30	25	0
40950	Connectionless_communication	201007	2	0	0	0	2	2	0	0	47	37	2	32	27	0
40950	Connectionless_communication	201008	1	0	0	0	1	1	0	0	48	38	2	33	28	0
40950	Connectionless_communication	201102	1	0	0	0	1	1	0	0	49	39	2	34	29	0
40950	Connectionless_communication	201107	2	0	0	0	2	2	0	0	51	40	2	36	30	0
40950	Connectionless_communication	201112	1	0	0	0	1	1	0	0	52	41	2	37	31	0
40950	Connectionless_communication	201201	1	0	0	0	1	0	0	0	53	42	2	37	31	0
40950	Connectionless_communication	201202	1	0	0	0	1	1	0	0	54	43	2	38	32	0
40950	Connectionless_communication	201207	1	0	0	0	1	1	0	0	55	44	2	39	33	0
40950	Connectionless_communication	201301	1	0	0	0	1	1	0	0	56	45	2	40	34	0
40950	Connectionless_communication	201302	2	0	0	0	1	1	0	0	58	45	2	42	34	0
40950	Connectionless_communication	201303	4	0	0	0	3	2	0	0	62	47	2	45	35	0
40950	Connectionless_communication	201304	2	0	0	0	2	1	0	0	64	49	2	46	36	0
40950	Connectionless_communication	201306	2	1	0	0	2	1	1	0	66	51	3	47	37	0
40950	Connectionless_communication	201312	5	0	0	0	2	2	0	0	71	52	3	52	38	0
40950	Connectionless_communication	201401	1	0	0	0	1	0	0	0	72	53	3	52	38	0
40950	Connectionless_communication	201406	1	1	0	0	1	1	1	0	73	54	4	53	39	0
40950	Connectionless_communication	201506	1	0	0	0	1	1	0	0	74	55	4	54	40	0
40950	Connectionless_communication	201511	2	1	0	0	2	1	1	0	76	57	5	55	41	0
40950	Connectionless_communication	201512	1	0	0	0	1	1	0	0	77	58	5	56	42	0
40950	Connectionless_communication	201602	1	0	0	0	1	1	0	0	78	59	5	57	43	0
40950	Connectionless_communication	201605	1	0	0	0	1	1	0	0	79	60	5	58	44	0
40950	Connectionless_communication	201702	1	0	0	0	1	1	0	0	80	61	5	59	45	0
40950	Connectionless_communication	201703	1	0	0	0	1	0	0	0	81	62	5	59	45	0
40950	Connectionless_communication	201704	1	0	0	0	1	1	0	0	82	63	5	60	46	0
40950	Connectionless_communication	201707	2	0	0	0	1	0	0	0	84	64	5	60	46	0
40950	Connectionless_communication	201708	1	0	0	0	1	1	0	0	85	65	5	61	47	0
40950	Connectionless_communication	201801	1	0	0	0	1	0	0	0	86	66	5	61	47	0
40950	Connectionless_communication	201802	2	0	0	0	2	2	0	0	88	68	5	63	49	0
40950	Connectionless_communication	201804	1	0	0	0	1	1	0	0	89	69	5	64	50	0
40950	Connectionless_communication	201805	6	1	0	0	5	3	1	0	95	72	6	68	51	1
32830538	Constrained_Application_Protocol	201109	7	0	0	0	4	4	0	0	7	4	0	7	4	0
32830538	Constrained_Application_Protocol	201112	5	0	0	0	4	3	0	0	12	8	0	11	7	0
32830538	Constrained_Application_Protocol	201201	3	0	0	0	3	2	0	0	15	11	0	13	9	0
32830538	Constrained_Application_Protocol	201202	1	0	0	0	1	0	0	0	16	12	0	13	9	0
32830538	Constrained_Application_Protocol	201203	1	0	0	0	1	1	0	0	17	13	0	14	10	0
32830538	Constrained_Application_Protocol	201205	1	0	0	0	1	0	0	0	18	14	0	14	10	0
32830538	Constrained_Application_Protocol	201207	5	0	0	0	3	3	0	0	23	17	0	19	13	0
32830538	Constrained_Application_Protocol	201208	3	0	0	0	3	2	0	0	26	20	0	21	15	0
32830538	Constrained_Application_Protocol	201209	1	0	0	0	1	1	0	0	27	21	0	22	16	0
32830538	Constrained_Application_Protocol	201211	2	0	0	0	2	1	0	0	29	23	0	23	17	0
32830538	Constrained_Application_Protocol	201302	1	0	0	0	1	1	0	0	30	24	0	24	18	0
32830538	Constrained_Application_Protocol	201303	1	0	0	0	1	1	0	0	31	25	0	25	19	0
32830538	Constrained_Application_Protocol	201304	3	0	0	0	2	1	0	0	34	27	0	26	19	0
32830538	Constrained_Application_Protocol	201305	1	0	0	0	1	0	0	0	35	28	0	26	19	0
32830538	Constrained_Application_Protocol	201306	4	0	0	0	2	0	0	0	39	30	0	26	19	0
32830538	Constrained_Application_Protocol	201307	2	1	0	0	2	1	1	0	41	32	1	27	20	0
32830538	Constrained_Application_Protocol	201308	5	0	0	0	4	1	0	0	46	36	1	28	20	0
32830538	Constrained_Application_Protocol	201309	1	0	0	0	1	1	0	0	47	37	1	29	21	0
32830538	Constrained_Application_Protocol	201310	5	0	0	0	3	1	0	0	52	40	1	32	22	0
32830538	Constrained_Application_Protocol	201311	2	0	0	0	2	1	0	0	54	42	1	33	23	0
32830538	Constrained_Application_Protocol	201402	1	0	0	0	1	0	0	0	55	43	1	33	23	0
32830538	Constrained_Application_Protocol	201403	3	0	0	0	2	0	0	0	58	45	1	33	23	0
32830538	Constrained_Application_Protocol	201404	2	0	0	0	2	1	0	0	60	47	1	34	24	0
32830538	Constrained_Application_Protocol	201406	1	0	0	0	1	1	0	0	61	48	1	35	25	0
32830538	Constrained_Application_Protocol	201407	10	0	0	0	6	4	0	0	71	52	1	39	27	0
32830538	Constrained_Application_Protocol	201408	4	0	0	0	3	1	0	0	75	55	1	40	27	0
32830538	Constrained_Application_Protocol	201409	5	1	0	0	4	3	1	0	80	59	2	43	28	1
32830538	Constrained_Application_Protocol	201410	2	0	0	0	1	1	0	0	82	60	2	45	29	1
32830538	Constrained_Application_Protocol	201411	1	0	0	0	1	1	0	0	83	61	2	46	29	1
32830538	Constrained_Application_Protocol	201412	1	0	0	0	1	0	0	0	84	62	2	46	29	1
32830538	Constrained_Application_Protocol	201501	1	0	0	0	1	1	0	0	85	63	2	47	30	1
32830538	Constrained_Application_Protocol	201502	5	1	0	0	3	1	1	0	90	65	3	49	30	1
32830538	Constrained_Application_Protocol	201503	1	1	0	0	1	1	1	0	91	66	4	50	31	2
32830538	Constrained_Application_Protocol	201504	1	0	0	0	1	1	0	0	92	67	4	51	32	2
32830538	Constrained_Application_Protocol	201505	3	0	0	0	3	1	0	0	95	70	4	52	33	2
32830538	Constrained_Application_Protocol	201506	8	0	0	0	5	4	0	0	103	75	4	59	37	2
32830538	Constrained_Application_Protocol	201507	1	0	0	0	1	0	0	0	104	76	4	59	37	2
32830538	Constrained_Application_Protocol	201508	2	0	0	0	2	1	0	0	106	78	4	60	38	2
32830538	Constrained_Application_Protocol	201509	3	0	0	0	2	2	0	0	109	79	4	63	39	2
32830538	Constrained_Application_Protocol	201511	1	0	0	0	1	0	0	0	110	80	4	63	39	2
32830538	Constrained_Application_Protocol	201601	4	0	0	0	3	2	0	0	114	83	4	66	40	2
32830538	Constrained_Application_Protocol	201603	1	0	0	0	1	0	0	0	115	84	4	66	40	2
32830538	Constrained_Application_Protocol	201604	3	0	0	0	3	3	0	0	118	86	4	69	42	2
32830538	Constrained_Application_Protocol	201605	2	0	0	0	2	0	0	0	120	88	4	69	42	2
32830538	Constrained_Application_Protocol	201606	3	0	0	0	2	1	0	0	123	90	4	71	43	2
32830538	Constrained_Application_Protocol	201608	1	0	0	0	1	1	0	0	124	91	4	72	44	2
32830538	Constrained_Application_Protocol	201609	1	0	0	0	1	1	0	0	125	91	4	73	44	2
32830538	Constrained_Application_Protocol	201611	1	0	0	0	1	0	0	0	126	92	4	73	44	2
32830538	Constrained_Application_Protocol	201612	2	0	0	0	1	0	0	0	128	93	4	73	44	2
32830538	Constrained_Application_Protocol	201704	2	0	0	0	2	2	0	0	130	95	4	75	46	2
32830538	Constrained_Application_Protocol	201705	5	0	0	0	4	3	0	0	135	97	4	79	47	2
32830538	Constrained_Application_Protocol	201706	2	0	0	0	2	1	0	0	137	98	4	80	47	2
32830538	Constrained_Application_Protocol	201707	3	0	0	0	3	2	0	0	140	101	4	82	49	2
32830538	Constrained_Application_Protocol	201708	1	0	0	0	1	1	0	0	141	102	4	83	50	2
32830538	Constrained_Application_Protocol	201709	2	0	0	0	2	1	0	0	143	104	4	84	51	2
32830538	Constrained_Application_Protocol	201710	4	0	0	0	2	0	0	0	147	106	4	84	51	2
32830538	Constrained_Application_Protocol	201802	6	0	0	0	3	2	0	0	153	109	4	88	53	2
32830538	Constrained_Application_Protocol	201805	1	0	0	0	1	0	0	0	154	110	4	88	53	2
32830538	Constrained_Application_Protocol	201806	6	0	0	0	4	1	0	0	160	114	4	89	54	2
32830538	Constrained_Application_Protocol	201807	4	0	0	0	4	3	0	0	164	118	4	92	57	2
880860	Content_delivery_network	200409	2	0	0	0	2	1	0	0	2	2	0	1	1	0
880860	Content_delivery_network	200503	3	0	0	0	1	0	0	0	5	2	0	1	1	0
880860	Content_delivery_network	200505	1	0	0	0	1	1	0	0	6	3	0	2	2	0
880860	Content_delivery_network	200506	4	0	0	0	1	1	0	0	10	4	0	6	3	0
880860	Content_delivery_network	200507	2	1	0	0	2	1	1	0	12	6	1	7	4	0
880860	Content_delivery_network	200509	1	0	0	0	1	0	0	0	13	7	1	7	4	0
880860	Content_delivery_network	200601	2	0	0	0	2	0	0	0	15	9	1	7	4	0
880860	Content_delivery_network	200602	3	0	0	0	1	0	0	0	18	10	1	7	4	0
880860	Content_delivery_network	200603	14	1	0	0	6	4	1	0	32	16	2	17	8	1
880860	Content_delivery_network	200604	17	1	0	0	9	4	1	0	49	23	3	23	11	1
880860	Content_delivery_network	200605	6	0	0	0	4	2	0	0	55	27	3	25	13	1
880860	Content_delivery_network	200606	14	1	0	0	7	4	1	0	69	33	4	34	16	1
880860	Content_delivery_network	200607	15	4	0	0	8	4	1	0	84	39	8	42	19	2
880860	Content_delivery_network	200608	9	1	0	0	7	4	1	0	93	44	9	47	21	2
880860	Content_delivery_network	200609	11	1	0	0	6	5	1	0	104	48	10	55	24	3
880860	Content_delivery_network	200610	8	2	0	0	4	2	1	0	112	51	12	61	25	4
880860	Content_delivery_network	200611	12	1	0	0	11	5	1	0	124	61	13	66	29	4
880860	Content_delivery_network	200612	16	0	0	0	8	4	0	0	140	68	13	78	32	4
880860	Content_delivery_network	200701	5	0	0	0	5	3	0	0	145	72	13	81	34	4
880860	Content_delivery_network	200702	9	2	0	0	7	3	2	0	154	77	15	85	36	5
880860	Content_delivery_network	200703	3	0	0	0	3	1	0	0	157	80	15	86	37	5
880860	Content_delivery_network	200704	9	0	0	0	7	2	0	0	166	87	15	88	39	5
880860	Content_delivery_network	200705	9	0	0	0	8	3	0	0	175	94	15	91	41	5
880860	Content_delivery_network	200706	7	0	0	0	6	3	0	0	182	99	15	95	44	5
880860	Content_delivery_network	200707	5	0	0	0	5	1	0	0	187	104	15	96	45	5
880860	Content_delivery_network	200708	13	0	0	0	12	5	0	0	200	116	15	101	50	5
880860	Content_delivery_network	200709	14	1	0	0	13	6	1	0	214	127	16	108	55	6
880860	Content_delivery_network	200710	9	1	0	0	6	4	1	0	223	133	17	114	59	7
880860	Content_delivery_network	200711	12	0	0	0	8	2	0	0	235	140	17	118	61	7
880860	Content_delivery_network	200712	13	0	0	0	10	1	0	0	248	149	17	119	62	7
880860	Content_delivery_network	200801	17	0	0	0	10	1	0	0	265	159	17	120	63	7
880860	Content_delivery_network	200802	19	1	0	0	14	3	1	0	284	172	18	126	66	7
880860	Content_delivery_network	200803	26	0	0	0	17	7	0	0	310	188	18	134	73	7
880860	Content_delivery_network	200804	44	8	1	0	16	6	4	1	354	201	26	155	77	12
880860	Content_delivery_network	200805	30	7	0	0	13	6	2	0	384	209	33	169	80	14
880860	Content_delivery_network	200806	29	1	0	0	17	6	1	0	413	222	34	176	84	14
880860	Content_delivery_network	200807	29	4	0	0	18	11	3	0	442	238	38	193	94	16
880860	Content_delivery_network	200808	24	4	0	0	16	6	2	0	466	249	42	199	97	17
880860	Content_delivery_network	200809	28	3	0	0	15	6	2	0	494	261	45	212	101	17
880860	Content_delivery_network	200810	31	0	0	0	25	8	0	0	525	280	45	224	106	17
880860	Content_delivery_network	200811	23	2	0	0	14	7	2	0	548	292	47	237	111	18
880860	Content_delivery_network	200812	28	1	0	0	19	6	1	0	576	307	48	246	116	18
880860	Content_delivery_network	200901	10	0	0	0	7	4	0	0	586	313	48	253	119	18
880860	Content_delivery_network	200902	14	0	0	0	9	4	0	0	600	321	48	261	122	18
880860	Content_delivery_network	200903	38	2	0	0	20	9	2	0	638	341	50	282	131	19
880860	Content_delivery_network	200904	37	2	0	0	24	9	2	0	675	360	52	295	137	19
880860	Content_delivery_network	200905	28	0	0	0	21	6	0	0	703	376	52	302	140	19
880860	Content_delivery_network	200906	22	1	0	0	18	6	1	0	725	392	53	308	145	19
880860	Content_delivery_network	200907	21	1	0	0	13	6	1	0	746	401	54	319	150	19
880860	Content_delivery_network	200908	16	1	0	0	10	5	1	0	762	410	55	328	154	19
880860	Content_delivery_network	200909	18	1	0	0	11	7	1	0	780	418	56	337	158	19
880860	Content_delivery_network	200910	68	32	19	13	17	10	6	5	848	431	88	380	165	37
880860	Content_delivery_network	200911	10	1	0	0	9	4	1	0	858	437	89	384	168	37
880860	Content_delivery_network	200912	2	0	0	0	2	1	0	0	860	439	89	385	169	37
880860	Content_delivery_network	201001	28	10	2	1	14	11	4	2	888	448	99	405	175	41
880860	Content_delivery_network	201002	37	12	8	6	12	9	3	3	925	457	111	437	181	52
880860	Content_delivery_network	201003	59	35	30	27	11	9	5	3	984	464	146	474	186	69
880860	Content_delivery_network	201004	10	1	0	0	6	4	1	0	994	469	147	481	189	69
880860	Content_delivery_network	201005	9	1	0	0	5	2	1	0	1003	473	148	483	190	70
880860	Content_delivery_network	201006	4	1	0	0	4	1	1	0	1007	476	149	484	190	70
880860	Content_delivery_network	201007	7	2	0	0	6	4	2	0	1014	480	151	489	192	71
880860	Content_delivery_network	201008	13	2	0	0	8	4	2	0	1027	486	153	496	194	72
880860	Content_delivery_network	201009	15	2	0	0	10	5	2	0	1042	490	155	503	196	72
880860	Content_delivery_network	201010	12	1	0	0	11	4	1	0	1054	499	156	507	198	72
880860	Content_delivery_network	201011	14	0	0	0	10	4	0	0	1068	507	156	511	202	72
880860	Content_delivery_network	201012	17	2	0	0	11	5	2	0	1085	516	158	519	205	72
880860	Content_delivery_network	201101	12	1	0	0	8	4	1	0	1097	523	159	524	208	72
880860	Content_delivery_network	201102	9	1	0	0	9	4	1	0	1106	529	160	528	210	72
880860	Content_delivery_network	201103	8	0	0	0	7	2	0	0	1114	536	160	531	212	72
880860	Content_delivery_network	201104	11	0	0	0	6	2	0	0	1125	542	160	537	214	72
880860	Content_delivery_network	201105	18	1	0	0	12	4	1	0	1143	552	161	542	216	73
880860	Content_delivery_network	201106	12	1	0	0	8	3	1	0	1155	558	162	545	217	74
880860	Content_delivery_network	201107	12	0	0	0	9	5	0	0	1167	566	162	551	221	74
880860	Content_delivery_network	201108	15	1	0	0	6	3	1	0	1182	571	163	557	223	74
880860	Content_delivery_network	201109	21	3	0	0	14	8	2	0	1203	583	166	569	229	76
880860	Content_delivery_network	201110	12	2	0	0	10	5	2	0	1215	589	168	574	232	76
880860	Content_delivery_network	201111	11	1	0	0	9	3	1	0	1226	595	169	578	233	76
880860	Content_delivery_network	201112	8	0	0	0	6	3	0	0	1234	601	169	581	236	76
880860	Content_delivery_network	201201	7	0	0	0	5	1	0	0	1241	606	169	582	237	76
880860	Content_delivery_network	201202	9	0	0	0	8	5	0	0	1250	613	169	588	241	76
880860	Content_delivery_network	201203	16	4	2	1	12	8	3	2	1266	621	173	599	246	78
880860	Content_delivery_network	201204	14	0	0	0	12	8	0	0	1280	631	173	609	252	78
880860	Content_delivery_network	201205	32	2	0	0	20	9	1	0	1312	648	175	625	258	78
880860	Content_delivery_network	201206	13	0	0	0	11	5	0	0	1325	654	175	631	259	78
880860	Content_delivery_network	201207	9	1	0	0	8	4	1	0	1334	661	176	636	262	78
880860	Content_delivery_network	201208	15	1	0	0	10	6	1	0	1349	669	177	647	266	79
880860	Content_delivery_network	201209	3	0	0	0	3	2	0	0	1352	672	177	649	268	79
880860	Content_delivery_network	201210	14	4	0	0	9	5	2	0	1366	680	181	657	272	80
880860	Content_delivery_network	201211	4	0	0	0	3	1	0	0	1370	683	181	658	273	80
880860	Content_delivery_network	201212	20	1	0	0	14	7	1	0	1390	693	182	668	276	80
880860	Content_delivery_network	201301	16	3	0	0	10	6	2	0	1406	700	185	676	279	81
880860	Content_delivery_network	201302	15	0	0	0	12	8	0	0	1421	706	185	686	282	81
880860	Content_delivery_network	201303	25	3	0	0	13	7	3	0	1446	716	188	696	287	83
880860	Content_delivery_network	201304	11	1	0	0	11	4	1	0	1457	723	189	700	288	83
880860	Content_delivery_network	201305	12	2	0	0	11	7	2	0	1469	733	191	708	294	84
880860	Content_delivery_network	201306	11	1	0	0	11	4	1	0	1480	740	192	712	296	85
880860	Content_delivery_network	201307	2	0	0	0	2	1	0	0	1482	742	192	713	296	85
880860	Content_delivery_network	201308	3	1	0	0	3	1	1	0	1485	745	193	714	297	85
880860	Content_delivery_network	201309	17	1	0	0	9	6	1	0	1502	754	194	727	303	86
880860	Content_delivery_network	201310	4	1	0	0	3	2	1	0	1506	757	195	729	305	87
880860	Content_delivery_network	201311	28	3	0	0	14	6	3	0	1534	768	198	747	308	87
880860	Content_delivery_network	201312	12	4	0	0	12	6	4	0	1546	776	202	753	311	88
880860	Content_delivery_network	201401	8	1	0	0	6	3	1	0	1554	780	203	757	312	88
880860	Content_delivery_network	201402	12	1	0	0	10	5	1	0	1566	789	204	764	316	88
880860	Content_delivery_network	201403	12	6	1	0	7	4	3	1	1578	794	210	772	319	90
880860	Content_delivery_network	201404	9	4	1	0	6	3	2	1	1587	797	214	778	320	92
880860	Content_delivery_network	201405	8	1	0	0	5	4	1	0	1595	801	215	785	323	92
880860	Content_delivery_network	201406	9	1	0	0	8	4	1	0	1604	809	216	790	327	92
880860	Content_delivery_network	201407	21	3	0	0	13	4	3	0	1625	819	219	796	329	92
880860	Content_delivery_network	201408	8	3	0	0	8	5	3	0	1633	825	222	801	332	93
880860	Content_delivery_network	201409	15	2	0	0	12	7	2	0	1648	834	224	810	336	94
880860	Content_delivery_network	201410	3	0	0	0	2	1	0	0	1651	835	224	812	337	94
880860	Content_delivery_network	201411	16	2	0	0	11	5	2	0	1667	846	226	820	341	94
880860	Content_delivery_network	201412	5	0	0	0	4	1	0	0	1672	849	226	821	341	94
880860	Content_delivery_network	201501	11	4	0	0	7	5	3	0	1683	854	230	830	345	96
880860	Content_delivery_network	201502	13	1	0	0	6	3	1	0	1696	860	231	839	348	96
880860	Content_delivery_network	201503	7	2	0	0	6	4	1	0	1703	864	233	844	350	96
880860	Content_delivery_network	201504	2	1	0	0	2	2	1	0	1705	866	234	846	352	97
880860	Content_delivery_network	201505	17	2	0	0	8	5	2	0	1722	872	236	858	355	98
880860	Content_delivery_network	201506	6	2	0	0	4	1	1	0	1728	875	238	860	355	98
880860	Content_delivery_network	201507	11	4	0	0	8	5	3	0	1739	881	242	866	358	99
880860	Content_delivery_network	201508	13	4	0	0	10	8	3	0	1752	889	246	876	364	101
880860	Content_delivery_network	201509	12	2	0	0	9	3	1	0	1764	897	248	881	366	101
880860	Content_delivery_network	201510	8	0	0	0	5	3	0	0	1772	900	248	885	368	101
880860	Content_delivery_network	201511	6	2	0	0	5	2	1	0	1778	901	250	888	368	101
880860	Content_delivery_network	201512	6	1	0	0	6	5	1	0	1784	907	251	893	373	102
880860	Content_delivery_network	201601	8	2	0	0	8	6	2	0	1792	914	253	899	378	102
880860	Content_delivery_network	201602	24	9	4	1	12	10	5	2	1816	921	262	921	383	110
880860	Content_delivery_network	201603	21	5	1	1	12	7	3	1	1837	927	267	932	384	112
880860	Content_delivery_network	201604	9	2	0	0	6	4	2	0	1846	931	269	938	387	113
880860	Content_delivery_network	201605	6	3	1	0	4	3	3	1	1852	933	272	943	388	115
880860	Content_delivery_network	201606	8	1	0	0	7	3	1	0	1860	939	273	946	390	115
880860	Content_delivery_network	201607	13	0	0	0	4	4	0	0	1873	941	273	959	391	115
880860	Content_delivery_network	201608	5	0	0	0	3	3	0	0	1878	944	273	964	394	115
880860	Content_delivery_network	201609	4	1	0	0	4	1	1	0	1882	947	274	965	394	115
880860	Content_delivery_network	201610	5	0	0	0	3	2	0	0	1887	950	274	969	396	115
880860	Content_delivery_network	201611	4	1	0	0	4	2	1	0	1891	954	275	971	398	116
880860	Content_delivery_network	201612	5	0	0	0	5	2	0	0	1896	958	275	973	399	116
880860	Content_delivery_network	201701	1	0	0	0	1	1	0	0	1897	959	275	974	400	116
880860	Content_delivery_network	201702	7	2	0	0	6	6	2	0	1904	964	277	981	405	118
880860	Content_delivery_network	201703	18	3	0	0	13	9	3	0	1922	975	280	995	411	120
880860	Content_delivery_network	201704	6	0	0	0	3	2	0	0	1928	978	280	997	412	120
880860	Content_delivery_network	201705	4	1	0	0	4	3	1	0	1932	981	281	1000	413	120
880860	Content_delivery_network	201706	8	1	0	0	5	3	1	0	1940	984	282	1006	414	121
880860	Content_delivery_network	201707	7	0	0	0	4	4	0	0	1947	988	282	1013	418	121
880860	Content_delivery_network	201708	3	0	0	0	3	3	0	0	1950	990	282	1016	420	121
880860	Content_delivery_network	201709	12	2	0	0	10	8	2	0	1962	999	284	1026	427	122
880860	Content_delivery_network	201710	6	1	0	0	4	3	1	0	1968	1003	285	1031	430	122
880860	Content_delivery_network	201711	8	1	0	0	6	2	1	0	1976	1007	286	1033	430	122
880860	Content_delivery_network	201712	8	2	0	0	6	4	2	0	1984	1011	288	1039	431	124
880860	Content_delivery_network	201801	8	0	0	0	7	4	0	0	1992	1015	288	1044	433	124
880860	Content_delivery_network	201802	12	3	0	0	12	8	3	0	2004	1026	291	1052	438	126
880860	Content_delivery_network	201803	2	0	0	0	2	2	0	0	2006	1028	291	1054	440	126
880860	Content_delivery_network	201804	4	1	0	0	4	3	1	0	2010	1031	292	1057	441	126
880860	Content_delivery_network	201805	9	1	0	0	6	5	1	0	2019	1035	293	1065	444	126
880860	Content_delivery_network	201806	14	2	0	0	8	7	2	0	2033	1041	295	1077	448	127
880860	Content_delivery_network	201807	3	1	0	0	3	2	1	0	2036	1043	296	1079	448	128
338689	Context_awareness	200411	1	0	0	0	1	1	0	0	1	1	0	1	1	0
338689	Context_awareness	200507	1	0	0	0	1	0	0	0	2	2	0	1	1	0
338689	Context_awareness	200510	1	0	0	0	1	0	0	0	3	3	0	1	1	0
338689	Context_awareness	200511	1	0	0	0	1	0	0	0	4	4	0	1	1	0
338689	Context_awareness	200602	1	0	0	0	1	0	0	0	5	5	0	1	1	0
338689	Context_awareness	200606	2	0	0	0	1	1	0	0	7	6	0	3	2	0
338689	Context_awareness	200608	1	0	0	0	1	1	0	0	8	7	0	4	3	0
338689	Context_awareness	200609	1	0	0	0	1	0	0	0	9	8	0	4	3	0
338689	Context_awareness	200610	2	0	0	0	2	0	0	0	11	10	0	4	3	0
338689	Context_awareness	200611	1	0	0	0	1	1	0	0	12	11	0	5	4	0
338689	Context_awareness	200703	13	0	0	0	4	2	0	0	25	15	0	11	6	0
338689	Context_awareness	200704	7	0	0	0	4	3	0	0	32	18	0	14	8	0
338689	Context_awareness	200708	1	0	0	0	1	1	0	0	33	19	0	15	9	0
338689	Context_awareness	200709	1	0	0	0	1	0	0	0	34	20	0	15	9	0
338689	Context_awareness	200710	2	0	0	0	2	2	0	0	36	22	0	17	11	0
338689	Context_awareness	200712	1	0	0	0	1	0	0	0	37	23	0	17	11	0
338689	Context_awareness	200802	1	0	0	0	1	1	0	0	38	24	0	18	12	0
338689	Context_awareness	200805	1	0	0	0	1	0	0	0	39	25	0	18	12	0
338689	Context_awareness	200806	6	1	0	0	3	3	1	0	45	28	1	24	15	1
338689	Context_awareness	200812	8	0	0	0	3	1	0	0	53	30	1	25	15	1
338689	Context_awareness	200903	1	0	0	0	1	1	0	0	54	31	1	26	16	1
338689	Context_awareness	200904	2	1	0	0	2	1	1	0	56	33	2	27	17	1
338689	Context_awareness	200905	2	0	0	0	2	1	0	0	58	35	2	28	18	1
338689	Context_awareness	200906	1	0	0	0	1	1	0	0	59	36	2	29	19	1
338689	Context_awareness	200907	2	0	0	0	2	1	0	0	61	38	2	30	20	1
338689	Context_awareness	200911	2	0	0	0	1	0	0	0	63	39	2	30	20	1
338689	Context_awareness	200912	1	0	0	0	1	0	0	0	64	40	2	30	20	1
338689	Context_awareness	201004	2	0	0	0	2	2	0	0	66	42	2	32	22	1
338689	Context_awareness	201005	2	0	0	0	2	0	0	0	68	44	2	32	22	1
338689	Context_awareness	201007	4	1	0	0	4	2	1	0	72	48	3	34	24	1
338689	Context_awareness	201008	1	0	0	0	1	1	0	0	73	49	3	35	25	1
338689	Context_awareness	201009	1	0	0	0	1	0	0	0	74	50	3	35	25	1
338689	Context_awareness	201010	1	0	0	0	1	1	0	0	75	50	3	36	25	1
338689	Context_awareness	201011	9	1	0	0	7	4	1	0	84	55	4	41	27	2
338689	Context_awareness	201101	2	0	0	0	2	1	0	0	86	56	4	42	27	2
338689	Context_awareness	201102	3	0	0	0	3	1	0	0	89	58	4	43	27	2
338689	Context_awareness	201103	1	0	0	0	1	0	0	0	90	59	4	43	27	2
338689	Context_awareness	201104	1	0	0	0	1	0	0	0	91	60	4	43	27	2
338689	Context_awareness	201105	12	0	0	0	4	4	0	0	103	64	4	55	31	2
338689	Context_awareness	201107	1	0	0	0	1	1	0	0	104	65	4	56	32	2
338689	Context_awareness	201109	5	0	0	0	2	1	0	0	109	67	4	57	33	2
338689	Context_awareness	201112	2	0	0	0	2	0	0	0	111	69	4	57	33	2
338689	Context_awareness	201202	4	0	0	0	1	0	0	0	115	70	4	57	33	2
338689	Context_awareness	201203	2	0	0	0	1	0	0	0	117	71	4	57	33	2
338689	Context_awareness	201204	4	0	0	0	4	3	0	0	121	75	4	60	36	2
338689	Context_awareness	201205	1	0	0	0	1	0	0	0	122	76	4	60	36	2
338689	Context_awareness	201206	3	0	0	0	2	1	0	0	125	78	4	62	37	2
338689	Context_awareness	201207	2	0	0	0	1	1	0	0	127	79	4	64	38	2
338689	Context_awareness	201209	3	1	0	0	3	3	1	0	130	81	5	67	40	3
338689	Context_awareness	201210	3	0	0	0	1	0	0	0	133	82	5	67	40	3
338689	Context_awareness	201211	2	0	0	0	2	0	0	0	135	84	5	67	40	3
338689	Context_awareness	201301	1	0	0	0	1	0	0	0	136	85	5	67	40	3
338689	Context_awareness	201302	3	1	0	0	2	0	1	0	139	87	6	67	40	3
338689	Context_awareness	201303	1	0	0	0	1	0	0	0	140	88	6	67	40	3
338689	Context_awareness	201305	3	0	0	0	2	2	0	0	143	90	6	70	42	3
338689	Context_awareness	201306	2	0	0	0	1	1	0	0	145	91	6	72	43	3
338689	Context_awareness	201312	1	0	0	0	1	0	0	0	146	92	6	72	43	3
338689	Context_awareness	201402	4	0	0	0	4	4	0	0	150	96	6	76	47	3
338689	Context_awareness	201403	1	0	0	0	1	1	0	0	151	97	6	77	48	3
338689	Context_awareness	201404	1	0	0	0	1	1	0	0	152	98	6	78	49	3
338689	Context_awareness	201405	1	0	0	0	1	1	0	0	153	98	6	79	49	3
338689	Context_awareness	201407	4	0	0	0	2	1	0	0	157	100	6	80	50	3
338689	Context_awareness	201412	1	0	0	0	1	0	0	0	158	101	6	80	50	3
338689	Context_awareness	201502	2	0	0	0	1	1	0	0	160	102	6	82	51	3
338689	Context_awareness	201504	3	0	0	0	2	2	0	0	163	102	6	85	51	3
338689	Context_awareness	201506	6	0	0	0	3	3	0	0	169	105	6	91	54	3
338689	Context_awareness	201508	3	0	0	0	3	2	0	0	172	108	6	93	56	3
338689	Context_awareness	201512	1	0	0	0	1	1	0	0	173	109	6	94	57	3
338689	Context_awareness	201601	1	0	0	0	1	1	0	0	174	110	6	95	58	3
338689	Context_awareness	201602	4	0	0	0	2	2	0	0	178	111	6	99	59	3
338689	Context_awareness	201603	8	0	0	0	4	4	0	0	186	113	6	107	61	3
338689	Context_awareness	201605	2	0	0	0	2	2	0	0	188	115	6	109	63	3
338689	Context_awareness	201607	1	0	0	0	1	1	0	0	189	116	6	110	64	3
338689	Context_awareness	201611	1	0	0	0	1	1	0	0	190	116	6	111	64	3
338689	Context_awareness	201702	2	0	0	0	2	2	0	0	192	118	6	113	66	3
338689	Context_awareness	201704	2	0	0	0	1	1	0	0	194	119	6	115	67	3
338689	Context_awareness	201706	4	2	0	0	3	3	2	0	198	121	8	119	69	5
338689	Context_awareness	201708	1	0	0	0	1	0	0	0	199	122	8	119	69	5
338689	Context_awareness	201710	4	0	0	0	4	4	0	0	203	124	8	123	71	5
338689	Context_awareness	201711	2	0	0	0	2	1	0	0	205	125	8	124	71	5
338689	Context_awareness	201712	1	0	0	0	1	1	0	0	206	126	8	125	72	5
338689	Context_awareness	201805	1	0	0	0	1	0	0	0	207	127	8	125	72	5
44571310	Contextual_searching	201501	6	0	0	0	4	4	0	0	6	4	0	6	4	0
44571310	Contextual_searching	201505	1	0	0	0	1	1	0	0	7	5	0	7	5	0
44571310	Contextual_searching	201506	2	0	0	0	2	2	0	0	9	7	0	9	7	0
44571310	Contextual_searching	201606	1	0	0	0	1	1	0	0	10	8	0	10	8	0
44571310	Contextual_searching	201611	1	0	0	0	1	1	0	0	11	9	0	11	9	0
44571310	Contextual_searching	201701	1	0	0	0	1	1	0	0	12	10	0	12	10	0
44571310	Contextual_searching	201705	1	0	0	0	1	0	0	0	13	11	0	12	10	0
44571310	Contextual_searching	201708	6	1	0	0	2	0	1	0	19	13	1	12	10	0
11981336	Control_plane	200707	3	0	0	0	2	2	0	0	3	2	0	3	2	0
11981336	Control_plane	200708	6	0	0	0	3	3	0	0	9	3	0	9	3	0
11981336	Control_plane	200709	3	1	0	0	3	2	1	0	12	5	1	11	4	0
11981336	Control_plane	200802	2	0	0	0	1	1	0	0	14	6	1	13	5	0
11981336	Control_plane	200803	1	0	0	0	1	1	0	0	15	7	1	14	6	0
11981336	Control_plane	200812	1	0	0	0	1	0	0	0	16	8	1	14	6	0
11981336	Control_plane	200901	3	0	0	0	1	1	0	0	19	9	1	17	7	0
11981336	Control_plane	200903	2	0	0	0	1	0	0	0	21	10	1	17	7	0
11981336	Control_plane	200908	1	0	0	0	1	1	0	0	22	11	1	18	8	0
11981336	Control_plane	200910	2	0	0	0	1	1	0	0	24	12	1	20	9	0
11981336	Control_plane	200911	3	0	0	0	2	1	0	0	27	14	1	22	10	0
11981336	Control_plane	201004	1	0	0	0	1	0	0	0	28	15	1	22	10	0
11981336	Control_plane	201102	1	0	0	0	1	1	0	0	29	16	1	23	11	0
11981336	Control_plane	201107	1	0	0	0	1	1	0	0	30	17	1	24	12	0
11981336	Control_plane	201203	1	0	0	0	1	1	0	0	31	18	1	25	13	0
11981336	Control_plane	201206	1	0	0	0	1	1	0	0	32	19	1	26	14	0
11981336	Control_plane	201208	3	1	0	0	3	2	1	0	35	22	2	28	16	0
11981336	Control_plane	201210	1	0	0	0	1	1	0	0	36	23	2	29	17	0
11981336	Control_plane	201503	2	1	0	0	2	0	1	0	38	25	3	29	17	0
11981336	Control_plane	201507	1	0	0	0	1	0	0	0	39	26	3	29	17	0
11981336	Control_plane	201511	1	0	0	0	1	0	0	0	40	27	3	29	17	0
11981336	Control_plane	201607	3	0	0	0	1	1	0	0	43	27	3	32	17	0
11981336	Control_plane	201703	1	0	0	0	1	1	0	0	44	28	3	33	18	0
11981336	Control_plane	201704	4	2	0	0	4	2	2	0	48	31	5	35	19	0
11981336	Control_plane	201705	1	0	0	0	1	1	0	0	49	32	5	36	20	0
11981336	Control_plane	201708	1	0	0	0	1	1	0	0	50	32	5	37	20	0
154805	Conversational_Monitor_System	200309	2	0	0	0	1	0	0	0	2	1	0	0	0	0
154805	Conversational_Monitor_System	200401	2	0	0	0	1	1	0	0	4	2	0	2	1	0
154805	Conversational_Monitor_System	200407	1	0	0	0	1	1	0	0	5	3	0	3	2	0
154805	Conversational_Monitor_System	200411	1	0	0	0	1	1	0	0	6	4	0	4	3	0
154805	Conversational_Monitor_System	200503	1	0	0	0	1	1	0	0	7	4	0	5	3	0
154805	Conversational_Monitor_System	200504	2	0	0	0	2	2	0	0	9	6	0	7	5	0
154805	Conversational_Monitor_System	200511	2	0	0	0	2	1	0	0	11	7	0	8	5	0
154805	Conversational_Monitor_System	200512	1	0	0	0	1	1	0	0	12	8	0	9	6	0
154805	Conversational_Monitor_System	200601	3	0	0	0	3	3	0	0	15	11	0	12	9	0
154805	Conversational_Monitor_System	200605	1	0	0	0	1	1	0	0	16	12	0	13	10	0
154805	Conversational_Monitor_System	200606	1	0	0	0	1	0	0	0	17	13	0	13	10	0
154805	Conversational_Monitor_System	200608	2	0	0	0	2	2	0	0	19	15	0	15	12	0
154805	Conversational_Monitor_System	200609	2	0	0	0	2	2	0	0	21	17	0	17	14	0
154805	Conversational_Monitor_System	200610	1	0	0	0	1	1	0	0	22	18	0	18	15	0
154805	Conversational_Monitor_System	200612	1	0	0	0	1	1	0	0	23	19	0	19	16	0
154805	Conversational_Monitor_System	200706	4	0	0	0	1	1	0	0	27	20	0	23	17	0
154805	Conversational_Monitor_System	200712	5	0	0	0	3	2	0	0	32	22	0	27	18	0
154805	Conversational_Monitor_System	200801	1	0	0	0	1	1	0	0	33	23	0	28	19	0
154805	Conversational_Monitor_System	200805	1	0	0	0	1	1	0	0	34	24	0	29	20	0
154805	Conversational_Monitor_System	200807	1	0	0	0	1	1	0	0	35	25	0	30	21	0
154805	Conversational_Monitor_System	200811	1	0	0	0	1	1	0	0	36	26	0	31	22	0
154805	Conversational_Monitor_System	200905	4	1	0	0	3	3	1	0	40	29	1	35	25	1
154805	Conversational_Monitor_System	201004	1	0	0	0	1	1	0	0	41	30	1	36	26	1
154805	Conversational_Monitor_System	201111	1	0	0	0	1	0	0	0	42	31	1	36	26	1
154805	Conversational_Monitor_System	201202	1	0	0	0	1	1	0	0	43	32	1	37	27	1
154805	Conversational_Monitor_System	201208	1	0	0	0	1	1	0	0	44	33	1	38	28	1
154805	Conversational_Monitor_System	201211	1	0	0	0	1	1	0	0	45	34	1	39	29	1
154805	Conversational_Monitor_System	201303	2	0	0	0	1	1	0	0	47	34	1	41	29	1
154805	Conversational_Monitor_System	201308	1	0	0	0	1	1	0	0	48	35	1	42	30	1
154805	Conversational_Monitor_System	201503	1	0	0	0	1	1	0	0	49	36	1	43	31	1
154805	Conversational_Monitor_System	201603	1	0	0	0	1	1	0	0	50	37	1	44	32	1
154805	Conversational_Monitor_System	201608	1	0	0	0	1	1	0	0	51	38	1	45	33	1
154805	Conversational_Monitor_System	201704	1	0	0	0	1	1	0	0	52	38	1	46	33	1
154805	Conversational_Monitor_System	201712	1	0	0	0	1	1	0	0	53	39	1	47	34	1
9358077	Core_router	200704	14	0	0	0	6	3	0	0	14	6	0	10	3	0
9358077	Core_router	200705	2	0	0	0	1	1	0	0	16	7	0	12	4	0
9358077	Core_router	200706	5	0	0	0	2	2	0	0	21	7	0	17	4	0
9358077	Core_router	200710	10	0	0	0	4	4	0	0	31	9	0	27	6	0
9358077	Core_router	200712	1	0	0	0	1	1	0	0	32	10	0	28	7	0
9358077	Core_router	200802	1	0	0	0	1	0	0	0	33	11	0	28	7	0
9358077	Core_router	200804	3	0	0	0	1	1	0	0	36	12	0	31	8	0
9358077	Core_router	200805	4	0	0	0	2	2	0	0	40	13	0	35	9	0
9358077	Core_router	200806	2	1	0	0	2	1	1	0	42	15	1	36	10	0
9358077	Core_router	200809	1	0	0	0	1	1	0	0	43	16	1	37	11	0
9358077	Core_router	200810	1	0	0	0	1	0	0	0	44	17	1	37	11	0
9358077	Core_router	200812	2	0	0	0	1	0	0	0	46	18	1	37	11	0
9358077	Core_router	200902	1	0	0	0	1	1	0	0	47	19	1	38	12	0
9358077	Core_router	200903	4	1	0	0	3	2	1	0	51	22	2	40	14	1
9358077	Core_router	200905	6	1	0	0	4	3	1	0	57	25	3	43	16	1
9358077	Core_router	200910	1	0	0	0	1	0	0	0	58	26	3	43	16	1
9358077	Core_router	200911	4	0	0	0	2	1	0	0	62	28	3	44	17	1
9358077	Core_router	200912	1	0	0	0	1	1	0	0	63	29	3	45	18	1
9358077	Core_router	201002	12	0	0	0	3	3	0	0	75	31	3	57	20	1
9358077	Core_router	201003	1	0	0	0	1	1	0	0	76	32	3	58	21	1
9358077	Core_router	201006	7	0	0	0	4	3	0	0	83	34	3	64	22	1
9358077	Core_router	201101	1	0	0	0	1	0	0	0	84	35	3	64	22	1
9358077	Core_router	201105	1	0	0	0	1	1	0	0	85	35	3	65	22	1
9358077	Core_router	201107	1	0	0	0	1	1	0	0	86	36	3	66	23	1
9358077	Core_router	201110	1	0	0	0	1	1	0	0	87	37	3	67	24	1
9358077	Core_router	201202	1	0	0	0	1	1	0	0	88	38	3	68	25	1
9358077	Core_router	201203	1	0	0	0	1	0	0	0	89	39	3	68	25	1
9358077	Core_router	201205	2	0	0	0	2	2	0	0	91	41	3	70	27	1
9358077	Core_router	201206	1	0	0	0	1	1	0	0	92	42	3	71	28	1
9358077	Core_router	201207	9	0	0	0	1	1	0	0	101	43	3	80	29	1
9358077	Core_router	201208	3	0	0	0	3	3	0	0	104	45	3	83	31	1
9358077	Core_router	201209	1	0	0	0	1	1	0	0	105	45	3	84	31	1
9358077	Core_router	201302	1	0	0	0	1	1	0	0	106	46	3	85	32	1
9358077	Core_router	201304	1	0	0	0	1	0	0	0	107	47	3	85	32	1
9358077	Core_router	201305	1	0	0	0	1	1	0	0	108	48	3	86	33	1
9358077	Core_router	201308	2	0	0	0	2	1	0	0	110	50	3	87	34	1
9358077	Core_router	201310	2	0	0	0	2	1	0	0	112	51	3	88	34	1
9358077	Core_router	201311	7	0	0	0	4	3	0	0	119	54	3	93	36	1
9358077	Core_router	201411	1	0	0	0	1	0	0	0	120	55	3	93	36	1
9358077	Core_router	201412	2	0	0	0	2	1	0	0	122	57	3	94	37	1
9358077	Core_router	201507	2	0	0	0	2	0	0	0	124	59	3	94	37	1
9358077	Core_router	201601	2	0	0	0	2	1	0	0	126	61	3	95	38	1
9358077	Core_router	201610	1	0	0	0	1	1	0	0	127	62	3	96	39	1
9358077	Core_router	201704	1	0	0	0	1	0	0	0	128	63	3	96	39	1
9358077	Core_router	201705	1	0	0	0	1	1	0	0	129	64	3	97	40	1
9358077	Core_router	201706	1	0	0	0	1	0	0	0	130	65	3	97	40	1
9358077	Core_router	201709	1	0	0	0	1	1	0	0	131	66	3	98	41	1
9358077	Core_router	201802	1	0	0	0	1	1	0	0	132	67	3	99	42	1
36662188	Cryptocurrency	201302	1	0	0	0	1	1	0	0	1	1	0	1	1	0
36662188	Cryptocurrency	201305	1	0	0	0	1	1	0	0	2	2	0	2	2	0
36662188	Cryptocurrency	201306	15	2	1	0	3	3	2	1	17	5	2	17	5	2
36662188	Cryptocurrency	201307	37	6	0	0	12	9	5	0	54	16	8	47	13	3
36662188	Cryptocurrency	201308	9	2	0	0	3	3	1	0	63	18	10	56	15	5
36662188	Cryptocurrency	201309	7	0	0	0	5	4	0	0	70	22	10	62	18	5
36662188	Cryptocurrency	201310	8	0	0	0	4	3	0	0	78	24	10	69	19	5
36662188	Cryptocurrency	201311	11	1	0	0	10	6	1	0	89	33	11	76	24	6
36662188	Cryptocurrency	201312	50	7	1	0	24	8	5	1	139	56	18	94	31	8
36662188	Cryptocurrency	201401	120	10	0	0	56	33	6	0	259	110	28	173	62	13
36662188	Cryptocurrency	201402	178	34	11	6	48	37	17	6	437	147	62	335	88	43
36662188	Cryptocurrency	201403	37	1	0	0	25	20	1	0	474	166	63	364	102	43
36662188	Cryptocurrency	201404	83	13	1	0	38	25	9	1	557	199	76	425	121	51
36662188	Cryptocurrency	201405	26	1	0	0	18	9	1	0	583	213	77	439	126	51
36662188	Cryptocurrency	201406	36	3	0	0	27	19	3	0	619	235	80	466	140	54
36662188	Cryptocurrency	201407	43	0	0	0	24	16	0	0	662	251	80	499	148	54
36662188	Cryptocurrency	201408	37	4	0	0	22	14	4	0	699	268	84	524	158	56
36662188	Cryptocurrency	201409	58	5	0	0	22	12	3	0	757	285	89	568	166	56
36662188	Cryptocurrency	201410	60	3	0	0	21	13	3	0	817	300	92	617	174	57
36662188	Cryptocurrency	201411	48	7	0	0	19	15	3	0	865	313	99	654	183	62
36662188	Cryptocurrency	201412	12	0	0	0	10	9	0	0	877	320	99	665	189	62
36662188	Cryptocurrency	201501	25	3	0	0	15	8	2	0	902	331	102	681	192	65
36662188	Cryptocurrency	201502	23	3	0	0	12	11	2	0	925	338	105	703	198	67
36662188	Cryptocurrency	201503	6	1	0	0	6	4	1	0	931	343	106	707	201	68
36662188	Cryptocurrency	201504	21	1	0	0	11	8	1	0	952	351	107	722	206	69
36662188	Cryptocurrency	201505	5	1	0	0	5	4	1	0	957	355	108	726	209	70
36662188	Cryptocurrency	201506	17	2	0	0	13	10	1	0	974	364	110	740	214	71
36662188	Cryptocurrency	201507	1	0	0	0	1	1	0	0	975	365	110	741	215	71
36662188	Cryptocurrency	201508	7	2	0	0	5	4	1	0	982	369	112	746	217	72
36662188	Cryptocurrency	201509	22	2	0	0	11	9	2	0	1004	378	114	759	224	74
36662188	Cryptocurrency	201510	21	0	0	0	4	4	0	0	1025	379	114	780	225	74
36662188	Cryptocurrency	201511	35	3	0	0	13	12	2	0	1060	385	117	813	230	76
36662188	Cryptocurrency	201512	5	0	0	0	3	3	0	0	1065	386	117	818	231	76
36662188	Cryptocurrency	201601	25	2	0	0	6	4	2	0	1090	389	119	840	232	77
36662188	Cryptocurrency	201602	1	0	0	0	1	1	0	0	1091	390	119	841	233	77
36662188	Cryptocurrency	201603	4	0	0	0	3	2	0	0	1095	393	119	843	235	77
36662188	Cryptocurrency	201604	4	0	0	0	2	1	0	0	1099	395	119	844	236	77
36662188	Cryptocurrency	201605	17	2	0	0	9	6	2	0	1116	402	121	857	240	77
36662188	Cryptocurrency	201606	14	1	0	0	9	6	1	0	1130	408	122	866	243	77
36662188	Cryptocurrency	201607	9	1	0	0	7	6	1	0	1139	413	123	874	247	77
36662188	Cryptocurrency	201608	9	1	0	0	7	6	1	0	1148	418	124	882	250	77
36662188	Cryptocurrency	201609	38	13	5	1	19	12	8	4	1186	430	137	912	255	85
36662188	Cryptocurrency	201610	3	0	0	0	3	3	0	0	1189	432	137	915	257	85
36662188	Cryptocurrency	201611	8	0	0	0	4	2	0	0	1197	435	137	921	258	85
36662188	Cryptocurrency	201612	21	5	0	0	9	7	3	0	1218	443	142	937	264	87
36662188	Cryptocurrency	201701	8	1	0	0	8	6	1	0	1226	450	143	943	269	87
36662188	Cryptocurrency	201702	14	2	0	0	8	7	2	0	1240	458	145	956	276	88
36662188	Cryptocurrency	201703	2	0	0	0	2	2	0	0	1242	460	145	958	278	88
36662188	Cryptocurrency	201704	4	0	0	0	3	3	0	0	1246	462	145	962	280	88
36662188	Cryptocurrency	201705	7	2	0	0	5	4	2	0	1253	465	147	968	282	89
36662188	Cryptocurrency	201706	30	5	0	0	21	16	5	0	1283	482	152	987	293	91
36662188	Cryptocurrency	201707	57	12	1	0	26	17	6	1	1340	500	164	1027	301	95
36662188	Cryptocurrency	201708	44	9	0	0	21	16	7	0	1384	517	173	1063	311	99
36662188	Cryptocurrency	201709	30	8	0	0	24	16	5	0	1414	534	181	1084	317	101
36662188	Cryptocurrency	201710	49	7	0	0	20	16	4	0	1463	551	188	1129	329	107
36662188	Cryptocurrency	201711	45	8	0	0	29	20	6	0	1508	573	196	1160	341	110
36662188	Cryptocurrency	201712	67	22	4	1	39	27	13	3	1575	601	218	1210	355	121
36662188	Cryptocurrency	201801	113	28	0	0	68	40	13	0	1688	659	246	1291	383	135
36662188	Cryptocurrency	201802	192	53	7	2	84	61	24	4	1880	731	299	1444	423	170
36662188	Cryptocurrency	201803	118	26	1	0	62	44	12	1	1998	784	325	1540	451	184
36662188	Cryptocurrency	201804	156	33	5	4	56	42	17	4	2154	825	358	1677	478	206
36662188	Cryptocurrency	201805	62	15	0	0	40	28	12	0	2216	851	373	1723	491	211
36662188	Cryptocurrency	201806	38	1	1	1	13	13	1	1	2254	857	374	1761	497	212
36662188	Cryptocurrency	201807	19	1	0	0	13	13	1	0	2273	864	375	1780	504	213
591994	Cryptographic_protocol	200406	3	0	0	0	2	2	0	0	3	2	0	3	2	0
591994	Cryptographic_protocol	200407	3	0	0	0	3	3	0	0	6	5	0	6	5	0
591994	Cryptographic_protocol	200409	1	0	0	0	1	1	0	0	7	5	0	7	5	0
591994	Cryptographic_protocol	200503	1	0	0	0	1	1	0	0	8	6	0	8	6	0
591994	Cryptographic_protocol	200507	1	0	0	0	1	1	0	0	9	6	0	9	6	0
591994	Cryptographic_protocol	200511	1	0	0	0	1	1	0	0	10	7	0	10	7	0
591994	Cryptographic_protocol	200607	1	0	0	0	1	1	0	0	11	8	0	11	8	0
591994	Cryptographic_protocol	200608	1	0	0	0	1	1	0	0	12	9	0	12	9	0
591994	Cryptographic_protocol	200609	2	0	0	0	1	1	0	0	14	10	0	14	10	0
591994	Cryptographic_protocol	200611	4	0	0	0	3	2	0	0	18	13	0	16	12	0
591994	Cryptographic_protocol	200612	1	0	0	0	1	1	0	0	19	14	0	17	13	0
591994	Cryptographic_protocol	200704	1	0	0	0	1	1	0	0	20	15	0	18	14	0
591994	Cryptographic_protocol	200706	2	1	0	0	2	1	1	0	22	17	1	19	15	0
591994	Cryptographic_protocol	200707	3	1	0	0	3	1	1	0	25	20	2	20	16	0
591994	Cryptographic_protocol	200711	2	1	0	0	2	1	1	0	27	22	3	21	17	0
591994	Cryptographic_protocol	200803	1	0	0	0	1	1	0	0	28	23	3	22	18	0
591994	Cryptographic_protocol	200807	1	0	0	0	1	0	0	0	29	24	3	22	18	0
591994	Cryptographic_protocol	200810	2	1	0	0	2	1	1	0	31	26	4	23	19	0
591994	Cryptographic_protocol	200811	3	1	0	0	3	2	1	0	34	29	5	25	21	0
591994	Cryptographic_protocol	200812	1	0	0	0	1	1	0	0	35	30	5	26	22	0
591994	Cryptographic_protocol	200907	1	0	0	0	1	1	0	0	36	31	5	27	23	0
591994	Cryptographic_protocol	201002	2	0	0	0	2	2	0	0	38	33	5	29	25	0
591994	Cryptographic_protocol	201003	1	0	0	0	1	1	0	0	39	34	5	30	26	0
591994	Cryptographic_protocol	201007	1	0	0	0	1	1	0	0	40	35	5	31	27	0
591994	Cryptographic_protocol	201009	2	0	0	0	1	0	0	0	42	36	5	31	27	0
591994	Cryptographic_protocol	201010	1	0	0	0	1	1	0	0	43	37	5	32	28	0
591994	Cryptographic_protocol	201102	1	0	0	0	1	1	0	0	44	38	5	33	29	0
591994	Cryptographic_protocol	201105	3	0	0	0	1	0	0	0	47	39	5	33	29	0
591994	Cryptographic_protocol	201108	1	0	0	0	1	1	0	0	48	40	5	34	30	0
591994	Cryptographic_protocol	201109	1	0	0	0	1	1	0	0	49	41	5	35	31	0
591994	Cryptographic_protocol	201111	3	0	0	0	2	0	0	0	52	43	5	35	31	0
591994	Cryptographic_protocol	201112	1	0	0	0	1	1	0	0	53	44	5	36	32	0
591994	Cryptographic_protocol	201203	1	0	0	0	1	0	0	0	54	45	5	36	32	0
591994	Cryptographic_protocol	201207	1	0	0	0	1	1	0	0	55	46	5	37	33	0
591994	Cryptographic_protocol	201212	3	0	0	0	3	3	0	0	58	48	5	40	35	0
591994	Cryptographic_protocol	201302	1	0	0	0	1	0	0	0	59	49	5	40	35	0
591994	Cryptographic_protocol	201308	2	0	0	0	2	2	0	0	61	51	5	42	37	0
591994	Cryptographic_protocol	201309	1	0	0	0	1	0	0	0	62	52	5	42	37	0
591994	Cryptographic_protocol	201311	3	1	0	0	2	1	1	0	65	54	6	43	38	0
591994	Cryptographic_protocol	201403	1	0	0	0	1	0	0	0	66	55	6	43	38	0
591994	Cryptographic_protocol	201406	5	1	0	0	3	2	1	0	71	58	7	45	40	1
591994	Cryptographic_protocol	201408	1	0	0	0	1	1	0	0	72	59	7	46	41	1
591994	Cryptographic_protocol	201411	2	0	0	0	1	0	0	0	74	60	7	46	41	1
591994	Cryptographic_protocol	201501	3	0	0	0	1	0	0	0	77	61	7	46	41	1
591994	Cryptographic_protocol	201503	3	2	1	0	2	2	2	1	80	63	9	49	43	3
591994	Cryptographic_protocol	201504	1	0	0	0	1	0	0	0	81	64	9	49	43	3
591994	Cryptographic_protocol	201509	2	0	0	0	1	1	0	0	83	65	9	51	44	3
591994	Cryptographic_protocol	201510	2	0	0	0	1	1	0	0	85	66	9	53	45	3
591994	Cryptographic_protocol	201511	3	0	0	0	2	2	0	0	88	68	9	56	47	3
591994	Cryptographic_protocol	201609	2	0	0	0	2	2	0	0	90	69	9	58	48	3
591994	Cryptographic_protocol	201610	1	0	0	0	1	1	0	0	91	69	9	59	48	3
591994	Cryptographic_protocol	201611	10	0	0	0	2	2	0	0	101	70	9	69	49	3
591994	Cryptographic_protocol	201612	2	0	0	0	2	2	0	0	103	71	9	71	50	3
591994	Cryptographic_protocol	201701	1	0	0	0	1	1	0	0	104	71	9	72	50	3
591994	Cryptographic_protocol	201704	3	1	0	0	3	1	1	0	107	73	10	73	50	3
591994	Cryptographic_protocol	201706	1	0	0	0	1	1	0	0	108	74	10	74	51	3
591994	Cryptographic_protocol	201707	2	1	0	0	2	1	1	0	110	76	11	75	52	3
591994	Cryptographic_protocol	201709	2	1	0	0	2	1	1	0	112	78	12	76	53	3
591994	Cryptographic_protocol	201710	1	0	0	0	1	1	0	0	113	79	12	77	54	3
591994	Cryptographic_protocol	201711	2	1	0	0	2	2	1	0	115	81	13	79	55	4
591994	Cryptographic_protocol	201806	1	0	0	0	1	1	0	0	116	82	13	80	56	4
591994	Cryptographic_protocol	201807	19	10	2	0	12	12	6	1	135	94	23	99	61	14
18934432	Cryptography	200112	1	0	0	0	1	1	0	0	1	1	0	1	1	0
18934432	Cryptography	200201	25	0	0	0	7	7	0	0	26	7	0	26	7	0
18934432	Cryptography	200202	6	0	0	0	4	4	0	0	32	10	0	32	9	0
18934432	Cryptography	200203	2	0	0	0	2	2	0	0	34	11	0	34	10	0
18934432	Cryptography	200204	4	0	0	0	3	2	0	0	38	14	0	36	12	0
18934432	Cryptography	200205	5	0	0	0	3	1	0	0	43	17	0	37	13	0
18934432	Cryptography	200206	2	0	0	0	2	2	0	0	45	19	0	39	15	0
18934432	Cryptography	200207	2	0	0	0	2	2	0	0	47	21	0	41	17	0
18934432	Cryptography	200208	4	0	0	0	2	0	0	0	51	23	0	41	17	0
18934432	Cryptography	200209	3	0	0	0	3	1	0	0	54	26	0	42	18	0
18934432	Cryptography	200210	5	0	0	0	4	1	0	0	59	30	0	43	19	0
18934432	Cryptography	200211	2	0	0	0	2	0	0	0	61	31	0	43	19	0
18934432	Cryptography	200212	9	0	0	0	5	3	0	0	70	34	0	48	21	0
18934432	Cryptography	200301	2	0	0	0	2	1	0	0	72	36	0	49	22	0
18934432	Cryptography	200302	4	0	0	0	4	2	0	0	76	39	0	51	23	0
18934432	Cryptography	200303	3	0	0	0	3	0	0	0	79	41	0	51	23	0
18934432	Cryptography	200304	4	0	0	0	4	2	0	0	83	44	0	53	25	0
18934432	Cryptography	200305	5	0	0	0	4	2	0	0	88	47	0	56	27	0
18934432	Cryptography	200306	3	0	0	0	3	1	0	0	91	49	0	57	28	0
18934432	Cryptography	200307	21	0	0	0	12	5	0	0	112	57	0	62	31	0
18934432	Cryptography	200308	6	0	0	0	4	3	0	0	118	61	0	67	34	0
18934432	Cryptography	200309	12	0	0	0	10	5	0	0	130	71	0	73	39	0
18934432	Cryptography	200310	4	1	0	0	3	2	1	0	134	74	1	76	41	0
18934432	Cryptography	200311	8	1	0	0	6	4	1	0	142	78	2	82	44	0
18934432	Cryptography	200312	19	0	0	0	9	6	0	0	161	85	2	98	48	0
18934432	Cryptography	200401	12	1	0	0	7	5	1	0	173	90	3	108	51	1
18934432	Cryptography	200402	39	0	0	0	8	7	0	0	212	96	3	146	56	1
18934432	Cryptography	200403	43	1	0	0	10	9	1	0	255	103	4	187	62	1
18934432	Cryptography	200404	84	1	0	0	18	12	1	0	339	115	5	263	69	1
18934432	Cryptography	200405	9	0	0	0	5	5	0	0	348	119	5	272	73	1
18934432	Cryptography	200406	8	0	0	0	6	3	0	0	356	123	5	276	74	1
18934432	Cryptography	200407	8	0	0	0	5	2	0	0	364	127	5	279	75	1
18934432	Cryptography	200408	6	1	0	0	6	3	1	0	370	132	6	282	77	1
18934432	Cryptography	200409	4	0	0	0	3	1	0	0	374	134	6	283	77	1
18934432	Cryptography	200410	7	0	0	0	6	6	0	0	381	139	6	290	82	1
18934432	Cryptography	200411	10	1	0	0	10	7	1	0	391	144	7	297	84	1
18934432	Cryptography	200412	6	1	0	0	6	6	1	0	397	149	8	303	89	2
18934432	Cryptography	200501	12	2	0	0	8	6	2	0	409	156	10	313	94	2
18934432	Cryptography	200502	7	0	0	0	4	2	0	0	416	159	10	315	95	2
18934432	Cryptography	200503	8	3	0	0	5	2	2	0	424	163	13	320	96	3
18934432	Cryptography	200504	5	0	0	0	5	5	0	0	429	168	13	325	101	3
18934432	Cryptography	200505	37	11	0	0	29	17	8	0	466	194	24	347	115	5
18934432	Cryptography	200506	15	3	0	0	12	8	2	0	481	203	27	357	120	5
18934432	Cryptography	200507	20	2	0	0	14	10	2	0	501	214	29	373	127	5
18934432	Cryptography	200508	19	0	0	0	7	5	0	0	520	220	29	390	131	5
18934432	Cryptography	200509	7	2	0	0	6	2	2	0	527	226	31	392	133	6
18934432	Cryptography	200510	15	1	0	0	12	9	1	0	542	235	32	401	139	6
18934432	Cryptography	200511	14	3	0	0	13	9	3	0	556	244	35	411	144	7
18934432	Cryptography	200512	15	3	0	0	13	9	3	0	571	254	38	421	150	7
18934432	Cryptography	200601	22	5	0	0	15	7	1	0	593	268	43	433	156	9
18934432	Cryptography	200602	13	0	0	0	11	8	0	0	606	278	43	441	163	9
18934432	Cryptography	200603	22	3	0	0	11	6	2	0	628	287	46	456	167	9
18934432	Cryptography	200604	82	7	0	0	31	18	6	0	710	311	53	513	178	9
18934432	Cryptography	200605	39	6	0	0	15	10	5	0	749	323	59	546	185	11
18934432	Cryptography	200606	44	6	0	0	27	16	5	0	793	346	65	579	197	13
18934432	Cryptography	200607	40	4	0	0	16	9	4	0	833	359	69	610	203	15
18934432	Cryptography	200608	275	39	12	7	100	67	24	7	1108	454	108	829	265	39
18934432	Cryptography	200609	35	7	0	0	13	7	3	0	1143	462	115	855	267	42
18934432	Cryptography	200610	32	5	0	0	14	10	3	0	1175	469	120	883	270	44
18934432	Cryptography	200611	58	8	0	0	35	22	8	0	1233	496	128	926	284	45
18934432	Cryptography	200612	29	6	0	0	21	17	5	0	1262	510	134	948	294	47
18934432	Cryptography	200701	22	4	0	0	16	12	4	0	1284	524	138	966	304	50
18934432	Cryptography	200702	19	5	0	0	17	8	4	0	1303	539	143	976	310	50
18934432	Cryptography	200703	31	9	1	0	27	14	9	1	1334	564	152	991	322	51
18934432	Cryptography	200704	34	6	0	0	20	12	2	0	1368	582	158	1014	332	52
18934432	Cryptography	200705	48	12	0	0	22	11	9	0	1416	602	170	1033	341	52
18934432	Cryptography	200706	39	5	1	0	22	14	4	1	1455	621	175	1063	352	55
18934432	Cryptography	200707	32	3	0	0	20	13	2	0	1487	638	178	1081	362	57
18934432	Cryptography	200708	26	7	0	0	17	7	5	0	1513	653	185	1094	367	58
18934432	Cryptography	200709	13	3	0	0	12	5	3	0	1526	663	188	1099	370	58
18934432	Cryptography	200710	28	4	0	0	21	10	4	0	1554	680	192	1116	376	58
18934432	Cryptography	200711	28	11	0	0	22	13	9	0	1582	699	203	1133	386	61
18934432	Cryptography	200712	28	6	0	0	23	11	6	0	1610	718	209	1148	393	61
18934432	Cryptography	200801	8	3	0	0	6	2	3	0	1618	723	212	1150	394	62
18934432	Cryptography	200802	14	3	0	0	10	5	3	0	1632	733	215	1157	399	62
18934432	Cryptography	200803	15	0	0	0	10	7	0	0	1647	742	215	1169	405	62
18934432	Cryptography	200804	15	4	0	0	13	8	3	0	1662	750	219	1178	408	62
18934432	Cryptography	200805	32	9	0	0	25	11	6	0	1694	771	228	1192	415	62
18934432	Cryptography	200806	28	4	0	0	15	12	3	0	1722	782	232	1214	423	62
18934432	Cryptography	200807	38	12	0	0	28	18	11	0	1760	805	244	1239	436	65
18934432	Cryptography	200808	7	1	0	0	7	4	1	0	1767	811	245	1243	439	65
18934432	Cryptography	200809	37	15	2	0	25	15	13	2	1804	832	260	1262	450	67
18934432	Cryptography	200810	22	7	1	0	17	10	6	1	1826	843	267	1275	454	68
18934432	Cryptography	200811	17	3	0	0	14	9	3	0	1843	853	270	1287	459	68
18934432	Cryptography	200812	19	2	0	0	11	8	2	0	1862	860	272	1303	463	68
18934432	Cryptography	200901	11	2	0	0	11	8	2	0	1873	869	274	1311	469	69
18934432	Cryptography	200902	36	5	0	0	18	9	3	0	1909	885	279	1331	476	69
18934432	Cryptography	200903	23	3	0	0	16	7	3	0	1932	897	282	1343	479	70
18934432	Cryptography	200904	17	3	0	0	14	9	3	0	1949	909	285	1354	486	72
18934432	Cryptography	200905	19	1	0	0	15	5	1	0	1968	921	286	1360	488	72
18934432	Cryptography	200906	22	8	0	0	19	10	7	0	1990	935	294	1371	493	72
18934432	Cryptography	200907	11	0	0	0	8	7	0	0	2001	940	294	1381	497	72
18934432	Cryptography	200908	17	6	1	0	12	9	5	1	2018	949	300	1391	503	73
18934432	Cryptography	200909	5	1	0	0	5	4	1	0	2023	952	301	1395	506	74
18934432	Cryptography	200910	35	8	0	0	19	10	6	0	2058	969	309	1408	514	74
18934432	Cryptography	200911	23	2	0	0	14	8	2	0	2081	979	311	1424	518	74
18934432	Cryptography	200912	15	4	0	0	10	6	3	0	2096	987	315	1433	522	75
18934432	Cryptography	201001	32	8	1	0	22	14	6	1	2128	1004	323	1451	531	76
18934432	Cryptography	201002	28	6	0	0	18	12	6	0	2156	1016	329	1472	537	76
18934432	Cryptography	201003	20	5	0	0	14	8	4	0	2176	1027	334	1481	542	77
18934432	Cryptography	201004	18	2	0	0	15	9	2	0	2194	1038	336	1491	547	77
18934432	Cryptography	201005	12	1	0	0	8	5	1	0	2206	1045	337	1498	551	77
18934432	Cryptography	201006	16	3	0	0	11	7	3	0	2222	1056	340	1506	558	78
18934432	Cryptography	201007	19	4	0	0	14	8	4	0	2241	1064	344	1516	560	78
18934432	Cryptography	201008	16	0	0	0	14	13	0	0	2257	1076	344	1531	571	78
18934432	Cryptography	201009	11	2	0	0	10	6	2	0	2268	1082	346	1538	573	78
18934432	Cryptography	201010	3	0	0	0	2	1	0	0	2271	1084	346	1539	574	78
18934432	Cryptography	201011	17	4	0	0	10	8	3	0	2288	1091	350	1553	579	81
18934432	Cryptography	201012	4	1	0	0	4	3	1	0	2292	1095	351	1556	582	81
18934432	Cryptography	201101	23	6	0	0	17	9	4	0	2315	1109	357	1569	589	81
18934432	Cryptography	201102	20	4	0	0	14	11	4	0	2335	1118	361	1586	595	83
18934432	Cryptography	201103	17	3	1	0	13	7	3	1	2352	1128	364	1594	599	84
18934432	Cryptography	201104	11	4	0	0	10	5	4	0	2363	1136	368	1599	602	84
18934432	Cryptography	201105	25	4	0	0	13	11	4	0	2388	1143	372	1622	608	86
18934432	Cryptography	201106	14	3	0	0	13	8	2	0	2402	1152	375	1631	612	87
18934432	Cryptography	201107	18	5	0	0	14	9	5	0	2420	1162	380	1644	617	89
18934432	Cryptography	201108	25	6	0	0	15	11	4	0	2445	1173	386	1665	624	92
18934432	Cryptography	201109	8	3	0	0	7	5	3	0	2453	1178	389	1671	627	94
18934432	Cryptography	201110	25	5	0	0	11	7	5	0	2478	1184	394	1688	629	96
18934432	Cryptography	201111	13	2	0	0	10	6	1	0	2491	1191	396	1696	632	96
18934432	Cryptography	201112	21	8	0	0	16	10	6	0	2512	1202	404	1709	637	97
18934432	Cryptography	201201	8	2	0	0	7	4	2	0	2520	1208	406	1714	640	98
18934432	Cryptography	201202	23	4	0	0	15	8	4	0	2543	1219	410	1723	644	98
18934432	Cryptography	201203	20	5	0	0	17	10	5	0	2563	1228	415	1735	646	98
18934432	Cryptography	201204	26	6	0	0	17	12	5	0	2589	1239	421	1755	652	101
18934432	Cryptography	201205	11	3	0	0	10	7	3	0	2600	1246	424	1762	656	102
18934432	Cryptography	201206	4	2	0	0	4	2	2	0	2604	1248	426	1764	656	102
18934432	Cryptography	201207	7	3	0	0	6	4	3	0	2611	1250	429	1769	657	103
18934432	Cryptography	201208	9	2	0	0	4	2	2	0	2620	1252	431	1771	657	103
18934432	Cryptography	201209	7	3	0	0	6	3	2	0	2627	1255	434	1775	657	103
18934432	Cryptography	201210	9	4	0	0	8	6	4	0	2636	1260	438	1781	660	104
18934432	Cryptography	201211	8	4	0	0	7	5	4	0	2644	1265	442	1787	663	106
18934432	Cryptography	201212	11	2	0	0	10	7	2	0	2655	1271	444	1795	666	107
18934432	Cryptography	201301	9	1	0	0	9	6	1	0	2664	1276	445	1801	668	107
18934432	Cryptography	201302	6	2	0	0	6	3	2	0	2670	1280	447	1804	669	107
18934432	Cryptography	201303	11	6	1	0	9	5	5	1	2681	1286	453	1810	671	108
18934432	Cryptography	201304	9	2	0	0	9	7	2	0	2690	1294	455	1817	677	108
18934432	Cryptography	201305	11	5	0	0	11	6	5	0	2701	1302	460	1823	680	109
18934432	Cryptography	201306	11	4	0	0	9	5	4	0	2712	1307	464	1828	682	109
18934432	Cryptography	201307	5	2	0	0	5	2	2	0	2717	1311	466	1830	683	109
18934432	Cryptography	201308	6	1	0	0	5	3	1	0	2723	1315	467	1833	685	109
18934432	Cryptography	201309	16	3	0	0	11	8	3	0	2739	1322	470	1846	689	111
18934432	Cryptography	201310	5	0	0	0	3	2	0	0	2744	1323	470	1850	689	111
18934432	Cryptography	201311	7	2	0	0	7	5	2	0	2751	1329	472	1855	693	112
18934432	Cryptography	201312	8	6	0	0	8	5	6	0	2759	1336	478	1860	697	115
18934432	Cryptography	201401	6	1	0	0	5	4	1	0	2765	1339	479	1865	699	115
18934432	Cryptography	201402	18	5	0	0	10	4	3	0	2783	1347	484	1871	702	115
18934432	Cryptography	201403	11	5	0	0	11	8	5	0	2794	1355	489	1879	707	117
18934432	Cryptography	201404	11	1	0	0	9	7	1	0	2805	1361	490	1888	711	117
18934432	Cryptography	201405	9	1	0	0	6	5	1	0	2814	1365	491	1896	714	118
18934432	Cryptography	201406	3	1	0	0	3	2	1	0	2817	1368	492	1898	716	118
18934432	Cryptography	201407	2	0	0	0	2	2	0	0	2819	1370	492	1900	718	118
18934432	Cryptography	201408	19	5	0	0	12	8	4	0	2838	1378	497	1910	722	118
18934432	Cryptography	201409	4	0	0	0	4	4	0	0	2842	1382	497	1914	726	118
18934432	Cryptography	201410	20	8	0	0	16	10	5	0	2862	1394	505	1928	732	121
18934432	Cryptography	201411	28	3	0	0	15	12	3	0	2890	1405	508	1953	740	123
18934432	Cryptography	201412	19	3	0	0	15	9	2	0	2909	1416	511	1965	745	123
18934432	Cryptography	201501	14	4	0	0	10	7	4	0	2923	1424	515	1973	749	124
18934432	Cryptography	201502	7	1	0	0	4	4	1	0	2930	1426	516	1980	751	125
18934432	Cryptography	201503	9	3	0	0	8	6	3	0	2939	1432	519	1987	755	126
18934432	Cryptography	201504	10	1	0	0	6	3	1	0	2949	1437	520	1992	758	126
18934432	Cryptography	201505	17	6	0	0	13	7	6	0	2966	1447	526	2003	761	127
18934432	Cryptography	201506	10	2	0	0	7	4	2	0	2976	1451	528	2008	762	127
18934432	Cryptography	201507	5	2	0	0	5	4	2	0	2981	1455	530	2012	764	128
18934432	Cryptography	201508	7	1	0	0	5	3	1	0	2988	1460	531	2017	767	128
18934432	Cryptography	201509	7	0	0	0	4	3	0	0	2995	1463	531	2023	769	128
18934432	Cryptography	201510	7	3	0	0	6	3	3	0	3002	1466	534	2027	769	128
18934432	Cryptography	201511	10	2	0	0	6	5	2	0	3012	1469	536	2036	771	129
18934432	Cryptography	201512	56	14	0	0	17	12	6	0	3068	1482	550	2062	779	130
18934432	Cryptography	201601	7	0	0	0	5	3	0	0	3075	1486	550	2066	781	130
18934432	Cryptography	201602	11	1	0	0	9	7	1	0	3086	1491	551	2075	784	130
18934432	Cryptography	201603	11	3	0	0	8	5	2	0	3097	1496	554	2083	786	131
18934432	Cryptography	201604	18	4	0	0	14	13	4	0	3115	1507	558	2097	795	132
18934432	Cryptography	201605	11	2	0	0	8	5	2	0	3126	1514	560	2103	799	134
18934432	Cryptography	201606	8	3	0	0	8	5	3	0	3134	1520	563	2108	802	134
18934432	Cryptography	201607	12	3	0	0	9	7	3	0	3146	1525	566	2118	805	135
18934432	Cryptography	201609	6	3	0	0	6	4	3	0	3152	1529	569	2122	807	136
18934432	Cryptography	201610	13	4	0	0	10	6	3	0	3165	1536	573	2131	810	137
18934432	Cryptography	201611	13	6	0	0	10	7	5	0	3178	1542	579	2139	813	139
18934432	Cryptography	201612	5	1	0	0	5	4	1	0	3183	1545	580	2143	815	140
18934432	Cryptography	201701	3	1	0	0	3	3	1	0	3186	1547	581	2146	817	141
18934432	Cryptography	201702	3	1	0	0	2	1	1	0	3189	1549	582	2147	818	141
18934432	Cryptography	201703	6	3	0	0	6	6	3	0	3195	1552	585	2153	820	144
18934432	Cryptography	201704	21	3	0	0	13	10	3	0	3216	1562	588	2170	827	145
18934432	Cryptography	201705	15	5	0	0	8	5	4	0	3231	1566	593	2176	828	145
18934432	Cryptography	201706	7	2	0	0	7	6	2	0	3238	1572	595	2182	832	146
18934432	Cryptography	201707	2	0	0	0	2	2	0	0	3240	1574	595	2184	834	146
18934432	Cryptography	201708	12	4	0	0	10	6	3	0	3252	1580	599	2191	835	148
18934432	Cryptography	201709	8	2	0	0	6	5	2	0	3260	1585	601	2198	839	149
18934432	Cryptography	201710	8	3	0	0	8	4	3	0	3268	1590	604	2202	840	150
18934432	Cryptography	201711	5	0	0	0	2	0	0	0	3273	1592	604	2202	840	150
18934432	Cryptography	201712	10	4	0	0	7	5	4	0	3283	1597	608	2208	842	151
18934432	Cryptography	201801	10	3	0	0	9	8	3	0	3293	1603	611	2217	845	153
18934432	Cryptography	201802	14	4	0	0	11	6	4	0	3307	1612	615	2223	848	153
18934432	Cryptography	201803	11	5	0	0	9	6	4	0	3318	1618	620	2231	850	155
18934432	Cryptography	201804	7	1	0	0	3	2	1	0	3325	1620	621	2237	851	155
18934432	Cryptography	201805	7	3	0	0	6	4	3	0	3332	1625	624	2241	854	155
18934432	Cryptography	201806	5	2	0	0	5	4	2	0	3337	1629	626	2245	857	156
18934432	Cryptography	201807	6	2	0	0	6	6	2	0	3343	1634	628	2251	861	158
17787148	Cyber-physical_system	200807	12	0	0	0	3	3	0	0	12	3	0	12	3	0
17787148	Cyber-physical_system	200808	2	0	0	0	1	1	0	0	14	4	0	14	4	0
17787148	Cyber-physical_system	200810	4	0	0	0	1	1	0	0	18	5	0	18	5	0
17787148	Cyber-physical_system	200905	4	0	0	0	2	1	0	0	22	7	0	19	6	0
17787148	Cyber-physical_system	200906	2	0	0	0	2	0	0	0	24	9	0	19	6	0
17787148	Cyber-physical_system	200907	1	0	0	0	1	0	0	0	25	10	0	19	6	0
17787148	Cyber-physical_system	200909	1	0	0	0	1	0	0	0	26	11	0	19	6	0
17787148	Cyber-physical_system	200911	2	1	0	0	2	1	1	0	28	12	1	20	6	0
17787148	Cyber-physical_system	201001	2	1	0	0	2	1	1	0	30	13	2	21	6	0
17787148	Cyber-physical_system	201004	11	0	0	0	3	0	0	0	41	16	2	21	6	0
17787148	Cyber-physical_system	201005	1	0	0	0	1	1	0	0	42	17	2	22	7	0
17787148	Cyber-physical_system	201006	3	1	0	0	2	1	1	0	45	17	3	23	7	0
17787148	Cyber-physical_system	201007	1	0	0	0	1	0	0	0	46	18	3	23	7	0
17787148	Cyber-physical_system	201011	1	0	0	0	1	0	0	0	47	19	3	23	7	0
17787148	Cyber-physical_system	201012	8	0	0	0	3	2	0	0	55	20	3	26	8	0
17787148	Cyber-physical_system	201102	8	1	0	0	2	1	1	0	63	20	4	27	8	0
17787148	Cyber-physical_system	201104	4	0	0	0	2	2	0	0	67	22	4	31	10	0
17787148	Cyber-physical_system	201105	2	0	0	0	2	2	0	0	69	24	4	33	12	0
17787148	Cyber-physical_system	201106	21	0	0	0	1	0	0	0	90	24	4	33	12	0
17787148	Cyber-physical_system	201109	4	0	0	0	3	1	0	0	94	27	4	34	13	0
17787148	Cyber-physical_system	201110	6	0	0	0	4	4	0	0	100	31	4	40	17	0
17787148	Cyber-physical_system	201111	9	1	0	0	4	1	1	0	109	34	5	41	18	1
17787148	Cyber-physical_system	201201	2	0	0	0	2	1	0	0	111	36	5	42	19	1
17787148	Cyber-physical_system	201202	2	0	0	0	1	1	0	0	113	37	5	44	20	1
17787148	Cyber-physical_system	201204	1	0	0	0	1	1	0	0	114	38	5	45	21	1
17787148	Cyber-physical_system	201209	2	0	0	0	1	0	0	0	116	39	5	45	21	1
17787148	Cyber-physical_system	201210	2	0	0	0	2	2	0	0	118	41	5	47	23	1
17787148	Cyber-physical_system	201212	4	0	0	0	2	1	0	0	122	43	5	48	24	1
17787148	Cyber-physical_system	201301	1	0	0	0	1	1	0	0	123	44	5	49	25	1
17787148	Cyber-physical_system	201303	2	1	0	0	2	1	1	0	125	46	6	50	26	1
17787148	Cyber-physical_system	201306	1	0	0	0	1	1	0	0	126	47	6	51	27	1
17787148	Cyber-physical_system	201307	1	0	0	0	1	0	0	0	127	48	6	51	27	1
17787148	Cyber-physical_system	201308	2	0	0	0	2	1	0	0	129	50	6	52	28	1
17787148	Cyber-physical_system	201401	1	0	0	0	1	1	0	0	130	51	6	53	29	1
17787148	Cyber-physical_system	201403	2	0	0	0	1	1	0	0	132	52	6	55	30	1
17787148	Cyber-physical_system	201404	2	0	0	0	2	2	0	0	134	54	6	57	32	1
17787148	Cyber-physical_system	201405	3	0	0	0	2	1	0	0	137	56	6	58	33	1
17787148	Cyber-physical_system	201407	4	0	0	0	3	2	0	0	141	57	6	61	33	1
17787148	Cyber-physical_system	201408	9	0	0	0	4	3	0	0	150	61	6	65	36	1
17787148	Cyber-physical_system	201409	3	0	0	0	2	0	0	0	153	63	6	65	36	1
17787148	Cyber-physical_system	201410	1	0	0	0	1	1	0	0	154	64	6	66	37	1
17787148	Cyber-physical_system	201412	11	0	0	0	3	2	0	0	165	66	6	73	38	1
17787148	Cyber-physical_system	201501	1	0	0	0	1	0	0	0	166	67	6	73	38	1
17787148	Cyber-physical_system	201502	9	0	0	0	2	2	0	0	175	68	6	82	39	1
17787148	Cyber-physical_system	201504	9	0	0	0	2	2	0	0	184	69	6	91	40	1
17787148	Cyber-physical_system	201505	1	0	0	0	1	1	0	0	185	69	6	92	40	1
17787148	Cyber-physical_system	201507	1	0	0	0	1	0	0	0	186	70	6	92	40	1
17787148	Cyber-physical_system	201508	1	0	0	0	1	1	0	0	187	71	6	93	41	1
17787148	Cyber-physical_system	201509	1	0	0	0	1	1	0	0	188	72	6	94	42	1
17787148	Cyber-physical_system	201510	1	0	0	0	1	1	0	0	189	72	6	95	42	1
17787148	Cyber-physical_system	201512	2	0	0	0	2	2	0	0	191	73	6	97	43	1
17787148	Cyber-physical_system	201601	1	0	0	0	1	1	0	0	192	74	6	98	44	1
17787148	Cyber-physical_system	201602	4	0	0	0	1	1	0	0	196	75	6	102	45	1
17787148	Cyber-physical_system	201603	9	0	0	0	3	3	0	0	205	78	6	111	48	1
17787148	Cyber-physical_system	201604	9	0	0	0	9	5	0	0	214	85	6	116	51	1
17787148	Cyber-physical_system	201605	4	0	0	0	4	4	0	0	218	88	6	120	54	1
17787148	Cyber-physical_system	201606	1	0	0	0	1	1	0	0	219	89	6	121	55	1
17787148	Cyber-physical_system	201607	4	1	0	0	4	3	1	0	223	93	7	124	58	2
17787148	Cyber-physical_system	201608	3	0	0	0	3	1	0	0	226	95	7	125	58	2
17787148	Cyber-physical_system	201609	2	0	0	0	2	2	0	0	228	97	7	127	60	2
17787148	Cyber-physical_system	201612	3	0	0	0	2	2	0	0	231	99	7	130	62	2
17787148	Cyber-physical_system	201701	2	1	0	0	2	1	1	0	233	101	8	131	63	2
17787148	Cyber-physical_system	201705	3	0	0	0	2	1	0	0	236	103	8	132	64	2
17787148	Cyber-physical_system	201706	1	0	0	0	1	1	0	0	237	104	8	133	65	2
17787148	Cyber-physical_system	201708	3	0	0	0	2	1	0	0	240	106	8	135	66	2
17787148	Cyber-physical_system	201709	2	0	0	0	2	2	0	0	242	108	8	137	68	2
17787148	Cyber-physical_system	201710	5	1	0	0	3	2	1	0	247	111	9	141	70	2
17787148	Cyber-physical_system	201711	3	0	0	0	2	1	0	0	250	112	9	143	70	2
17787148	Cyber-physical_system	201801	3	0	0	0	3	3	0	0	253	114	9	146	72	2
17787148	Cyber-physical_system	201804	4	0	0	0	2	1	0	0	257	116	9	149	72	2
17787148	Cyber-physical_system	201806	2	0	0	0	2	2	0	0	259	118	9	151	74	2
17787148	Cyber-physical_system	201807	13	0	0	0	2	1	0	0	272	120	9	163	75	2
37925700	Cyberattack	201301	7	0	0	0	5	5	0	0	7	5	0	7	5	0
37925700	Cyberattack	201302	5	0	0	0	5	5	0	0	12	8	0	12	8	0
37925700	Cyberattack	201303	5	1	0	0	4	2	1	0	17	12	1	14	10	0
37925700	Cyberattack	201304	6	0	0	0	5	1	0	0	23	17	1	16	11	0
37925700	Cyberattack	201305	3	0	0	0	2	0	0	0	26	19	1	16	11	0
37925700	Cyberattack	201306	10	0	0	0	3	3	0	0	36	22	1	26	14	0
37925700	Cyberattack	201307	7	1	0	0	4	1	1	0	43	26	2	27	15	0
37925700	Cyberattack	201308	6	1	0	0	4	2	1	0	49	30	3	29	17	0
37925700	Cyberattack	201309	3	0	0	0	3	3	0	0	52	33	3	32	20	0
37925700	Cyberattack	201310	6	2	0	0	5	2	2	0	58	38	5	34	22	1
37925700	Cyberattack	201311	9	3	0	0	6	4	2	0	67	44	8	39	26	1
37925700	Cyberattack	201312	6	2	0	0	4	2	2	0	73	47	10	41	27	1
37925700	Cyberattack	201401	7	1	0	0	5	3	1	0	80	50	11	46	28	2
37925700	Cyberattack	201402	4	0	0	0	3	2	0	0	84	53	11	49	30	2
37925700	Cyberattack	201403	1	0	0	0	1	1	0	0	85	54	11	50	31	2
37925700	Cyberattack	201404	8	3	0	0	7	5	2	0	93	61	14	56	36	3
37925700	Cyberattack	201405	9	1	0	0	7	5	1	0	102	67	15	63	40	3
37925700	Cyberattack	201407	3	0	0	0	2	1	0	0	105	68	15	64	40	3
37925700	Cyberattack	201408	4	0	0	0	2	2	0	0	109	69	15	68	41	3
37925700	Cyberattack	201410	7	2	0	0	6	3	2	0	116	72	17	71	41	3
37925700	Cyberattack	201412	2	1	0	0	2	1	1	0	118	73	18	72	41	3
37925700	Cyberattack	201501	1	0	0	0	1	1	0	0	119	74	18	73	42	3
37925700	Cyberattack	201502	3	0	0	0	2	1	0	0	122	76	18	75	43	3
37925700	Cyberattack	201503	6	2	0	0	4	2	2	0	128	80	20	77	45	3
37925700	Cyberattack	201504	3	0	0	0	3	2	0	0	131	82	20	79	46	3
37925700	Cyberattack	201505	1	0	0	0	1	0	0	0	132	83	20	79	46	3
37925700	Cyberattack	201506	1	0	0	0	1	1	0	0	133	84	20	80	47	3
37925700	Cyberattack	201507	5	2	0	0	4	2	2	0	138	87	22	82	48	3
37925700	Cyberattack	201508	2	0	0	0	2	0	0	0	140	89	22	82	48	3
37925700	Cyberattack	201509	4	0	0	0	3	2	0	0	144	92	22	85	50	3
37925700	Cyberattack	201510	6	3	0	0	6	3	3	0	150	97	25	88	52	3
37925700	Cyberattack	201511	3	0	0	0	1	1	0	0	153	98	25	91	53	3
37925700	Cyberattack	201512	2	0	0	0	1	0	0	0	155	99	25	91	53	3
37925700	Cyberattack	201601	5	1	0	0	3	2	1	0	160	101	26	95	54	3
37925700	Cyberattack	201602	3	0	0	0	1	1	0	0	163	102	26	98	55	3
37925700	Cyberattack	201604	2	1	0	0	2	1	1	0	165	103	27	99	55	3
37925700	Cyberattack	201606	4	0	0	0	3	3	0	0	169	105	27	103	57	3
37925700	Cyberattack	201607	2	0	0	0	1	1	0	0	171	106	27	105	58	3
37925700	Cyberattack	201608	5	0	0	0	5	4	0	0	176	110	27	109	61	3
37925700	Cyberattack	201609	2	1	0	0	2	1	1	0	178	111	28	110	61	3
37925700	Cyberattack	201610	5	2	0	0	5	2	2	0	183	114	30	112	61	3
37925700	Cyberattack	201611	4	1	0	0	3	2	1	0	187	116	31	114	62	4
37925700	Cyberattack	201612	3	0	0	0	2	1	0	0	190	117	31	115	62	4
37925700	Cyberattack	201701	3	1	0	0	3	3	1	0	193	119	32	118	64	5
37925700	Cyberattack	201704	5	1	0	0	4	3	1	0	198	122	33	122	65	6
37925700	Cyberattack	201705	4	1	0	0	2	1	1	0	202	123	34	123	65	6
37925700	Cyberattack	201706	19	2	0	0	14	9	2	0	221	133	36	137	70	6
37925700	Cyberattack	201707	8	2	0	0	6	6	1	0	229	138	38	145	73	8
37925700	Cyberattack	201708	10	3	0	0	7	4	2	0	239	144	41	152	76	8
37925700	Cyberattack	201709	8	1	0	0	6	3	1	0	247	150	42	155	79	8
37925700	Cyberattack	201711	1	0	0	0	1	0	0	0	248	151	42	155	79	8
37925700	Cyberattack	201712	5	1	0	0	4	2	1	0	253	155	43	157	81	8
37925700	Cyberattack	201801	6	0	0	0	5	4	0	0	259	159	43	162	84	8
37925700	Cyberattack	201802	5	1	0	0	2	1	1	0	264	161	44	163	85	8
37925700	Cyberattack	201803	3	0	0	0	2	1	0	0	267	163	44	164	86	8
37925700	Cyberattack	201804	8	2	0	0	7	5	2	0	275	169	46	170	90	9
37925700	Cyberattack	201805	2	0	0	0	2	2	0	0	277	170	46	172	91	9
37925700	Cyberattack	201806	5	0	0	0	3	3	0	0	282	172	46	177	93	9
37925700	Cyberattack	201807	3	0	0	0	3	2	0	0	285	173	46	179	93	9
295981	DOCSIS	200401	1	0	0	0	1	0	0	0	1	1	0	0	0	0
295981	DOCSIS	200403	1	0	0	0	1	0	0	0	2	2	0	0	0	0
295981	DOCSIS	200404	4	0	0	0	3	1	0	0	6	5	0	1	1	0
295981	DOCSIS	200405	4	1	0	0	3	2	1	0	10	8	1	4	3	0
295981	DOCSIS	200407	1	0	0	0	1	0	0	0	11	9	1	4	3	0
295981	DOCSIS	200408	4	0	0	0	3	1	0	0	15	12	1	6	4	0
295981	DOCSIS	200409	4	0	0	0	3	1	0	0	19	15	1	7	5	0
295981	DOCSIS	200410	2	0	0	0	1	1	0	0	21	15	1	9	5	0
295981	DOCSIS	200411	2	0	0	0	2	2	0	0	23	17	1	11	7	0
295981	DOCSIS	200412	8	0	0	0	7	3	0	0	31	24	1	15	10	0
295981	DOCSIS	200502	1	0	0	0	1	0	0	0	32	25	1	15	10	0
295981	DOCSIS	200503	2	0	0	0	2	1	0	0	34	27	1	16	11	0
295981	DOCSIS	200504	1	0	0	0	1	0	0	0	35	28	1	16	11	0
295981	DOCSIS	200505	4	0	0	0	3	1	0	0	39	31	1	18	12	0
295981	DOCSIS	200506	5	0	0	0	4	3	0	0	44	34	1	21	14	0
295981	DOCSIS	200507	3	0	0	0	2	1	0	0	47	35	1	23	14	0
295981	DOCSIS	200508	9	0	0	0	8	2	0	0	56	42	1	25	15	0
295981	DOCSIS	200509	6	0	0	0	5	5	0	0	62	46	1	31	19	0
295981	DOCSIS	200510	5	0	0	0	2	0	0	0	67	48	1	31	19	0
295981	DOCSIS	200511	1	0	0	0	1	0	0	0	68	49	1	31	19	0
295981	DOCSIS	200512	21	0	0	0	8	4	0	0	89	57	1	46	23	0
295981	DOCSIS	200601	9	0	0	0	7	4	0	0	98	63	1	52	26	0
295981	DOCSIS	200602	4	1	0	0	4	2	1	0	102	66	2	54	27	0
295981	DOCSIS	200603	7	0	0	0	5	2	0	0	109	71	2	56	29	0
295981	DOCSIS	200604	4	0	0	0	4	1	0	0	113	75	2	57	30	0
295981	DOCSIS	200605	4	0	0	0	4	2	0	0	117	77	2	59	30	0
295981	DOCSIS	200606	1	0	0	0	1	1	0	0	118	78	2	60	31	0
295981	DOCSIS	200607	9	0	0	0	5	4	0	0	127	83	2	68	35	0
295981	DOCSIS	200608	14	0	0	0	9	4	0	0	141	91	2	75	39	0
295981	DOCSIS	200609	18	0	0	0	14	7	0	0	159	104	2	86	45	0
295981	DOCSIS	200610	18	0	0	0	11	5	0	0	177	113	2	95	48	0
295981	DOCSIS	200611	13	0	0	0	9	2	0	0	190	121	2	100	49	0
295981	DOCSIS	200612	26	0	0	0	19	1	0	0	216	140	2	102	50	0
295981	DOCSIS	200701	13	0	0	0	9	4	0	0	229	148	2	106	53	0
295981	DOCSIS	200702	15	0	0	0	12	4	0	0	244	160	2	112	57	0
295981	DOCSIS	200703	19	0	0	0	11	6	0	0	263	170	2	124	62	0
295981	DOCSIS	200704	23	0	0	0	12	8	0	0	286	181	2	142	69	0
295981	DOCSIS	200705	18	0	0	0	14	2	0	0	304	194	2	144	71	0
295981	DOCSIS	200706	28	0	0	0	22	9	0	0	332	213	2	156	78	0
295981	DOCSIS	200707	11	0	0	0	6	3	0	0	343	218	2	159	81	0
295981	DOCSIS	200708	20	2	0	0	15	7	2	0	363	232	4	169	87	0
295981	DOCSIS	200709	9	0	0	0	8	4	0	0	372	239	4	173	90	0
295981	DOCSIS	200710	15	0	0	0	10	3	0	0	387	247	4	178	91	0
295981	DOCSIS	200711	27	1	0	0	18	5	1	0	414	263	5	186	94	0
295981	DOCSIS	200712	21	0	0	0	14	3	0	0	435	275	5	189	97	0
295981	DOCSIS	200801	14	0	0	0	8	3	0	0	449	281	5	193	99	0
295981	DOCSIS	200802	11	5	0	0	9	2	4	0	460	289	10	196	100	0
295981	DOCSIS	200803	5	0	0	0	3	0	0	0	465	292	10	196	100	0
295981	DOCSIS	200804	4	0	0	0	3	2	0	0	469	295	10	198	102	0
295981	DOCSIS	200805	2	0	0	0	2	0	0	0	471	297	10	198	102	0
295981	DOCSIS	200806	4	0	0	0	3	2	0	0	475	300	10	200	104	0
295981	DOCSIS	200807	10	1	0	0	7	2	1	0	485	306	11	202	105	0
295981	DOCSIS	200808	2	0	0	0	2	2	0	0	487	306	11	204	105	0
295981	DOCSIS	200809	3	1	0	0	3	2	1	0	490	307	12	206	106	0
295981	DOCSIS	200810	2	0	0	0	2	2	0	0	492	308	12	208	107	0
295981	DOCSIS	200811	9	1	0	0	7	3	1	0	501	314	13	211	110	1
295981	DOCSIS	200812	1	0	0	0	1	1	0	0	502	315	13	212	111	1
295981	DOCSIS	200903	5	0	0	0	2	1	0	0	507	317	13	215	112	1
295981	DOCSIS	200904	5	0	0	0	4	1	0	0	512	321	13	216	113	1
295981	DOCSIS	200905	8	1	0	0	8	3	1	0	520	329	14	219	116	1
295981	DOCSIS	200907	6	0	0	0	4	1	0	0	526	332	14	220	117	1
295981	DOCSIS	200908	4	0	0	0	4	3	0	0	530	336	14	223	120	1
295981	DOCSIS	200909	3	0	0	0	3	1	0	0	533	339	14	224	121	1
295981	DOCSIS	200910	16	1	0	0	7	5	1	0	549	344	15	232	124	1
295981	DOCSIS	200911	1	0	0	0	1	1	0	0	550	345	15	233	125	1
295981	DOCSIS	200912	8	0	0	0	7	4	0	0	558	351	15	237	128	1
295981	DOCSIS	201001	2	0	0	0	2	2	0	0	560	352	15	239	129	1
295981	DOCSIS	201002	2	0	0	0	2	0	0	0	562	354	15	239	129	1
295981	DOCSIS	201003	9	0	0	0	4	2	0	0	571	357	15	246	130	1
295981	DOCSIS	201004	2	0	0	0	2	2	0	0	573	359	15	248	132	1
295981	DOCSIS	201005	3	0	0	0	2	1	0	0	576	361	15	250	133	1
295981	DOCSIS	201006	2	0	0	0	2	1	0	0	578	363	15	251	134	1
295981	DOCSIS	201007	6	2	0	0	3	1	1	0	584	366	17	253	135	1
295981	DOCSIS	201010	6	0	0	0	5	5	0	0	590	370	17	259	139	1
295981	DOCSIS	201011	4	0	0	0	4	3	0	0	594	373	17	262	141	1
295981	DOCSIS	201012	3	0	0	0	2	1	0	0	597	375	17	264	142	1
295981	DOCSIS	201101	2	0	0	0	2	1	0	0	599	377	17	265	143	1
295981	DOCSIS	201102	1	0	0	0	1	0	0	0	600	377	17	265	143	1
295981	DOCSIS	201103	4	1	0	0	3	2	1	0	604	379	18	268	144	1
295981	DOCSIS	201104	3	0	0	0	2	2	0	0	607	381	18	271	146	1
295981	DOCSIS	201105	7	0	0	0	3	3	0	0	614	383	18	278	148	1
295981	DOCSIS	201106	4	0	0	0	2	0	0	0	618	384	18	278	148	1
295981	DOCSIS	201107	4	1	0	0	3	0	1	0	622	387	19	278	148	1
295981	DOCSIS	201109	4	0	0	0	4	3	0	0	626	391	19	281	151	1
295981	DOCSIS	201111	4	1	0	0	3	1	1	0	630	394	20	283	152	1
295981	DOCSIS	201112	14	1	0	0	8	4	1	0	644	400	21	290	155	1
295981	DOCSIS	201201	1	0	0	0	1	0	0	0	645	401	21	290	155	1
295981	DOCSIS	201202	2	0	0	0	1	0	0	0	647	402	21	290	155	1
295981	DOCSIS	201204	4	0	0	0	4	4	0	0	651	405	21	294	158	1
295981	DOCSIS	201205	1	0	0	0	1	1	0	0	652	406	21	295	159	1
295981	DOCSIS	201206	11	0	0	0	5	2	0	0	663	411	21	297	161	1
295981	DOCSIS	201207	3	0	0	0	2	1	0	0	666	413	21	299	162	1
295981	DOCSIS	201208	4	0	0	0	3	2	0	0	670	415	21	301	163	1
295981	DOCSIS	201209	3	0	0	0	3	1	0	0	673	417	21	302	163	1
295981	DOCSIS	201211	1	0	0	0	1	1	0	0	674	418	21	303	164	1
295981	DOCSIS	201212	3	0	0	0	3	2	0	0	677	420	21	305	165	1
295981	DOCSIS	201301	4	0	0	0	4	2	0	0	681	423	21	307	166	1
295981	DOCSIS	201302	1	0	0	0	1	1	0	0	682	424	21	308	167	1
295981	DOCSIS	201304	6	1	0	0	5	4	1	0	688	428	22	313	171	1
295981	DOCSIS	201305	7	1	0	0	6	2	1	0	695	432	23	315	172	1
295981	DOCSIS	201306	3	0	0	0	3	1	0	0	698	434	23	316	172	1
295981	DOCSIS	201307	2	0	0	0	2	1	0	0	700	436	23	317	173	1
295981	DOCSIS	201308	1	0	0	0	1	1	0	0	701	437	23	318	174	1
295981	DOCSIS	201309	5	0	0	0	4	2	0	0	706	439	23	320	174	1
295981	DOCSIS	201311	6	1	0	0	5	3	1	0	712	442	24	324	175	1
295981	DOCSIS	201312	1	0	0	0	1	1	0	0	713	443	24	325	176	1
295981	DOCSIS	201401	21	0	0	0	7	6	0	0	734	448	24	344	180	1
295981	DOCSIS	201402	6	0	0	0	4	2	0	0	740	452	24	347	182	1
295981	DOCSIS	201403	2	0	0	0	2	2	0	0	742	454	24	349	184	1
295981	DOCSIS	201404	2	0	0	0	2	2	0	0	744	456	24	351	186	1
295981	DOCSIS	201405	2	0	0	0	2	2	0	0	746	458	24	353	188	1
295981	DOCSIS	201406	1	0	0	0	1	1	0	0	747	459	24	354	189	1
295981	DOCSIS	201407	10	0	0	0	6	3	0	0	757	464	24	357	191	1
295981	DOCSIS	201408	4	0	0	0	4	3	0	0	761	468	24	360	194	1
295981	DOCSIS	201409	8	0	0	0	7	4	0	0	769	474	24	365	197	1
295981	DOCSIS	201410	6	1	0	0	4	2	1	0	775	476	25	369	198	1
295981	DOCSIS	201411	1	0	0	0	1	0	0	0	776	477	25	369	198	1
295981	DOCSIS	201412	1	0	0	0	1	0	0	0	777	478	25	369	198	1
295981	DOCSIS	201502	7	0	0	0	4	2	0	0	784	481	25	371	199	1
295981	DOCSIS	201503	8	1	0	0	8	8	1	0	792	488	26	379	205	2
295981	DOCSIS	201504	3	0	0	0	1	0	0	0	795	489	26	379	205	2
295981	DOCSIS	201505	2	0	0	0	1	1	0	0	797	490	26	381	206	2
295981	DOCSIS	201506	1	0	0	0	1	1	0	0	798	491	26	382	207	2
295981	DOCSIS	201507	5	0	0	0	4	4	0	0	803	494	26	387	210	2
295981	DOCSIS	201508	3	0	0	0	2	2	0	0	806	496	26	390	211	2
295981	DOCSIS	201510	1	0	0	0	1	0	0	0	807	497	26	390	211	2
295981	DOCSIS	201511	4	0	0	0	3	1	0	0	811	499	26	391	211	2
295981	DOCSIS	201512	2	0	0	0	1	1	0	0	813	500	26	393	212	2
295981	DOCSIS	201601	7	0	0	0	5	1	0	0	820	504	26	396	212	2
295981	DOCSIS	201602	1	0	0	0	1	1	0	0	821	505	26	397	213	2
295981	DOCSIS	201603	10	1	0	0	4	3	1	0	831	509	27	406	216	2
295981	DOCSIS	201605	16	0	0	0	3	2	0	0	847	512	27	421	218	2
295981	DOCSIS	201606	1	0	0	0	1	0	0	0	848	513	27	421	218	2
295981	DOCSIS	201607	4	0	0	0	4	4	0	0	852	515	27	425	219	2
295981	DOCSIS	201610	3	0	0	0	2	2	0	0	855	517	27	428	221	2
295981	DOCSIS	201611	1	0	0	0	1	0	0	0	856	518	27	428	221	2
295981	DOCSIS	201612	2	0	0	0	1	1	0	0	858	519	27	430	222	2
295981	DOCSIS	201701	1	0	0	0	1	1	0	0	859	520	27	431	223	2
295981	DOCSIS	201703	2	0	0	0	2	2	0	0	861	522	27	433	225	2
295981	DOCSIS	201705	6	0	0	0	4	3	0	0	867	526	27	438	228	2
295981	DOCSIS	201706	1	0	0	0	1	1	0	0	868	527	27	439	229	2
295981	DOCSIS	201707	13	1	0	0	5	3	1	0	881	530	28	444	230	2
295981	DOCSIS	201708	4	0	0	0	1	1	0	0	885	530	28	448	230	2
295981	DOCSIS	201709	5	0	0	0	3	1	0	0	890	532	28	451	230	2
295981	DOCSIS	201710	1	0	0	0	1	1	0	0	891	532	28	452	230	2
295981	DOCSIS	201711	1	0	0	0	1	0	0	0	892	533	28	452	230	2
295981	DOCSIS	201712	10	0	0	0	5	4	0	0	902	537	28	461	232	2
295981	DOCSIS	201801	4	0	0	0	4	4	0	0	906	541	28	465	236	2
295981	DOCSIS	201803	1	0	0	0	1	1	0	0	907	541	28	466	236	2
295981	DOCSIS	201804	3	0	0	0	2	2	0	0	910	543	28	469	238	2
295981	DOCSIS	201805	1	0	0	0	1	0	0	0	911	544	28	469	238	2
40712897	Dark_web	201409	1	0	0	0	1	1	0	0	1	1	0	1	1	0
40712897	Dark_web	201501	1	0	0	0	1	1	0	0	2	2	0	2	2	0
40712897	Dark_web	201502	1	0	0	0	1	1	0	0	3	3	0	3	3	0
40712897	Dark_web	201503	1	0	0	0	1	1	0	0	4	4	0	4	4	0
40712897	Dark_web	201505	1	0	0	0	1	1	0	0	5	5	0	5	5	0
40712897	Dark_web	201506	12	1	0	0	2	2	1	0	17	6	1	17	6	1
40712897	Dark_web	201507	71	4	0	0	14	8	3	0	88	18	5	79	11	2
40712897	Dark_web	201508	13	1	0	0	5	4	1	0	101	21	6	91	13	2
40712897	Dark_web	201509	42	4	0	0	14	12	3	0	143	32	10	130	21	5
40712897	Dark_web	201510	43	9	2	1	18	10	6	2	186	47	19	163	27	10
40712897	Dark_web	201511	32	10	0	0	18	12	8	0	218	63	29	178	37	11
40712897	Dark_web	201512	51	6	0	0	16	12	4	0	269	76	35	222	45	13
40712897	Dark_web	201601	30	1	0	0	5	3	1	0	299	79	36	250	46	13
40712897	Dark_web	201602	38	9	0	0	17	12	3	0	337	90	45	281	51	17
40712897	Dark_web	201603	12	3	0	0	10	7	2	0	349	98	48	290	55	19
40712897	Dark_web	201604	15	2	0	0	6	5	2	0	364	101	50	304	56	21
40712897	Dark_web	201605	27	9	0	0	20	11	8	0	391	118	59	316	63	21
40712897	Dark_web	201606	14	5	0	0	10	6	4	0	405	125	64	324	65	21
40712897	Dark_web	201607	20	4	0	0	11	9	3	0	425	134	68	342	70	24
40712897	Dark_web	201608	11	3	0	0	9	6	1	0	436	141	71	350	73	25
40712897	Dark_web	201609	7	2	0	0	6	3	2	0	443	145	73	354	74	25
40712897	Dark_web	201610	18	7	1	0	10	7	5	1	461	152	80	367	78	29
40712897	Dark_web	201611	46	15	0	0	26	14	10	0	507	174	95	398	87	33
40712897	Dark_web	201612	40	8	0	0	22	17	5	0	547	189	103	433	97	38
40712897	Dark_web	201701	53	16	0	0	34	21	8	0	600	219	119	471	113	40
40712897	Dark_web	201702	16	2	0	0	8	4	2	0	616	224	121	481	114	40
40712897	Dark_web	201703	32	13	0	0	28	16	10	0	648	250	134	501	128	43
40712897	Dark_web	201704	31	9	0	0	23	14	7	0	679	268	143	521	135	46
40712897	Dark_web	201705	17	3	0	0	13	6	2	0	696	278	146	530	138	46
40712897	Dark_web	201706	41	13	0	0	29	18	11	0	737	303	159	553	151	50
40712897	Dark_web	201707	35	10	0	0	26	15	6	0	772	322	169	576	157	54
40712897	Dark_web	201708	39	12	0	0	31	22	9	0	811	347	181	603	168	61
40712897	Dark_web	201709	46	11	0	0	34	20	10	0	857	376	192	630	180	62
40712897	Dark_web	201710	50	16	0	0	41	30	13	0	907	411	208	669	203	71
40712897	Dark_web	201711	53	22	0	0	42	26	16	0	960	444	230	705	217	79
40712897	Dark_web	201712	40	18	0	0	32	19	13	0	1000	467	248	729	223	83
40712897	Dark_web	201801	29	10	0	0	25	16	8	0	1029	487	258	749	232	85
40712897	Dark_web	201802	38	19	1	0	33	19	15	1	1067	512	277	772	242	90
40712897	Dark_web	201803	39	12	0	0	31	19	10	0	1106	536	289	798	252	92
40712897	Dark_web	201804	35	15	0	0	30	20	12	0	1141	560	304	823	264	98
40712897	Dark_web	201805	28	12	0	0	25	15	11	0	1169	577	316	840	269	100
40712897	Dark_web	201806	42	19	0	0	36	21	15	0	1211	606	335	866	282	104
40712897	Dark_web	201807	30	14	0	0	22	14	8	0	1241	623	349	886	289	108
39062059	Data_Plane_Development_Kit	201305	5	0	0	0	3	3	0	0	5	3	0	5	3	0
39062059	Data_Plane_Development_Kit	201306	1	0	0	0	1	0	0	0	6	4	0	5	3	0
39062059	Data_Plane_Development_Kit	201307	21	1	0	0	7	5	1	0	27	10	1	24	7	1
39062059	Data_Plane_Development_Kit	201308	12	0	0	0	4	2	0	0	39	13	1	32	8	1
39062059	Data_Plane_Development_Kit	201309	1	0	0	0	1	1	0	0	40	13	1	33	8	1
39062059	Data_Plane_Development_Kit	201310	2	0	0	0	2	0	0	0	42	13	1	33	8	1
39062059	Data_Plane_Development_Kit	201311	1	0	0	0	1	0	0	0	43	13	1	33	8	1
39062059	Data_Plane_Development_Kit	201401	2	0	0	0	1	0	0	0	45	13	1	33	8	1
39062059	Data_Plane_Development_Kit	201402	6	0	0	0	3	2	0	0	51	14	1	36	9	1
39062059	Data_Plane_Development_Kit	201403	2	0	0	0	2	1	0	0	53	14	1	37	9	1
39062059	Data_Plane_Development_Kit	201405	4	0	0	0	3	3	0	0	57	15	1	41	10	1
39062059	Data_Plane_Development_Kit	201407	3	0	0	0	3	2	0	0	60	17	1	43	11	1
39062059	Data_Plane_Development_Kit	201409	1	0	0	0	1	0	0	0	61	18	1	43	11	1
39062059	Data_Plane_Development_Kit	201410	1	0	0	0	1	0	0	0	62	18	1	43	11	1
39062059	Data_Plane_Development_Kit	201411	3	0	0	0	2	1	0	0	65	19	1	45	11	1
39062059	Data_Plane_Development_Kit	201412	1	0	0	0	1	0	0	0	66	20	1	45	11	1
39062059	Data_Plane_Development_Kit	201501	1	0	0	0	1	0	0	0	67	21	1	45	11	1
39062059	Data_Plane_Development_Kit	201503	1	0	0	0	1	0	0	0	68	22	1	45	11	1
39062059	Data_Plane_Development_Kit	201504	2	0	0	0	2	2	0	0	70	24	1	47	13	1
39062059	Data_Plane_Development_Kit	201505	6	0	0	0	3	2	0	0	76	25	1	51	14	1
39062059	Data_Plane_Development_Kit	201508	3	0	0	0	3	1	0	0	79	27	1	52	14	1
39062059	Data_Plane_Development_Kit	201509	2	0	0	0	2	0	0	0	81	29	1	52	14	1
39062059	Data_Plane_Development_Kit	201510	1	0	0	0	1	1	0	0	82	30	1	53	15	1
39062059	Data_Plane_Development_Kit	201512	2	0	0	0	1	0	0	0	84	31	1	53	15	1
39062059	Data_Plane_Development_Kit	201604	1	0	0	0	1	0	0	0	85	32	1	53	15	1
39062059	Data_Plane_Development_Kit	201605	2	0	0	0	2	0	0	0	87	34	1	53	15	1
39062059	Data_Plane_Development_Kit	201606	1	0	0	0	1	1	0	0	88	35	1	54	16	1
39062059	Data_Plane_Development_Kit	201607	3	0	0	0	3	3	0	0	91	35	1	57	16	1
39062059	Data_Plane_Development_Kit	201609	1	0	0	0	1	0	0	0	92	36	1	57	16	1
39062059	Data_Plane_Development_Kit	201610	1	0	0	0	1	1	0	0	93	37	1	58	17	1
39062059	Data_Plane_Development_Kit	201611	1	0	0	0	1	0	0	0	94	38	1	58	17	1
39062059	Data_Plane_Development_Kit	201612	2	0	0	0	2	0	0	0	96	40	1	58	17	1
39062059	Data_Plane_Development_Kit	201702	9	0	0	0	2	2	0	0	105	42	1	67	19	1
39062059	Data_Plane_Development_Kit	201703	2	0	0	0	2	0	0	0	107	43	1	67	19	1
39062059	Data_Plane_Development_Kit	201704	2	0	0	0	2	2	0	0	109	44	1	69	20	1
39062059	Data_Plane_Development_Kit	201705	1	0	0	0	1	1	0	0	110	45	1	70	21	1
39062059	Data_Plane_Development_Kit	201706	2	0	0	0	2	1	0	0	112	46	1	71	22	1
39062059	Data_Plane_Development_Kit	201707	3	0	0	0	3	2	0	0	115	49	1	73	23	1
39062059	Data_Plane_Development_Kit	201708	1	0	0	0	1	1	0	0	116	50	1	74	24	1
39062059	Data_Plane_Development_Kit	201709	1	0	0	0	1	0	0	0	117	51	1	74	24	1
39062059	Data_Plane_Development_Kit	201710	3	0	0	0	3	3	0	0	120	54	1	77	26	1
39062059	Data_Plane_Development_Kit	201711	1	0	0	0	1	1	0	0	121	55	1	78	27	1
39062059	Data_Plane_Development_Kit	201712	2	0	0	0	1	0	0	0	123	56	1	78	27	1
39062059	Data_Plane_Development_Kit	201801	1	0	0	0	1	1	0	0	124	57	1	79	27	1
39062059	Data_Plane_Development_Kit	201802	19	4	1	0	14	5	2	1	143	71	5	87	32	3
39062059	Data_Plane_Development_Kit	201804	3	1	0	0	3	1	1	0	146	72	6	88	32	3
39062059	Data_Plane_Development_Kit	201805	2	0	0	0	2	1	0	0	148	73	6	89	32	3
39062059	Data_Plane_Development_Kit	201806	2	0	0	0	2	1	0	0	150	74	6	90	33	3
10186403	Data_aggregation	200704	4	0	0	0	4	3	0	0	4	4	0	3	3	0
10186403	Data_aggregation	200804	11	0	0	0	1	1	0	0	15	5	0	14	4	0
10186403	Data_aggregation	200806	3	0	0	0	1	1	0	0	18	6	0	17	5	0
10186403	Data_aggregation	200908	1	0	0	0	1	1	0	0	19	7	0	18	6	0
10186403	Data_aggregation	201010	1	0	0	0	1	1	0	0	20	8	0	19	7	0
10186403	Data_aggregation	201101	1	0	0	0	1	1	0	0	21	9	0	20	8	0
10186403	Data_aggregation	201110	1	0	0	0	1	1	0	0	22	10	0	21	9	0
10186403	Data_aggregation	201206	1	0	0	0	1	1	0	0	23	11	0	22	10	0
10186403	Data_aggregation	201207	1	0	0	0	1	0	0	0	24	12	0	22	10	0
10186403	Data_aggregation	201208	4	3	0	0	4	2	3	0	28	16	3	24	12	1
10186403	Data_aggregation	201211	2	0	0	0	1	0	0	0	30	17	3	24	12	1
10186403	Data_aggregation	201311	1	0	0	0	1	0	0	0	31	18	3	24	12	1
10186403	Data_aggregation	201401	2	0	0	0	1	0	0	0	33	19	3	24	12	1
10186403	Data_aggregation	201405	1	0	0	0	1	1	0	0	34	20	3	25	13	1
10186403	Data_aggregation	201411	1	0	0	0	1	1	0	0	35	21	3	26	14	1
10186403	Data_aggregation	201503	1	0	0	0	1	1	0	0	36	22	3	27	15	1
10186403	Data_aggregation	201504	2	0	0	0	1	1	0	0	38	23	3	29	16	1
10186403	Data_aggregation	201505	2	0	0	0	2	2	0	0	40	25	3	31	18	1
10186403	Data_aggregation	201605	1	0	0	0	1	1	0	0	41	26	3	32	19	1
10186403	Data_aggregation	201608	1	0	0	0	1	1	0	0	42	27	3	33	20	1
10186403	Data_aggregation	201609	6	2	0	0	3	2	2	0	48	30	5	35	22	1
10186403	Data_aggregation	201612	10	2	0	0	3	2	2	0	58	32	7	37	24	1
10186403	Data_aggregation	201709	2	0	0	0	2	2	0	0	60	34	7	39	26	1
10186403	Data_aggregation	201804	1	0	0	0	1	0	0	0	61	35	7	39	26	1
2720954	Data_analysis	200511	4	0	0	0	1	1	0	0	4	1	0	4	1	0
2720954	Data_analysis	200601	3	1	0	0	3	2	1	0	7	4	1	6	3	0
2720954	Data_analysis	200602	1	0	0	0	1	0	0	0	8	5	1	6	3	0
2720954	Data_analysis	200603	2	1	0	0	1	0	1	0	10	6	2	6	3	0
2720954	Data_analysis	200605	1	0	0	0	1	1	0	0	11	7	2	7	4	0
2720954	Data_analysis	200607	2	0	0	0	2	0	0	0	13	9	2	7	4	0
2720954	Data_analysis	200608	1	0	0	0	1	1	0	0	14	10	2	8	5	0
2720954	Data_analysis	200610	10	0	0	0	4	4	0	0	24	13	2	18	8	0
2720954	Data_analysis	200611	4	1	0	0	2	1	1	0	28	15	3	19	9	0
2720954	Data_analysis	200612	2	0	0	0	1	0	0	0	30	16	3	19	9	0
2720954	Data_analysis	200701	3	0	0	0	3	1	0	0	33	19	3	20	10	0
2720954	Data_analysis	200702	4	1	0	0	4	1	1	0	37	23	4	21	11	0
2720954	Data_analysis	200703	3	0	0	0	2	2	0	0	40	25	4	24	13	0
2720954	Data_analysis	200704	11	1	0	0	5	4	1	0	51	30	5	33	17	1
2720954	Data_analysis	200705	12	0	0	0	5	3	0	0	63	35	5	42	20	1
2720954	Data_analysis	200706	7	1	0	0	4	3	1	0	70	38	6	48	22	1
2720954	Data_analysis	200707	8	1	0	0	5	3	1	0	78	42	7	52	24	1
2720954	Data_analysis	200708	12	3	0	0	9	5	2	0	90	49	10	58	27	1
2720954	Data_analysis	200709	4	1	0	0	4	2	1	0	94	53	11	60	29	1
2720954	Data_analysis	200710	6	1	0	0	3	1	1	0	100	55	12	62	29	1
2720954	Data_analysis	200711	1	0	0	0	1	0	0	0	101	56	12	62	29	1
2720954	Data_analysis	200712	8	1	0	0	6	4	1	0	109	62	13	67	33	1
2720954	Data_analysis	200801	4	2	0	0	4	2	2	0	113	65	15	69	34	1
2720954	Data_analysis	200802	3	1	0	0	3	2	1	0	116	67	16	71	35	1
2720954	Data_analysis	200803	2	1	0	0	2	1	1	0	118	69	17	72	36	1
2720954	Data_analysis	200804	2	1	0	0	2	1	1	0	120	71	18	73	37	1
2720954	Data_analysis	200805	1	0	0	0	1	1	0	0	121	72	18	74	38	1
2720954	Data_analysis	200806	2	0	0	0	2	2	0	0	123	74	18	76	40	1
2720954	Data_analysis	200807	3	0	0	0	2	1	0	0	126	76	18	77	41	1
2720954	Data_analysis	200808	2	0	0	0	2	1	0	0	128	78	18	78	42	1
2720954	Data_analysis	200809	2	1	0	0	2	1	1	0	130	80	19	79	43	1
2720954	Data_analysis	200810	10	2	0	0	9	3	2	0	140	89	21	82	46	1
2720954	Data_analysis	200812	21	1	0	0	6	3	1	0	161	95	22	86	49	1
2720954	Data_analysis	200901	7	1	0	0	6	5	1	0	168	100	23	92	53	1
2720954	Data_analysis	200902	6	2	0	0	5	2	2	0	174	105	25	94	55	1
2720954	Data_analysis	200903	17	7	0	0	13	7	6	0	191	117	32	102	61	1
2720954	Data_analysis	200904	5	1	0	0	5	2	1	0	196	122	33	104	63	1
2720954	Data_analysis	200905	6	2	0	0	4	3	2	0	202	126	35	109	66	3
2720954	Data_analysis	200906	2	0	0	0	2	1	0	0	204	128	35	110	67	3
2720954	Data_analysis	200907	6	3	0	0	6	4	3	0	210	132	38	114	69	4
2720954	Data_analysis	200908	3	1	0	0	3	1	1	0	213	134	39	115	69	4
2720954	Data_analysis	200909	2	1	0	0	2	1	1	0	215	136	40	116	70	4
2720954	Data_analysis	200911	6	0	0	0	4	2	0	0	221	140	40	120	72	4
2720954	Data_analysis	200912	1	0	0	0	1	1	0	0	222	141	40	121	73	4
2720954	Data_analysis	201001	59	0	0	0	5	2	0	0	281	146	40	134	75	4
2720954	Data_analysis	201002	12	2	0	0	9	6	2	0	293	153	42	141	79	4
2720954	Data_analysis	201003	6	1	0	0	5	2	1	0	299	158	43	143	81	4
2720954	Data_analysis	201004	2	0	0	0	1	0	0	0	301	159	43	143	81	4
2720954	Data_analysis	201005	9	2	0	0	8	2	2	0	310	166	45	146	82	4
2720954	Data_analysis	201006	7	2	0	0	4	3	2	0	317	170	47	149	85	4
2720954	Data_analysis	201007	8	3	0	0	7	4	2	0	325	175	50	154	87	4
2720954	Data_analysis	201008	1	0	0	0	1	0	0	0	326	176	50	154	87	4
2720954	Data_analysis	201009	7	2	0	0	6	4	2	0	333	181	52	159	90	4
2720954	Data_analysis	201010	13	5	0	0	13	8	5	0	346	192	57	167	96	4
2720954	Data_analysis	201011	11	3	0	0	9	4	3	0	357	201	60	172	100	4
2720954	Data_analysis	201012	16	5	0	0	9	6	4	0	373	209	65	180	105	5
2720954	Data_analysis	201101	12	1	0	0	4	2	1	0	385	213	66	190	107	5
2720954	Data_analysis	201102	2	0	0	0	2	2	0	0	387	215	66	192	109	5
2720954	Data_analysis	201103	6	1	0	0	4	0	1	0	393	219	67	192	109	5
2720954	Data_analysis	201105	7	0	0	0	4	2	0	0	400	222	67	197	110	5
2720954	Data_analysis	201106	14	1	0	0	8	4	1	0	414	229	68	206	113	5
2720954	Data_analysis	201107	1	0	0	0	1	1	0	0	415	230	68	207	114	5
2720954	Data_analysis	201108	4	2	0	0	4	3	2	0	419	233	70	210	116	6
2720954	Data_analysis	201109	9	1	0	0	8	5	1	0	428	238	71	215	118	7
2720954	Data_analysis	201111	5	1	0	0	4	3	1	0	433	240	72	219	119	7
2720954	Data_analysis	201201	4	1	0	0	4	2	1	0	437	243	73	221	120	7
2720954	Data_analysis	201202	5	2	0	0	5	2	2	0	442	247	75	223	121	7
2720954	Data_analysis	201204	7	1	0	0	5	3	1	0	449	251	76	227	123	7
2720954	Data_analysis	201205	3	1	0	0	3	2	1	0	452	252	77	229	123	7
2720954	Data_analysis	201206	6	2	0	0	6	4	2	0	458	256	79	233	125	7
2720954	Data_analysis	201207	10	3	0	0	6	4	2	0	468	260	82	240	127	8
2720954	Data_analysis	201208	2	0	0	0	2	2	0	0	470	262	82	242	129	8
2720954	Data_analysis	201209	2	1	0	0	2	1	1	0	472	264	83	243	130	8
2720954	Data_analysis	201210	7	2	0	0	7	4	2	0	479	269	85	247	132	8
2720954	Data_analysis	201211	7	1	0	0	5	3	1	0	486	274	86	251	135	8
2720954	Data_analysis	201212	9	2	0	0	6	3	2	0	495	279	88	256	137	8
2720954	Data_analysis	201301	2	1	0	0	2	1	1	0	497	281	89	257	138	8
2720954	Data_analysis	201302	6	2	0	0	6	3	2	0	503	286	91	260	140	8
2720954	Data_analysis	201303	8	1	0	0	6	3	1	0	511	291	92	264	142	9
2720954	Data_analysis	201304	12	4	0	0	9	5	3	0	523	300	96	271	147	12
2720954	Data_analysis	201305	10	1	0	0	8	4	1	0	533	308	97	276	151	12
2720954	Data_analysis	201306	11	1	0	0	7	4	1	0	544	314	98	280	154	13
2720954	Data_analysis	201307	10	2	0	0	10	4	2	0	554	324	100	284	158	14
2720954	Data_analysis	201308	10	0	0	0	5	1	0	0	564	329	100	287	159	14
2720954	Data_analysis	201309	8	0	0	0	6	5	0	0	572	333	100	294	162	14
2720954	Data_analysis	201310	3	0	0	0	3	2	0	0	575	335	100	296	163	14
2720954	Data_analysis	201311	10	2	0	0	8	7	2	0	585	340	102	304	167	15
2720954	Data_analysis	201312	16	4	0	0	10	4	3	0	601	348	106	311	169	15
2720954	Data_analysis	201401	7	2	0	0	6	3	2	0	608	352	108	314	170	15
2720954	Data_analysis	201402	8	0	0	0	5	1	0	0	616	357	108	317	171	15
2720954	Data_analysis	201403	19	1	0	0	8	4	1	0	635	364	109	325	174	15
2720954	Data_analysis	201404	11	2	0	0	7	2	1	0	646	370	111	329	175	16
2720954	Data_analysis	201405	12	5	0	0	8	4	3	0	658	377	116	335	178	16
2720954	Data_analysis	201406	1	0	0	0	1	1	0	0	659	377	116	336	178	16
2720954	Data_analysis	201407	3	1	0	0	3	1	1	0	662	379	117	337	178	16
2720954	Data_analysis	201408	2	1	0	0	2	1	1	0	664	381	118	338	179	16
2720954	Data_analysis	201409	1	0	0	0	1	1	0	0	665	382	118	339	180	16
2720954	Data_analysis	201410	9	2	0	0	7	3	2	0	674	387	120	343	181	16
2720954	Data_analysis	201411	53	1	0	0	4	2	1	0	727	389	121	394	181	16
2720954	Data_analysis	201412	23	1	0	0	5	3	1	0	750	393	122	415	183	16
2720954	Data_analysis	201501	3	1	0	0	3	1	1	0	753	395	123	416	183	16
2720954	Data_analysis	201502	4	1	0	0	3	2	1	0	757	396	124	419	183	16
2720954	Data_analysis	201503	3	1	0	0	2	2	1	0	760	398	125	422	185	17
2720954	Data_analysis	201504	2	1	0	0	2	1	1	0	762	399	126	423	185	17
2720954	Data_analysis	201505	6	2	0	0	4	2	2	0	768	402	128	427	186	17
2720954	Data_analysis	201506	10	1	0	0	9	7	1	0	778	409	129	435	191	17
2720954	Data_analysis	201507	10	1	0	0	5	3	1	0	788	413	130	443	193	17
2720954	Data_analysis	201508	8	0	0	0	4	2	0	0	796	417	130	445	195	17
2720954	Data_analysis	201509	7	3	0	0	6	4	2	0	803	421	133	450	197	18
2720954	Data_analysis	201510	3	1	0	0	2	1	1	0	806	422	134	451	197	18
2720954	Data_analysis	201511	4	2	0	0	4	2	2	0	810	425	136	453	198	18
2720954	Data_analysis	201512	11	3	0	0	8	4	3	0	821	432	139	457	201	19
2720954	Data_analysis	201601	9	1	0	0	6	3	1	0	830	437	140	462	203	19
2720954	Data_analysis	201602	2	0	0	0	2	2	0	0	832	439	140	464	205	19
2720954	Data_analysis	201604	2	1	0	0	2	1	1	0	834	440	141	465	205	19
2720954	Data_analysis	201605	1	0	0	0	1	1	0	0	835	441	141	466	206	19
2720954	Data_analysis	201606	6	0	0	0	4	2	0	0	841	445	141	468	208	19
2720954	Data_analysis	201607	4	2	0	0	4	2	2	0	845	449	143	470	210	19
2720954	Data_analysis	201608	7	1	0	0	6	3	1	0	852	453	144	473	211	19
2720954	Data_analysis	201609	6	0	0	0	5	4	0	0	858	457	144	477	213	19
2720954	Data_analysis	201610	6	2	0	0	6	2	2	0	864	462	146	479	214	19
2720954	Data_analysis	201611	4	1	0	0	3	2	1	0	868	465	147	481	215	20
2720954	Data_analysis	201612	15	3	0	0	10	7	3	0	883	472	150	493	219	20
2720954	Data_analysis	201702	5	1	0	0	5	3	1	0	888	476	151	496	221	20
2720954	Data_analysis	201703	7	2	0	0	6	2	2	0	895	482	153	498	223	20
2720954	Data_analysis	201704	7	0	0	0	4	3	0	0	902	485	153	504	225	20
2720954	Data_analysis	201705	7	2	0	0	5	3	2	0	909	488	155	509	226	20
2720954	Data_analysis	201706	8	3	0	0	7	4	3	0	917	493	158	513	227	21
2720954	Data_analysis	201707	10	2	0	0	9	7	2	0	927	500	160	521	230	22
2720954	Data_analysis	201708	3	0	0	0	3	1	0	0	930	503	160	522	231	22
2720954	Data_analysis	201709	8	2	0	0	6	4	2	0	938	508	162	528	233	23
2720954	Data_analysis	201710	14	0	0	0	8	4	0	0	952	515	162	532	236	23
2720954	Data_analysis	201711	2	1	0	0	2	1	1	0	954	516	163	533	236	23
2720954	Data_analysis	201712	11	3	0	0	8	6	3	0	965	523	166	541	240	23
2720954	Data_analysis	201801	17	5	0	0	10	8	5	0	982	530	171	555	244	25
2720954	Data_analysis	201802	9	4	0	0	8	5	3	0	991	535	175	561	245	26
2720954	Data_analysis	201803	6	1	0	0	3	1	1	0	997	537	176	562	245	26
2720954	Data_analysis	201804	24	4	0	0	7	5	3	0	1021	541	180	583	247	27
2720954	Data_analysis	201805	5	2	0	0	5	2	2	0	1026	544	182	585	247	27
2720954	Data_analysis	201806	1	0	0	0	1	1	0	0	1027	545	182	586	248	27
579730	Data_center	200407	1	0	0	0	1	1	0	0	1	1	0	1	1	0
579730	Data_center	200408	8	0	0	0	3	1	0	0	9	4	0	5	2	0
579730	Data_center	200409	2	0	0	0	1	1	0	0	11	5	0	7	3	0
579730	Data_center	200410	3	0	0	0	1	1	0	0	14	6	0	10	4	0
579730	Data_center	200412	4	1	0	0	3	1	1	0	18	9	1	11	5	0
579730	Data_center	200501	2	0	0	0	2	1	0	0	20	11	1	12	6	0
579730	Data_center	200502	1	0	0	0	1	1	0	0	21	12	1	13	7	0
579730	Data_center	200503	2	0	0	0	2	1	0	0	23	14	1	14	8	0
579730	Data_center	200505	1	0	0	0	1	1	0	0	24	15	1	15	9	0
579730	Data_center	200506	2	0	0	0	2	2	0	0	26	17	1	17	11	0
579730	Data_center	200507	6	1	0	0	5	2	1	0	32	22	2	19	13	0
579730	Data_center	200508	11	0	0	0	6	1	0	0	43	27	2	25	14	0
579730	Data_center	200510	3	0	0	0	3	0	0	0	46	29	2	25	14	0
579730	Data_center	200511	3	0	0	0	3	2	0	0	49	32	2	27	16	0
579730	Data_center	200512	11	0	0	0	9	4	0	0	60	41	2	33	20	0
579730	Data_center	200601	7	2	0	0	5	3	2	0	67	45	4	36	22	0
579730	Data_center	200602	10	2	0	0	9	3	2	0	77	54	6	39	25	0
579730	Data_center	200603	5	1	0	0	5	5	1	0	82	58	7	44	29	1
579730	Data_center	200604	7	0	0	0	6	4	0	0	89	64	7	49	33	1
579730	Data_center	200605	7	0	0	0	6	4	0	0	96	70	7	53	37	1
579730	Data_center	200606	5	0	0	0	3	2	0	0	101	72	7	55	39	1
579730	Data_center	200607	14	4	0	0	10	4	4	0	115	81	11	60	42	1
579730	Data_center	200608	4	1	0	0	4	0	1	0	119	84	12	60	42	1
579730	Data_center	200609	4	2	0	0	4	4	2	0	123	87	14	64	45	3
579730	Data_center	200610	8	0	0	0	7	6	0	0	131	94	14	70	51	3
579730	Data_center	200611	11	1	0	0	10	5	1	0	142	104	15	75	56	4
579730	Data_center	200612	9	2	0	0	7	4	2	0	151	110	17	81	59	4
579730	Data_center	200701	2	0	0	0	2	2	0	0	153	112	17	83	61	4
579730	Data_center	200702	4	0	0	0	4	2	0	0	157	116	17	85	63	4
579730	Data_center	200703	15	1	0	0	13	10	1	0	172	128	18	97	72	4
579730	Data_center	200704	24	3	0	0	15	9	3	0	196	141	21	108	79	5
579730	Data_center	200705	8	0	0	0	7	4	0	0	204	147	21	113	82	5
579730	Data_center	200706	10	0	0	0	8	5	0	0	214	154	21	118	86	5
579730	Data_center	200707	21	1	0	0	8	4	1	0	235	162	22	130	90	5
579730	Data_center	200708	19	5	2	1	7	6	4	2	254	168	27	147	95	10
579730	Data_center	200709	7	2	0	0	6	2	2	0	261	173	29	149	96	10
579730	Data_center	200710	19	1	0	0	13	9	1	0	280	186	30	164	105	10
579730	Data_center	200711	7	0	0	0	5	3	0	0	287	191	30	168	108	10
579730	Data_center	200712	7	0	0	0	5	5	0	0	294	196	30	175	113	10
579730	Data_center	200801	3	0	0	0	3	2	0	0	297	199	30	177	115	10
579730	Data_center	200802	11	1	0	0	9	3	1	0	308	207	31	180	117	10
579730	Data_center	200803	3	1	0	0	3	2	1	0	311	209	32	182	118	10
579730	Data_center	200804	7	0	0	0	5	3	0	0	318	214	32	185	121	10
579730	Data_center	200805	9	2	0	0	8	6	2	0	327	222	34	192	127	11
579730	Data_center	200806	12	1	0	0	8	4	1	0	339	229	35	196	130	11
579730	Data_center	200807	13	0	0	0	9	8	0	0	352	236	35	208	136	11
579730	Data_center	200808	14	2	0	0	8	5	2	0	366	242	37	215	139	11
579730	Data_center	200809	8	0	0	0	7	3	0	0	374	247	37	219	141	11
579730	Data_center	200810	21	0	0	0	11	7	0	0	395	258	37	233	148	11
579730	Data_center	200811	14	3	0	0	9	4	3	0	409	265	40	240	150	11
579730	Data_center	200812	8	1	0	0	6	6	1	0	417	268	41	248	153	12
579730	Data_center	200901	10	3	0	0	10	9	3	0	427	273	44	257	158	14
579730	Data_center	200902	9	2	0	0	8	3	2	0	436	280	46	261	160	16
579730	Data_center	200903	4	0	0	0	4	2	0	0	440	283	46	263	161	16
579730	Data_center	200904	9	3	0	0	9	6	3	0	449	289	49	269	164	18
579730	Data_center	200905	9	2	0	0	8	4	2	0	458	296	51	273	167	18
579730	Data_center	200906	20	3	0	0	14	8	3	0	478	305	54	282	171	18
579730	Data_center	200907	10	3	0	0	8	5	1	0	488	309	57	289	174	19
579730	Data_center	200908	6	2	0	0	5	3	1	0	494	313	59	293	176	19
579730	Data_center	200909	9	1	0	0	7	5	1	0	503	318	60	299	180	20
579730	Data_center	200910	9	2	0	0	7	3	2	0	512	324	62	302	183	20
579730	Data_center	200911	7	2	0	0	6	2	2	0	519	329	64	304	184	20
579730	Data_center	200912	12	5	0	0	10	7	4	0	531	337	69	313	189	23
579730	Data_center	201001	14	5	0	0	10	6	3	0	545	343	74	321	191	24
579730	Data_center	201002	23	6	0	0	15	8	4	0	568	353	80	336	196	26
579730	Data_center	201003	13	2	0	0	9	5	2	0	581	360	82	342	199	27
579730	Data_center	201004	12	2	0	0	10	7	2	0	593	366	84	351	202	27
579730	Data_center	201005	4	1	0	0	4	2	1	0	597	369	85	353	203	27
579730	Data_center	201006	7	3	0	0	7	4	3	0	604	375	88	357	206	27
579730	Data_center	201007	9	0	0	0	4	4	0	0	613	379	88	366	210	27
579730	Data_center	201008	10	2	0	0	6	3	2	0	623	384	90	373	212	27
579730	Data_center	201009	15	1	0	0	9	6	1	0	638	392	91	383	217	27
579730	Data_center	201010	18	4	0	0	12	10	4	0	656	401	95	393	224	28
579730	Data_center	201011	15	1	0	0	12	8	1	0	671	411	96	402	230	28
579730	Data_center	201012	2	0	0	0	2	0	0	0	673	413	96	402	230	28
579730	Data_center	201101	8	1	0	0	6	4	1	0	681	418	97	407	233	28
579730	Data_center	201102	10	2	0	0	8	5	2	0	691	423	99	413	235	29
579730	Data_center	201103	5	0	0	0	3	2	0	0	696	426	99	417	237	29
579730	Data_center	201104	10	2	0	0	9	6	2	0	706	431	101	423	239	30
579730	Data_center	201105	9	3	0	0	8	6	3	0	715	438	104	429	244	31
579730	Data_center	201106	13	2	0	0	8	6	1	0	728	443	106	438	247	31
579730	Data_center	201107	25	0	0	0	12	7	0	0	753	453	106	451	252	31
579730	Data_center	201108	11	0	0	0	8	3	0	0	764	460	106	455	254	31
579730	Data_center	201109	14	4	0	0	11	6	3	0	778	467	110	463	256	31
579730	Data_center	201110	19	4	1	0	11	7	4	1	797	476	114	477	262	32
579730	Data_center	201111	12	2	0	0	10	6	2	0	809	483	116	485	265	33
579730	Data_center	201112	9	1	0	0	6	4	1	0	818	487	117	491	267	33
579730	Data_center	201201	10	2	0	0	10	6	2	0	828	495	119	497	271	33
579730	Data_center	201202	10	0	0	0	7	5	0	0	838	501	119	504	275	33
579730	Data_center	201203	20	1	0	0	11	6	1	0	858	509	120	518	278	33
579730	Data_center	201204	8	1	0	0	7	6	1	0	866	516	121	525	284	33
579730	Data_center	201205	8	1	0	0	5	4	1	0	874	520	122	532	287	33
579730	Data_center	201206	14	1	0	0	11	7	1	0	888	528	123	541	291	33
579730	Data_center	201207	13	3	0	0	11	6	3	0	901	537	126	549	295	33
579730	Data_center	201208	13	3	0	0	8	5	3	0	914	542	129	558	297	34
579730	Data_center	201209	13	0	0	0	9	3	0	0	927	549	129	562	298	34
579730	Data_center	201210	5	0	0	0	5	4	0	0	932	554	129	566	302	34
579730	Data_center	201211	4	0	0	0	4	2	0	0	936	557	129	568	303	34
579730	Data_center	201212	7	2	0	0	6	2	1	0	943	562	131	571	304	34
579730	Data_center	201301	3	1	0	0	3	1	1	0	946	565	132	572	305	34
579730	Data_center	201302	4	0	0	0	3	3	0	0	950	568	132	576	308	34
579730	Data_center	201303	8	0	0	0	8	2	0	0	958	576	132	578	310	34
579730	Data_center	201304	11	4	0	0	9	5	3	0	969	584	136	584	314	34
579730	Data_center	201305	7	0	0	0	5	3	0	0	976	588	136	587	316	34
579730	Data_center	201306	9	2	0	0	7	3	2	0	985	592	138	591	316	34
579730	Data_center	201307	8	2	0	0	6	3	2	0	993	597	140	594	318	34
579730	Data_center	201308	12	3	0	0	11	6	3	0	1005	606	143	601	322	34
579730	Data_center	201309	14	2	0	0	8	5	2	0	1019	613	145	607	326	34
579730	Data_center	201310	15	3	0	0	9	5	2	0	1034	621	148	613	330	35
579730	Data_center	201311	10	0	0	0	5	5	0	0	1044	625	148	623	334	35
579730	Data_center	201312	14	3	0	0	10	5	3	0	1058	632	151	628	336	36
579730	Data_center	201401	14	4	0	0	10	6	4	0	1072	640	155	635	340	36
579730	Data_center	201402	4	0	0	0	4	2	0	0	1076	644	155	637	342	36
579730	Data_center	201403	11	2	0	0	7	4	1	0	1087	648	157	644	344	37
579730	Data_center	201404	5	1	0	0	5	3	1	0	1092	652	158	647	346	37
579730	Data_center	201405	16	4	0	0	12	4	3	0	1108	662	162	653	348	37
579730	Data_center	201406	5	1	0	0	3	2	1	0	1113	663	163	657	348	37
579730	Data_center	201407	9	2	0	0	7	5	2	0	1122	667	165	662	350	37
579730	Data_center	201408	8	1	0	0	8	7	1	0	1130	674	166	669	356	37
579730	Data_center	201409	6	0	0	0	4	4	0	0	1136	678	166	675	360	37
579730	Data_center	201410	4	0	0	0	4	2	0	0	1140	682	166	677	362	37
579730	Data_center	201411	6	1	0	0	5	4	1	0	1146	686	167	681	365	38
579730	Data_center	201412	1	0	0	0	1	0	0	0	1147	687	167	681	365	38
579730	Data_center	201501	16	0	0	0	5	3	0	0	1163	691	167	694	367	38
579730	Data_center	201502	8	0	0	0	6	6	0	0	1171	697	167	702	373	38
579730	Data_center	201503	5	1	0	0	5	4	1	0	1176	701	168	706	376	39
579730	Data_center	201504	7	2	0	0	5	4	2	0	1183	702	170	710	376	39
579730	Data_center	201505	2	1	0	0	2	1	1	0	1185	704	171	711	377	39
579730	Data_center	201506	9	1	0	0	6	6	1	0	1194	709	172	720	382	40
579730	Data_center	201507	10	2	0	0	7	5	2	0	1204	714	174	727	385	41
579730	Data_center	201508	7	2	0	0	6	3	1	0	1211	720	176	731	388	42
579730	Data_center	201509	4	0	0	0	4	4	0	0	1215	723	176	735	391	42
579730	Data_center	201510	6	1	0	0	5	4	1	0	1221	727	177	740	394	42
579730	Data_center	201511	3	0	0	0	3	3	0	0	1224	729	177	743	396	42
579730	Data_center	201512	1	0	0	0	1	1	0	0	1225	730	177	744	397	42
579730	Data_center	201601	5	1	0	0	5	4	1	0	1230	734	178	748	400	42
579730	Data_center	201602	2	0	0	0	2	2	0	0	1232	736	178	750	402	42
579730	Data_center	201603	16	6	3	2	8	6	4	2	1248	741	184	764	405	46
579730	Data_center	201604	9	2	0	0	6	4	2	0	1257	746	186	770	408	47
579730	Data_center	201605	2	0	0	0	2	1	0	0	1259	748	186	771	409	47
579730	Data_center	201606	4	0	0	0	2	2	0	0	1263	750	186	775	411	47
579730	Data_center	201607	2	1	0	0	2	1	1	0	1265	751	187	776	411	47
579730	Data_center	201608	4	1	0	0	4	2	1	0	1269	754	188	778	412	47
579730	Data_center	201609	8	3	0	0	6	3	3	0	1277	757	191	782	412	48
579730	Data_center	201610	2	0	0	0	2	2	0	0	1279	759	191	784	414	48
579730	Data_center	201611	8	1	0	0	6	4	1	0	1287	763	192	788	416	48
579730	Data_center	201612	1	0	0	0	1	1	0	0	1288	764	192	789	417	48
579730	Data_center	201701	3	0	0	0	3	3	0	0	1291	767	192	792	420	48
579730	Data_center	201702	9	1	0	0	5	5	1	0	1300	770	193	801	423	49
579730	Data_center	201703	10	0	0	0	6	4	0	0	1310	776	193	807	426	49
579730	Data_center	201704	9	0	0	0	2	2	0	0	1319	777	193	816	427	49
579730	Data_center	201705	4	0	0	0	3	2	0	0	1323	780	193	818	429	49
579730	Data_center	201706	2	0	0	0	2	1	0	0	1325	782	193	819	430	49
579730	Data_center	201707	3	0	0	0	3	3	0	0	1328	783	193	822	431	49
579730	Data_center	201708	17	1	0	0	13	7	1	0	1345	793	194	832	434	50
579730	Data_center	201709	8	1	0	0	8	6	1	0	1353	797	195	838	436	50
579730	Data_center	201710	9	0	0	0	7	5	0	0	1362	802	195	845	439	50
579730	Data_center	201711	3	1	0	0	3	2	1	0	1365	803	196	847	439	50
579730	Data_center	201712	10	2	0	0	5	4	2	0	1375	808	198	855	443	52
579730	Data_center	201801	10	2	0	0	7	4	1	0	1385	812	200	860	444	52
579730	Data_center	201803	6	2	0	0	5	5	2	0	1391	816	202	866	448	54
579730	Data_center	201804	7	1	0	0	5	2	1	0	1398	821	203	868	450	54
579730	Data_center	201805	3	1	0	0	3	3	1	0	1401	822	204	871	451	55
579730	Data_center	201806	4	1	0	0	4	2	1	0	1405	825	205	873	452	55
579730	Data_center	201807	4	0	0	0	4	3	0	0	1409	828	205	876	454	55
8013	Data_compression	200111	1	0	0	0	1	1	0	0	1	1	0	1	1	0
8013	Data_compression	200112	4	0	0	0	4	4	0	0	5	5	0	5	5	0
8013	Data_compression	200202	3	0	0	0	3	3	0	0	8	8	0	8	7	0
8013	Data_compression	200203	1	0	0	0	1	1	0	0	9	9	0	9	7	0
8013	Data_compression	200204	2	0	0	0	2	1	0	0	11	11	0	10	8	0
8013	Data_compression	200207	7	0	0	0	4	2	0	0	18	15	0	14	10	0
8013	Data_compression	200208	3	0	0	0	3	2	0	0	21	18	0	16	12	0
8013	Data_compression	200209	2	0	0	0	2	2	0	0	23	20	0	18	14	0
8013	Data_compression	200210	4	0	0	0	1	0	0	0	27	21	0	18	14	0
8013	Data_compression	200211	1	0	0	0	1	1	0	0	28	21	0	19	14	0
8013	Data_compression	200212	2	0	0	0	1	0	0	0	30	22	0	19	14	0
8013	Data_compression	200302	1	0	0	0	1	1	0	0	31	23	0	20	15	0
8013	Data_compression	200303	2	0	0	0	1	1	0	0	33	24	0	22	16	0
8013	Data_compression	200304	1	0	0	0	1	1	0	0	34	25	0	23	17	0
8013	Data_compression	200306	1	0	0	0	1	1	0	0	35	26	0	24	18	0
8013	Data_compression	200307	5	0	0	0	2	2	0	0	40	28	0	29	20	0
8013	Data_compression	200309	1	0	0	0	1	0	0	0	41	29	0	29	20	0
8013	Data_compression	200310	2	0	0	0	2	2	0	0	43	31	0	31	22	0
8013	Data_compression	200311	5	0	0	0	4	4	0	0	48	34	0	36	25	0
8013	Data_compression	200312	8	0	0	0	2	1	0	0	56	36	0	37	26	0
8013	Data_compression	200401	2	0	0	0	2	2	0	0	58	37	0	39	27	0
8013	Data_compression	200402	4	0	0	0	3	3	0	0	62	40	0	43	30	0
8013	Data_compression	200403	1	0	0	0	1	1	0	0	63	41	0	44	31	0
8013	Data_compression	200404	7	2	0	0	4	3	1	0	70	45	2	48	34	0
8013	Data_compression	200405	6	0	0	0	5	3	0	0	76	50	2	51	37	0
8013	Data_compression	200406	6	0	0	0	5	1	0	0	82	55	2	52	38	0
8013	Data_compression	200407	3	0	0	0	2	1	0	0	85	57	2	54	39	0
8013	Data_compression	200408	7	0	0	0	5	4	0	0	92	62	2	60	43	0
8013	Data_compression	200409	7	0	0	0	7	3	0	0	99	69	2	63	46	0
8013	Data_compression	200410	11	0	0	0	7	6	0	0	110	76	2	73	52	0
8013	Data_compression	200411	10	1	0	0	7	4	1	0	120	81	3	80	54	0
8013	Data_compression	200501	6	0	0	0	6	6	0	0	126	86	3	86	59	0
8013	Data_compression	200502	7	0	0	0	7	5	0	0	133	93	3	91	64	0
8013	Data_compression	200503	6	0	0	0	6	2	0	0	139	98	3	93	65	0
8013	Data_compression	200504	9	1	0	0	6	4	1	0	148	103	4	100	68	0
8013	Data_compression	200507	4	0	0	0	4	4	0	0	152	107	4	104	72	0
8013	Data_compression	200508	13	1	0	0	11	7	1	0	165	116	5	113	77	0
8013	Data_compression	200509	7	0	0	0	7	3	0	0	172	123	5	116	80	0
8013	Data_compression	200510	4	0	0	0	3	1	0	0	176	126	5	117	81	0
8013	Data_compression	200511	5	0	0	0	5	2	0	0	181	131	5	119	83	0
8013	Data_compression	200512	6	0	0	0	4	1	0	0	187	135	5	120	84	0
8013	Data_compression	200601	12	3	0	0	10	3	3	0	199	145	8	123	87	0
8013	Data_compression	200602	9	0	0	0	9	7	0	0	208	153	8	130	93	0
8013	Data_compression	200603	3	0	0	0	3	1	0	0	211	156	8	131	94	0
8013	Data_compression	200604	18	2	0	0	11	6	2	0	229	166	10	138	99	0
8013	Data_compression	200605	4	0	0	0	4	4	0	0	233	170	10	142	103	0
8013	Data_compression	200606	11	0	0	0	5	2	0	0	244	175	10	149	105	0
8013	Data_compression	200607	18	2	0	0	10	5	2	0	262	185	12	158	110	0
8013	Data_compression	200608	6	0	0	0	6	3	0	0	268	191	12	161	113	0
8013	Data_compression	200609	7	0	0	0	7	6	0	0	275	197	12	167	118	0
8013	Data_compression	200610	14	3	0	0	10	6	3	0	289	206	15	176	123	0
8013	Data_compression	200611	5	1	0	0	5	4	1	0	294	210	16	180	126	0
8013	Data_compression	200612	5	1	0	0	5	2	1	0	299	214	17	182	127	0
8013	Data_compression	200701	21	5	0	0	11	8	3	0	320	224	22	193	134	0
8013	Data_compression	200702	24	2	0	0	19	10	2	0	344	241	24	205	143	1
8013	Data_compression	200703	10	3	0	0	10	6	3	0	354	251	27	211	149	1
8013	Data_compression	200704	57	5	2	1	22	14	3	2	411	272	32	256	162	3
8013	Data_compression	200705	21	3	0	0	14	6	3	0	432	285	35	266	167	3
8013	Data_compression	200706	21	7	0	0	15	10	5	0	453	298	42	278	175	3
8013	Data_compression	200707	13	0	0	0	10	8	0	0	466	304	42	289	179	3
8013	Data_compression	200708	22	1	0	0	10	6	1	0	488	313	43	307	184	4
8013	Data_compression	200709	10	1	0	0	10	6	1	0	498	321	44	313	188	4
8013	Data_compression	200710	10	2	0	0	7	5	2	0	508	327	46	321	192	6
8013	Data_compression	200711	9	2	0	0	9	3	2	0	517	336	48	324	195	6
8013	Data_compression	200712	7	0	0	0	7	4	0	0	524	343	48	328	199	6
8013	Data_compression	200801	8	0	0	0	8	4	0	0	532	350	48	332	202	6
8013	Data_compression	200802	14	3	0	0	12	8	3	0	546	362	51	340	210	7
8013	Data_compression	200803	17	4	0	0	15	3	4	0	563	376	55	343	212	7
8013	Data_compression	200804	12	4	0	0	11	4	4	0	575	386	59	347	215	8
8013	Data_compression	200805	5	0	0	0	5	2	0	0	580	391	59	349	217	8
8013	Data_compression	200806	4	0	0	0	3	2	0	0	584	394	59	352	219	8
8013	Data_compression	200807	15	3	0	0	8	4	1	0	599	402	62	360	223	8
8013	Data_compression	200808	2	1	0	0	2	2	1	0	601	404	63	362	225	9
8013	Data_compression	200809	9	2	0	0	7	5	2	0	610	410	65	367	229	9
8013	Data_compression	200810	4	1	0	0	4	1	1	0	614	414	66	368	230	9
8013	Data_compression	200811	7	1	0	0	7	5	1	0	621	421	67	373	235	9
8013	Data_compression	200812	4	1	0	0	4	2	1	0	625	425	68	375	237	9
8013	Data_compression	200901	3	1	0	0	2	1	1	0	628	427	69	376	238	9
8013	Data_compression	200902	13	3	0	0	10	8	3	0	641	435	72	385	244	11
8013	Data_compression	200903	5	0	0	0	4	3	0	0	646	439	72	388	247	11
8013	Data_compression	200904	4	0	0	0	3	1	0	0	650	442	72	389	248	11
8013	Data_compression	200905	12	4	0	0	10	3	4	0	662	450	76	392	250	12
8013	Data_compression	200906	9	3	0	0	8	3	3	0	671	457	79	395	252	12
8013	Data_compression	200907	5	0	0	0	4	1	0	0	676	461	79	397	253	12
8013	Data_compression	200908	3	0	0	0	2	2	0	0	679	461	79	400	253	12
8013	Data_compression	200909	5	1	0	0	5	2	1	0	684	466	80	402	255	12
8013	Data_compression	200910	6	1	0	0	5	2	1	0	690	471	81	404	257	12
8013	Data_compression	200911	2	0	0	0	2	1	0	0	692	473	81	405	258	12
8013	Data_compression	201001	8	1	0	0	4	2	1	0	700	476	82	411	259	12
8013	Data_compression	201002	6	1	0	0	4	3	1	0	706	479	83	416	261	12
8013	Data_compression	201003	2	1	0	0	2	1	1	0	708	480	84	417	261	12
8013	Data_compression	201004	4	1	0	0	4	1	1	0	712	483	85	418	261	12
8013	Data_compression	201005	5	0	0	0	4	3	0	0	717	487	85	422	264	12
8013	Data_compression	201006	1	0	0	0	1	0	0	0	718	488	85	422	264	12
8013	Data_compression	201007	5	2	0	0	4	1	1	0	723	492	87	424	265	12
8013	Data_compression	201009	6	0	0	0	3	3	0	0	729	494	87	430	267	12
8013	Data_compression	201010	2	0	0	0	2	2	0	0	731	496	87	432	269	12
8013	Data_compression	201011	5	1	0	0	3	3	1	0	736	499	88	437	272	13
8013	Data_compression	201012	11	2	0	0	9	6	2	0	747	506	90	443	276	14
8013	Data_compression	201101	3	0	0	0	3	3	0	0	750	508	90	446	278	14
8013	Data_compression	201102	8	0	0	0	7	5	0	0	758	514	90	452	282	14
8013	Data_compression	201103	12	0	0	0	4	4	0	0	770	517	90	464	285	14
8013	Data_compression	201104	3	0	0	0	2	0	0	0	773	519	90	464	285	14
8013	Data_compression	201105	12	3	0	0	9	1	3	0	785	528	93	465	286	14
8013	Data_compression	201106	3	0	0	0	3	0	0	0	788	531	93	465	286	14
8013	Data_compression	201107	3	1	0	0	3	2	1	0	791	534	94	467	288	14
8013	Data_compression	201108	3	1	0	0	3	2	1	0	794	535	95	469	288	14
8013	Data_compression	201109	2	0	0	0	2	1	0	0	796	537	95	470	289	14
8013	Data_compression	201110	11	4	0	0	10	6	3	0	807	545	99	477	293	14
8013	Data_compression	201111	6	1	0	0	4	3	1	0	813	549	100	482	296	15
8013	Data_compression	201112	20	2	0	0	8	6	2	0	833	555	102	500	300	15
8013	Data_compression	201201	14	4	0	0	13	8	4	0	847	563	106	508	304	16
8013	Data_compression	201202	12	0	0	0	7	4	0	0	859	569	106	517	307	16
8013	Data_compression	201203	29	1	0	0	10	5	1	0	888	577	107	540	310	16
8013	Data_compression	201204	9	1	0	0	8	5	1	0	897	584	108	546	314	16
8013	Data_compression	201205	6	0	0	0	5	2	0	0	903	589	108	548	316	16
8013	Data_compression	201206	6	0	0	0	5	3	0	0	909	594	108	551	319	16
8013	Data_compression	201207	3	1	0	0	3	1	1	0	912	597	109	552	320	16
8013	Data_compression	201208	7	0	0	0	6	4	0	0	919	601	109	556	322	16
8013	Data_compression	201209	5	0	0	0	5	5	0	0	924	604	109	561	324	16
8013	Data_compression	201210	6	1	0	0	6	5	1	0	930	609	110	566	328	16
8013	Data_compression	201211	5	0	0	0	4	4	0	0	935	613	110	571	332	16
8013	Data_compression	201212	6	1	0	0	5	2	1	0	941	617	111	573	333	16
8013	Data_compression	201301	18	1	0	0	8	4	1	0	959	622	112	587	335	16
8013	Data_compression	201302	14	2	0	0	10	8	2	0	973	626	114	599	337	16
8013	Data_compression	201303	8	2	0	0	8	3	2	0	981	633	116	602	339	16
8013	Data_compression	201304	90	2	0	0	9	4	2	0	1071	640	118	683	341	16
8013	Data_compression	201306	9	1	0	0	6	2	1	0	1080	645	119	685	342	16
8013	Data_compression	201307	4	1	0	0	4	3	1	0	1084	649	120	688	345	16
8013	Data_compression	201308	2	1	0	0	2	1	1	0	1086	651	121	689	346	16
8013	Data_compression	201309	8	2	0	0	5	3	2	0	1094	656	123	692	349	16
8013	Data_compression	201310	4	1	0	0	4	3	1	0	1098	659	124	695	351	16
8013	Data_compression	201311	7	2	0	0	7	6	2	0	1105	666	126	701	357	18
8013	Data_compression	201312	5	1	0	0	4	3	1	0	1110	668	127	705	358	18
8013	Data_compression	201401	7	1	0	0	6	3	1	0	1117	673	128	708	360	18
8013	Data_compression	201402	7	1	0	0	6	4	1	0	1124	678	129	713	363	18
8013	Data_compression	201403	9	1	0	0	4	3	1	0	1133	681	130	721	365	19
8013	Data_compression	201404	2	0	0	0	1	0	0	0	1135	682	130	721	365	19
8013	Data_compression	201405	8	2	0	0	6	3	2	0	1143	688	132	724	368	19
8013	Data_compression	201406	4	1	0	0	4	3	1	0	1147	689	133	727	368	19
8013	Data_compression	201407	4	1	0	0	4	2	1	0	1151	693	134	729	370	19
8013	Data_compression	201408	2	0	0	0	2	1	0	0	1153	694	134	730	370	19
8013	Data_compression	201409	5	2	0	0	5	3	2	0	1158	697	136	733	371	19
8013	Data_compression	201410	2	1	0	0	2	1	1	0	1160	699	137	734	372	19
8013	Data_compression	201411	9	3	0	0	7	3	2	0	1169	705	140	738	373	20
8013	Data_compression	201412	8	2	0	0	8	5	2	0	1177	712	142	743	377	20
8013	Data_compression	201501	5	2	0	0	5	2	2	0	1182	715	144	745	377	20
8013	Data_compression	201502	3	0	0	0	3	3	0	0	1185	718	144	748	380	20
8013	Data_compression	201503	3	0	0	0	2	1	0	0	1188	720	144	750	381	20
8013	Data_compression	201504	5	0	0	0	4	3	0	0	1193	723	144	754	383	20
8013	Data_compression	201505	8	3	0	0	8	5	3	0	1201	728	147	759	385	20
8013	Data_compression	201506	2	0	0	0	2	2	0	0	1203	729	147	761	386	20
8013	Data_compression	201507	6	1	0	0	4	3	1	0	1209	731	148	766	387	20
8013	Data_compression	201508	2	0	0	0	2	2	0	0	1211	733	148	768	389	20
8013	Data_compression	201509	2	0	0	0	2	2	0	0	1213	735	148	770	391	20
8013	Data_compression	201510	18	7	0	0	7	6	5	0	1231	741	155	779	396	20
8013	Data_compression	201511	4	1	0	0	4	4	1	0	1235	743	156	783	397	21
8013	Data_compression	201512	2	0	0	0	2	1	0	0	1237	744	156	784	397	21
8013	Data_compression	201601	6	1	0	0	5	1	1	0	1243	748	157	785	397	21
8013	Data_compression	201602	2	0	0	0	2	1	0	0	1245	750	157	786	398	21
8013	Data_compression	201603	2	0	0	0	2	1	0	0	1247	752	157	787	399	21
8013	Data_compression	201604	11	5	0	0	8	5	4	0	1258	759	162	794	402	22
8013	Data_compression	201605	8	0	0	0	4	4	0	0	1266	762	162	802	404	22
8013	Data_compression	201607	7	2	0	0	7	5	2	0	1273	765	164	807	405	23
8013	Data_compression	201608	3	0	0	0	2	1	0	0	1276	767	164	808	406	23
8013	Data_compression	201609	6	0	0	0	5	2	0	0	1282	772	164	810	408	23
8013	Data_compression	201610	11	4	0	0	8	5	4	0	1293	777	168	815	410	23
8013	Data_compression	201611	5	1	0	0	4	3	1	0	1298	779	169	819	410	24
8013	Data_compression	201612	5	1	0	0	3	3	1	0	1303	781	170	824	412	25
8013	Data_compression	201701	5	2	0	0	5	4	2	0	1308	784	172	828	414	26
8013	Data_compression	201702	4	1	0	0	4	1	1	0	1312	787	173	829	414	26
8013	Data_compression	201703	7	2	0	0	6	5	2	0	1319	791	175	835	416	27
8013	Data_compression	201704	10	3	0	0	9	7	3	0	1329	797	178	843	420	28
8013	Data_compression	201705	7	1	0	0	7	7	1	0	1336	801	179	850	424	29
8013	Data_compression	201706	6	2	0	0	5	4	2	0	1342	804	181	855	425	30
8013	Data_compression	201708	11	4	0	0	6	4	3	0	1353	807	185	860	425	30
8013	Data_compression	201709	6	1	0	0	4	3	1	0	1359	808	186	865	425	30
8013	Data_compression	201711	3	1	0	0	3	3	1	0	1362	809	187	868	426	31
8013	Data_compression	201712	6	2	0	0	6	4	2	0	1368	813	189	872	428	31
8013	Data_compression	201801	1	0	0	0	1	1	0	0	1369	813	189	873	428	31
8013	Data_compression	201802	2	0	0	0	2	2	0	0	1371	814	189	875	429	31
8013	Data_compression	201803	26	6	0	0	12	9	6	0	1397	822	195	886	433	33
8013	Data_compression	201804	11	2	0	0	8	6	2	0	1408	827	197	895	435	34
8013	Data_compression	201805	3	1	0	0	3	2	1	0	1411	830	198	897	437	34
8013	Data_compression	201806	4	1	0	0	3	1	1	0	1415	833	199	898	438	34
8013	Data_compression	201807	16	0	0	0	6	6	0	0	1431	837	199	914	441	34
10231058	Data_exchange	200704	3	0	0	0	3	3	0	0	3	3	0	3	3	0
10231058	Data_exchange	200705	2	0	0	0	2	1	0	0	5	4	0	4	3	0
10231058	Data_exchange	200806	1	0	0	0	1	1	0	0	6	5	0	5	4	0
10231058	Data_exchange	200810	2	0	0	0	2	2	0	0	8	7	0	7	6	0
10231058	Data_exchange	201007	1	0	0	0	1	1	0	0	9	8	0	8	7	0
10231058	Data_exchange	201107	1	0	0	0	1	1	0	0	10	9	0	9	8	0
10231058	Data_exchange	201109	1	0	0	0	1	1	0	0	11	10	0	10	9	0
10231058	Data_exchange	201110	9	0	0	0	2	2	0	0	20	12	0	19	11	0
10231058	Data_exchange	201112	21	0	0	0	5	3	0	0	41	16	0	33	13	0
10231058	Data_exchange	201203	1	0	0	0	1	1	0	0	42	17	0	34	14	0
10231058	Data_exchange	201211	2	0	0	0	2	2	0	0	44	19	0	36	16	0
10231058	Data_exchange	201303	1	0	0	0	1	1	0	0	45	19	0	37	16	0
10231058	Data_exchange	201305	1	0	0	0	1	1	0	0	46	20	0	38	17	0
10231058	Data_exchange	201310	8	0	0	0	1	1	0	0	54	21	0	46	18	0
10231058	Data_exchange	201401	1	0	0	0	1	0	0	0	55	22	0	46	18	0
10231058	Data_exchange	201402	1	0	0	0	1	1	0	0	56	23	0	47	19	0
10231058	Data_exchange	201404	8	0	0	0	2	2	0	0	64	25	0	55	21	0
10231058	Data_exchange	201407	1	0	0	0	1	1	0	0	65	26	0	56	22	0
10231058	Data_exchange	201509	2	1	0	0	2	1	1	0	67	28	1	57	23	0
10231058	Data_exchange	201510	2	0	0	0	1	1	0	0	69	29	1	59	24	0
10231058	Data_exchange	201605	1	0	0	0	1	1	0	0	70	30	1	60	25	0
10231058	Data_exchange	201606	2	0	0	0	2	2	0	0	72	31	1	62	26	0
10231058	Data_exchange	201608	3	0	0	0	2	2	0	0	75	32	1	65	27	0
10231058	Data_exchange	201609	4	1	0	0	3	2	1	0	79	35	2	67	29	1
10231058	Data_exchange	201611	3	0	0	0	1	1	0	0	82	36	2	70	30	1
10231058	Data_exchange	201708	3	0	0	0	1	1	0	0	85	37	2	73	31	1
10231058	Data_exchange	201709	1	0	0	0	1	1	0	0	86	38	2	74	32	1
10231058	Data_exchange	201710	3	1	0	0	3	1	1	0	89	41	3	75	33	1
10231058	Data_exchange	201711	3	1	0	0	2	1	1	0	92	43	4	76	34	1
10231058	Data_exchange	201802	1	0	0	0	1	0	0	0	93	44	4	76	34	1
10231058	Data_exchange	201805	3	1	0	0	3	3	1	0	96	47	5	79	37	2
10231058	Data_exchange	201806	5	0	0	0	2	2	0	0	101	49	5	84	39	2
10231058	Data_exchange	201807	5	1	0	0	4	1	1	0	106	53	6	85	40	2
46626475	Data_lake	201506	4	0	0	0	2	2	0	0	4	2	0	4	2	0
46626475	Data_lake	201510	9	0	0	0	4	4	0	0	13	6	0	13	6	0
46626475	Data_lake	201511	6	1	0	0	5	4	1	0	19	11	1	18	10	0
46626475	Data_lake	201512	12	0	0	0	7	7	0	0	31	17	1	30	16	0
46626475	Data_lake	201601	6	0	0	0	6	5	0	0	37	22	1	35	20	0
46626475	Data_lake	201603	2	0	0	0	1	0	0	0	39	23	1	35	20	0
46626475	Data_lake	201604	2	0	0	0	1	1	0	0	41	24	1	37	21	0
46626475	Data_lake	201605	5	0	0	0	4	3	0	0	46	27	1	40	23	0
46626475	Data_lake	201606	4	0	0	0	2	2	0	0	50	28	1	44	24	0
46626475	Data_lake	201607	2	0	0	0	2	0	0	0	52	30	1	44	24	0
46626475	Data_lake	201609	5	0	0	0	4	1	0	0	57	34	1	46	25	0
46626475	Data_lake	201610	5	0	0	0	4	4	0	0	62	37	1	51	28	0
46626475	Data_lake	201611	4	0	0	0	2	2	0	0	66	39	1	55	30	0
46626475	Data_lake	201612	13	0	0	0	2	2	0	0	79	41	1	68	32	0
46626475	Data_lake	201701	3	0	0	0	2	1	0	0	82	43	1	70	33	0
46626475	Data_lake	201703	3	0	0	0	3	2	0	0	85	45	1	72	34	0
46626475	Data_lake	201704	4	0	0	0	3	3	0	0	89	47	1	76	36	0
46626475	Data_lake	201705	2	1	0	0	2	2	1	0	91	49	2	78	38	1
46626475	Data_lake	201706	9	0	0	0	3	1	0	0	100	52	2	85	39	1
46626475	Data_lake	201707	4	1	0	0	4	1	1	0	104	55	3	86	39	1
46626475	Data_lake	201708	4	0	0	0	4	2	0	0	108	59	3	88	41	1
46626475	Data_lake	201709	6	0	0	0	6	5	0	0	114	65	3	93	46	1
46626475	Data_lake	201712	6	1	0	0	4	3	1	0	120	67	4	97	46	2
46626475	Data_lake	201801	1	0	0	0	1	1	0	0	121	67	4	98	46	2
46626475	Data_lake	201802	3	0	0	0	3	2	0	0	124	70	4	100	48	2
46626475	Data_lake	201803	4	0	0	0	4	3	0	0	128	73	4	103	50	2
46626475	Data_lake	201804	4	1	0	0	2	2	1	0	132	75	5	107	52	3
46626475	Data_lake	201805	3	1	0	0	3	3	1	0	135	76	6	110	53	4
46626475	Data_lake	201806	8	2	0	0	5	5	2	0	143	80	8	118	57	6
46626475	Data_lake	201807	4	0	0	0	1	0	0	0	147	81	8	118	57	6
18218754	Data_masking	200810	4	0	0	0	1	1	0	0	4	1	0	4	1	0
18218754	Data_masking	200901	2	0	0	0	2	1	0	0	6	3	0	5	2	0
18218754	Data_masking	200902	1	0	0	0	1	1	0	0	7	4	0	6	3	0
18218754	Data_masking	200904	5	0	0	0	3	1	0	0	12	7	0	7	4	0
18218754	Data_masking	200905	5	0	0	0	2	1	0	0	17	9	0	11	5	0
18218754	Data_masking	200906	1	0	0	0	1	1	0	0	18	10	0	12	6	0
18218754	Data_masking	200907	3	0	0	0	3	1	0	0	21	13	0	13	7	0
18218754	Data_masking	200908	9	0	0	0	5	4	0	0	30	17	0	21	10	0
18218754	Data_masking	200909	4	2	0	0	4	3	2	0	34	20	2	24	12	1
18218754	Data_masking	200911	2	0	0	0	1	1	0	0	36	21	2	26	13	1
18218754	Data_masking	200912	2	0	0	0	2	2	0	0	38	23	2	28	15	1
18218754	Data_masking	201006	1	0	0	0	1	0	0	0	39	24	2	28	15	1
18218754	Data_masking	201008	2	0	0	0	2	2	0	0	41	26	2	30	17	1
18218754	Data_masking	201011	1	0	0	0	1	0	0	0	42	27	2	30	17	1
18218754	Data_masking	201103	3	0	0	0	1	1	0	0	45	28	2	33	18	1
18218754	Data_masking	201104	3	0	0	0	3	1	0	0	48	30	2	34	18	1
18218754	Data_masking	201106	2	1	0	0	2	2	1	0	50	32	3	36	20	2
18218754	Data_masking	201111	2	0	0	0	1	1	0	0	52	32	3	38	20	2
18218754	Data_masking	201203	1	0	0	0	1	0	0	0	53	33	3	38	20	2
18218754	Data_masking	201204	3	0	0	0	3	2	0	0	56	36	3	40	22	2
18218754	Data_masking	201206	1	0	0	0	1	0	0	0	57	37	3	40	22	2
18218754	Data_masking	201207	2	0	0	0	2	1	0	0	59	39	3	41	23	2
18218754	Data_masking	201208	3	0	0	0	2	2	0	0	62	41	3	44	25	2
18218754	Data_masking	201211	1	0	0	0	1	0	0	0	63	42	3	44	25	2
18218754	Data_masking	201302	2	1	0	0	2	2	1	0	65	44	4	46	27	3
18218754	Data_masking	201303	1	0	0	0	1	0	0	0	66	45	4	46	27	3
18218754	Data_masking	201304	1	0	0	0	1	1	0	0	67	46	4	47	28	3
18218754	Data_masking	201305	26	1	0	0	3	3	1	0	93	49	5	73	31	4
18218754	Data_masking	201306	3	1	0	0	3	3	1	0	96	52	6	76	34	5
18218754	Data_masking	201307	1	0	0	0	1	1	0	0	97	53	6	77	35	5
18218754	Data_masking	201308	3	0	0	0	3	2	0	0	100	56	6	79	37	5
18218754	Data_masking	201309	2	0	0	0	1	1	0	0	102	57	6	81	38	5
18218754	Data_masking	201402	2	0	0	0	1	0	0	0	104	58	6	81	38	5
18218754	Data_masking	201403	6	0	0	0	1	0	0	0	110	59	6	81	38	5
18218754	Data_masking	201406	1	0	0	0	1	0	0	0	111	60	6	81	38	5
18218754	Data_masking	201407	1	0	0	0	1	1	0	0	112	61	6	82	39	5
18218754	Data_masking	201408	3	0	0	0	2	1	0	0	115	63	6	84	40	5
18218754	Data_masking	201410	9	0	0	0	5	2	0	0	124	67	6	88	41	5
18218754	Data_masking	201411	2	0	0	0	1	0	0	0	126	68	6	88	41	5
18218754	Data_masking	201412	2	0	0	0	1	0	0	0	128	69	6	88	41	5
18218754	Data_masking	201501	1	0	0	0	1	1	0	0	129	70	6	89	42	5
18218754	Data_masking	201502	3	0	0	0	3	0	0	0	132	73	6	89	42	5
18218754	Data_masking	201503	2	0	0	0	2	0	0	0	134	75	6	89	42	5
18218754	Data_masking	201504	7	0	0	0	4	2	0	0	141	77	6	93	42	5
18218754	Data_masking	201506	4	1	0	0	4	1	1	0	145	81	7	94	43	5
18218754	Data_masking	201507	9	0	0	0	2	2	0	0	154	83	7	103	45	5
18218754	Data_masking	201508	2	0	0	0	2	0	0	0	156	84	7	103	45	5
18218754	Data_masking	201510	3	0	0	0	3	2	0	0	159	87	7	105	47	5
18218754	Data_masking	201511	2	0	0	0	2	2	0	0	161	89	7	107	49	5
18218754	Data_masking	201512	3	0	0	0	2	1	0	0	164	91	7	109	50	5
18218754	Data_masking	201601	3	1	0	0	3	2	1	0	167	94	8	111	52	5
18218754	Data_masking	201602	2	0	0	0	2	1	0	0	169	96	8	112	52	5
18218754	Data_masking	201603	5	0	0	0	4	0	0	0	174	100	8	112	52	5
18218754	Data_masking	201604	5	0	0	0	3	1	0	0	179	103	8	114	53	5
18218754	Data_masking	201605	1	0	0	0	1	1	0	0	180	104	8	115	54	5
18218754	Data_masking	201606	6	1	0	0	4	2	1	0	186	107	9	118	55	5
18218754	Data_masking	201607	1	0	0	0	1	1	0	0	187	108	9	119	55	5
18218754	Data_masking	201608	3	0	0	0	2	1	0	0	190	110	9	120	56	5
18218754	Data_masking	201609	3	1	0	0	3	1	1	0	193	113	10	121	57	5
18218754	Data_masking	201702	4	0	0	0	2	1	0	0	197	114	10	123	57	5
18218754	Data_masking	201703	3	1	0	0	2	1	1	0	200	116	11	125	58	5
18218754	Data_masking	201704	3	0	0	0	3	3	0	0	203	118	11	128	60	5
18218754	Data_masking	201705	1	0	0	0	1	1	0	0	204	119	11	129	61	5
18218754	Data_masking	201707	3	0	0	0	3	2	0	0	207	122	11	131	63	5
18218754	Data_masking	201708	3	2	0	0	3	2	2	0	210	125	13	133	65	6
18218754	Data_masking	201709	6	0	0	0	2	1	0	0	216	127	13	134	66	6
18218754	Data_masking	201710	2	0	0	0	2	1	0	0	218	129	13	135	67	6
18218754	Data_masking	201711	14	0	0	0	2	2	0	0	232	131	13	149	69	6
18218754	Data_masking	201712	2	1	0	0	2	1	1	0	234	133	14	150	70	6
18218754	Data_masking	201805	1	0	0	0	1	0	0	0	235	134	14	150	70	6
42253	Data_mining	200204	1	0	0	0	1	0	0	0	1	1	0	0	0	0
42253	Data_mining	200205	7	0	0	0	5	3	0	0	8	6	0	5	3	0
42253	Data_mining	200206	1	0	0	0	1	1	0	0	9	7	0	6	4	0
42253	Data_mining	200207	3	1	0	0	3	2	1	0	12	10	1	8	6	0
42253	Data_mining	200210	1	0	0	0	1	1	0	0	13	11	1	9	7	0
42253	Data_mining	200211	3	0	0	0	3	1	0	0	16	14	1	10	8	0
42253	Data_mining	200301	1	0	0	0	1	1	0	0	17	15	1	11	9	0
42253	Data_mining	200304	3	0	0	0	3	3	0	0	20	16	1	14	10	0
42253	Data_mining	200305	2	0	0	0	1	0	0	0	22	17	1	14	10	0
42253	Data_mining	200306	1	0	0	0	1	1	0	0	23	18	1	15	11	0
42253	Data_mining	200309	4	0	0	0	3	2	0	0	27	20	1	18	12	0
42253	Data_mining	200310	1	0	0	0	1	1	0	0	28	21	1	19	13	0
42253	Data_mining	200312	5	0	0	0	3	2	0	0	33	24	1	21	15	0
42253	Data_mining	200401	1	0	0	0	1	1	0	0	34	25	1	22	16	0
42253	Data_mining	200402	1	0	0	0	1	1	0	0	35	26	1	23	17	0
42253	Data_mining	200403	6	0	0	0	6	5	0	0	41	31	1	28	21	0
42253	Data_mining	200404	3	0	0	0	2	0	0	0	44	33	1	28	21	0
42253	Data_mining	200405	11	0	0	0	4	3	0	0	55	36	1	35	23	0
42253	Data_mining	200406	1	0	0	0	1	0	0	0	56	37	1	35	23	0
42253	Data_mining	200407	5	0	0	0	5	4	0	0	61	42	1	39	27	0
42253	Data_mining	200408	2	0	0	0	2	2	0	0	63	44	1	41	29	0
42253	Data_mining	200409	4	1	0	0	4	3	1	0	67	48	2	44	32	0
42253	Data_mining	200410	2	0	0	0	2	1	0	0	69	50	2	45	33	0
42253	Data_mining	200411	8	0	0	0	6	2	0	0	77	54	2	47	34	0
42253	Data_mining	200412	12	0	0	0	6	2	0	0	89	60	2	49	36	0
42253	Data_mining	200501	7	1	0	0	6	2	1	0	96	65	3	52	37	0
42253	Data_mining	200502	7	0	0	0	6	2	0	0	103	71	3	54	39	0
42253	Data_mining	200503	4	1	0	0	4	2	1	0	107	74	4	56	40	0
42253	Data_mining	200504	6	0	0	0	6	3	0	0	113	78	4	59	41	0
42253	Data_mining	200505	36	0	0	0	15	5	0	0	149	91	4	68	45	0
42253	Data_mining	200506	12	0	0	0	8	4	0	0	161	99	4	74	49	0
42253	Data_mining	200507	16	0	0	0	8	1	0	0	177	106	4	76	50	0
42253	Data_mining	200508	23	4	0	0	16	6	4	0	200	121	8	82	55	0
42253	Data_mining	200509	21	2	0	0	15	9	2	0	221	135	10	95	64	0
42253	Data_mining	200510	25	2	0	0	18	6	1	0	246	150	12	104	68	0
42253	Data_mining	200511	21	3	0	0	18	11	3	0	267	167	15	116	78	1
42253	Data_mining	200512	24	4	0	0	17	9	3	0	291	183	19	130	86	1
42253	Data_mining	200601	37	11	2	1	19	8	5	2	328	201	30	143	93	3
42253	Data_mining	200602	41	5	0	0	24	11	5	0	369	223	35	155	102	3
42253	Data_mining	200603	15	3	0	0	11	6	3	0	384	234	38	163	108	4
42253	Data_mining	200604	37	7	0	0	24	6	7	0	421	258	45	170	114	4
42253	Data_mining	200605	52	11	0	0	29	14	7	0	473	287	56	206	128	10
42253	Data_mining	200606	40	5	0	0	23	10	4	0	513	306	61	226	134	11
42253	Data_mining	200607	39	4	0	0	22	12	4	0	552	321	65	250	141	11
42253	Data_mining	200608	28	1	0	0	20	7	1	0	580	339	66	260	147	11
42253	Data_mining	200609	57	5	0	0	35	18	5	0	637	369	71	284	162	11
42253	Data_mining	200610	63	11	0	0	48	23	10	0	700	410	82	317	180	12
42253	Data_mining	200611	25	7	0	0	20	10	6	0	725	426	89	329	186	13
42253	Data_mining	200612	33	6	0	0	23	12	5	0	758	443	95	344	194	13
42253	Data_mining	200701	53	5	0	0	33	17	4	0	811	473	100	370	209	14
42253	Data_mining	200702	49	7	0	0	34	18	5	0	860	501	107	398	224	18
42253	Data_mining	200703	30	5	0	0	20	12	4	0	890	517	112	412	234	19
42253	Data_mining	200704	43	11	0	0	26	9	8	0	933	539	123	425	242	21
42253	Data_mining	200705	38	2	0	0	22	8	2	0	971	559	125	446	248	21
42253	Data_mining	200706	37	6	0	0	25	15	4	0	1008	580	131	470	259	22
42253	Data_mining	200707	23	3	0	0	16	8	3	0	1031	594	134	481	266	23
42253	Data_mining	200708	39	15	4	2	25	14	10	3	1070	612	149	504	277	29
42253	Data_mining	200709	36	8	0	0	23	12	6	0	1106	631	157	524	285	29
42253	Data_mining	200710	29	8	0	0	17	6	4	0	1135	646	165	536	289	31
42253	Data_mining	200711	24	3	0	0	17	8	3	0	1159	659	168	546	294	31
42253	Data_mining	200712	33	6	0	0	23	11	4	0	1192	676	174	564	299	31
42253	Data_mining	200801	19	0	0	0	12	4	0	0	1211	687	174	571	302	31
42253	Data_mining	200802	41	15	0	0	24	12	10	0	1252	708	189	588	312	31
42253	Data_mining	200803	39	5	0	0	23	10	5	0	1291	731	194	601	322	32
42253	Data_mining	200804	40	7	0	0	23	12	6	0	1331	751	201	624	331	32
42253	Data_mining	200805	36	6	0	0	20	12	4	0	1367	769	207	646	341	33
42253	Data_mining	200806	62	9	0	0	33	21	9	0	1429	796	216	687	356	35
42253	Data_mining	200807	45	5	0	0	26	12	2	0	1474	821	221	708	367	35
42253	Data_mining	200808	37	5	0	0	22	15	5	0	1511	837	226	731	376	36
42253	Data_mining	200809	15	4	0	0	12	4	4	0	1526	847	230	735	378	37
42253	Data_mining	200810	28	10	2	0	23	11	10	2	1554	866	240	747	385	40
42253	Data_mining	200811	21	4	0	0	16	11	2	0	1575	878	244	761	392	41
42253	Data_mining	200812	26	1	0	0	17	10	1	0	1601	891	245	780	399	41
42253	Data_mining	200901	33	6	0	0	20	11	6	0	1634	910	251	797	409	42
42253	Data_mining	200902	59	10	0	0	35	17	7	0	1693	940	261	838	421	46
42253	Data_mining	200903	65	5	0	0	30	14	5	0	1758	965	266	874	430	47
42253	Data_mining	200904	65	10	2	0	31	15	8	1	1823	991	276	918	440	50
42253	Data_mining	200905	86	14	2	1	29	19	10	2	1909	1013	290	991	452	59
42253	Data_mining	200906	9	1	0	0	5	3	1	0	1918	1016	291	996	453	59
42253	Data_mining	200907	30	3	0	0	12	8	2	0	1948	1025	294	1020	458	59
42253	Data_mining	200908	19	2	0	0	16	10	2	0	1967	1038	296	1032	466	59
42253	Data_mining	200909	30	10	0	0	21	11	8	0	1997	1054	306	1049	472	64
42253	Data_mining	200910	9	3	0	0	6	5	2	0	2006	1059	309	1057	476	66
42253	Data_mining	200911	21	5	0	0	15	11	5	0	2027	1071	314	1072	484	69
42253	Data_mining	200912	59	9	0	0	20	7	5	0	2086	1087	323	1091	487	69
42253	Data_mining	201001	181	2	0	0	9	7	2	0	2267	1094	325	1270	492	71
42253	Data_mining	201002	43	11	0	0	25	16	9	0	2310	1112	336	1298	502	72
42253	Data_mining	201003	29	7	0	0	20	10	5	0	2339	1126	343	1314	507	72
42253	Data_mining	201004	29	6	0	0	21	12	5	0	2368	1141	349	1333	513	72
42253	Data_mining	201005	20	6	0	0	16	7	4	0	2388	1154	355	1342	517	74
42253	Data_mining	201006	19	8	0	0	15	5	7	0	2407	1165	363	1351	519	75
42253	Data_mining	201007	20	3	0	0	16	10	3	0	2427	1177	366	1363	525	78
42253	Data_mining	201008	26	7	0	0	21	7	6	0	2453	1196	373	1372	530	78
42253	Data_mining	201009	21	4	0	0	14	9	3	0	2474	1205	377	1382	534	78
42253	Data_mining	201010	17	6	0	0	14	8	5	0	2491	1215	383	1392	538	79
42253	Data_mining	201011	14	4	0	0	12	6	4	0	2505	1224	387	1398	541	79
42253	Data_mining	201012	11	2	0	0	10	6	2	0	2516	1232	389	1404	545	80
42253	Data_mining	201101	17	3	0	0	10	6	3	0	2533	1240	392	1415	549	80
42253	Data_mining	201102	29	6	0	0	21	10	5	0	2562	1256	398	1426	554	80
42253	Data_mining	201103	9	3	0	0	7	4	2	0	2571	1261	401	1432	556	80
42253	Data_mining	201104	42	4	0	0	16	7	4	0	2613	1274	405	1461	560	80
42253	Data_mining	201105	40	3	0	0	25	15	3	0	2653	1296	408	1490	572	82
42253	Data_mining	201106	16	4	0	0	12	7	3	0	2669	1306	412	1499	577	84
42253	Data_mining	201107	14	3	0	0	10	6	3	0	2683	1315	415	1505	582	85
42253	Data_mining	201108	15	4	0	0	11	6	2	0	2698	1325	419	1515	587	85
42253	Data_mining	201109	24	2	0	0	13	6	2	0	2722	1336	421	1531	591	85
42253	Data_mining	201110	56	12	0	0	30	16	9	0	2778	1362	433	1563	603	88
42253	Data_mining	201111	36	4	0	0	20	14	3	0	2814	1375	437	1591	610	92
42253	Data_mining	201112	23	4	0	0	10	6	4	0	2837	1382	441	1610	613	94
42253	Data_mining	201201	20	3	0	0	14	10	3	0	2857	1393	444	1623	620	94
42253	Data_mining	201202	33	3	0	0	15	6	3	0	2890	1404	447	1631	623	95
42253	Data_mining	201203	12	1	0	0	11	4	1	0	2902	1412	448	1635	625	95
42253	Data_mining	201204	15	1	0	0	14	9	1	0	2917	1423	449	1645	631	95
42253	Data_mining	201205	11	4	0	0	11	5	4	0	2928	1433	453	1650	635	95
42253	Data_mining	201206	13	1	0	0	10	5	1	0	2941	1440	454	1656	637	95
42253	Data_mining	201207	16	3	0	0	14	8	3	0	2957	1453	457	1665	644	96
42253	Data_mining	201208	13	4	0	0	12	6	4	0	2970	1461	461	1671	646	96
42253	Data_mining	201209	30	4	0	0	18	8	4	0	3000	1476	465	1688	651	97
42253	Data_mining	201210	13	4	0	0	10	5	3	0	3013	1484	469	1696	654	97
42253	Data_mining	201211	19	3	0	0	10	4	2	0	3032	1492	472	1707	657	98
42253	Data_mining	201212	24	4	0	0	13	7	4	0	3056	1501	476	1725	660	101
42253	Data_mining	201301	20	2	0	0	8	4	2	0	3076	1507	478	1738	662	101
42253	Data_mining	201302	24	6	0	0	16	11	6	0	3100	1519	484	1756	669	104
42253	Data_mining	201303	21	4	0	0	15	9	4	0	3121	1533	488	1771	677	106
42253	Data_mining	201304	25	2	0	0	16	10	2	0	3146	1545	490	1785	683	106
42253	Data_mining	201305	23	6	2	1	10	4	4	2	3169	1554	496	1797	686	107
42253	Data_mining	201306	19	2	0	0	14	6	2	0	3188	1565	498	1803	690	107
42253	Data_mining	201307	12	3	0	0	11	6	3	0	3200	1574	501	1809	694	108
42253	Data_mining	201308	17	7	0	0	12	6	6	0	3217	1583	508	1816	697	110
42253	Data_mining	201309	12	4	1	0	9	6	4	1	3229	1590	512	1824	701	112
42253	Data_mining	201310	11	1	0	0	7	4	1	0	3240	1595	513	1831	703	112
42253	Data_mining	201311	16	5	0	0	10	3	3	0	3256	1604	518	1836	705	112
42253	Data_mining	201312	8	1	0	0	8	6	1	0	3264	1611	519	1842	710	113
42253	Data_mining	201401	8	2	0	0	7	4	2	0	3272	1615	521	1846	711	113
42253	Data_mining	201402	42	8	0	0	24	10	5	0	3314	1635	529	1862	717	114
42253	Data_mining	201403	14	2	0	0	11	7	2	0	3328	1644	531	1872	722	115
42253	Data_mining	201404	10	4	0	0	8	3	3	0	3338	1651	535	1877	724	115
42253	Data_mining	201405	12	0	0	0	9	6	0	0	3350	1659	535	1885	729	115
42253	Data_mining	201406	12	2	0	0	9	5	2	0	3362	1665	537	1892	731	117
42253	Data_mining	201407	24	4	0	0	14	11	4	0	3386	1676	541	1911	739	119
42253	Data_mining	201408	13	4	0	0	9	5	3	0	3399	1682	545	1918	741	119
42253	Data_mining	201409	14	4	1	0	10	5	3	1	3413	1688	549	1924	742	120
42253	Data_mining	201410	12	2	0	0	11	7	2	0	3425	1697	551	1931	747	120
42253	Data_mining	201411	20	6	0	0	11	5	5	0	3445	1706	557	1938	750	122
42253	Data_mining	201412	35	3	0	0	13	9	3	0	3480	1713	560	1967	753	123
42253	Data_mining	201501	8	1	0	0	7	4	1	0	3488	1718	561	1971	755	123
42253	Data_mining	201502	11	2	0	0	9	4	2	0	3499	1724	563	1976	757	123
42253	Data_mining	201503	5	0	0	0	3	1	0	0	3504	1726	563	1978	757	123
42253	Data_mining	201504	1	0	0	0	1	1	0	0	3505	1727	563	1979	758	123
42253	Data_mining	201505	7	3	0	0	7	4	3	0	3512	1731	566	1983	759	123
42253	Data_mining	201506	12	3	0	0	10	6	3	0	3524	1740	569	1991	764	125
42253	Data_mining	201507	11	4	0	0	8	3	3	0	3535	1745	573	1995	764	125
42253	Data_mining	201508	24	4	0	0	16	8	4	0	3559	1757	577	2009	768	127
42253	Data_mining	201509	8	2	0	0	8	6	2	0	3567	1760	579	2015	769	128
42253	Data_mining	201510	10	1	0	0	6	5	1	0	3577	1763	580	2024	771	128
42253	Data_mining	201511	2	1	0	0	2	1	1	0	3579	1764	581	2025	771	128
42253	Data_mining	201512	24	3	0	0	14	8	3	0	3603	1776	584	2036	777	128
42253	Data_mining	201601	14	2	0	0	7	6	1	0	3617	1781	586	2046	780	128
42253	Data_mining	201602	7	2	0	0	7	5	2	0	3624	1785	588	2051	782	128
42253	Data_mining	201603	5	0	0	0	2	1	0	0	3629	1787	588	2054	783	128
42253	Data_mining	201604	3	1	0	0	3	3	1	0	3632	1789	589	2057	785	129
42253	Data_mining	201605	30	7	0	0	17	13	5	0	3662	1801	596	2079	791	135
42253	Data_mining	201606	18	5	0	0	11	10	4	0	3680	1806	601	2095	794	139
42253	Data_mining	201607	7	1	0	0	4	2	1	0	3687	1809	602	2099	795	139
42253	Data_mining	201608	5	2	0	0	4	3	2	0	3692	1811	604	2102	796	140
42253	Data_mining	201609	7	0	0	0	4	3	0	0	3699	1814	604	2107	798	140
42253	Data_mining	201610	13	5	0	0	7	4	2	0	3712	1819	609	2114	800	140
42253	Data_mining	201611	14	5	1	0	9	6	5	1	3726	1824	614	2125	802	142
42253	Data_mining	201612	8	3	0	0	7	4	3	0	3734	1828	617	2129	803	143
42253	Data_mining	201701	12	2	0	0	9	7	2	0	3746	1835	619	2138	807	145
42253	Data_mining	201702	22	3	0	0	10	7	2	0	3768	1841	622	2152	810	145
42253	Data_mining	201703	16	4	0	0	14	8	4	0	3784	1852	626	2161	815	145
42253	Data_mining	201704	20	7	0	0	17	11	6	0	3804	1864	633	2173	819	149
42253	Data_mining	201705	3	1	0	0	3	1	1	0	3807	1867	634	2174	820	150
42253	Data_mining	201706	9	3	0	0	7	5	3	0	3816	1872	637	2181	822	152
42253	Data_mining	201707	11	2	0	0	8	5	2	0	3827	1879	639	2187	825	152
42253	Data_mining	201708	5	2	0	0	5	3	2	0	3832	1883	641	2190	827	152
42253	Data_mining	201709	6	1	0	0	5	4	1	0	3838	1888	642	2195	830	152
42253	Data_mining	201710	16	3	0	0	11	8	3	0	3854	1895	645	2207	834	152
42253	Data_mining	201711	4	1	0	0	4	2	1	0	3858	1898	646	2209	835	152
42253	Data_mining	201712	13	4	0	0	11	4	4	0	3871	1907	650	2214	837	153
42253	Data_mining	201801	7	2	0	0	7	5	2	0	3878	1912	652	2219	840	153
42253	Data_mining	201802	19	8	0	0	16	12	8	0	3897	1921	660	2234	845	158
42253	Data_mining	201803	6	2	0	0	5	1	2	0	3903	1925	662	2235	845	158
42253	Data_mining	201804	10	2	0	0	9	6	2	0	3913	1932	664	2241	849	159
42253	Data_mining	201805	8	2	0	0	6	4	2	0	3921	1936	666	2246	851	160
42253	Data_mining	201806	4	1	0	0	4	3	1	0	3925	1939	667	2249	853	160
42253	Data_mining	201807	3	0	0	0	1	1	0	0	3928	1940	667	2252	854	160
3461736	Data_visualization	200801	1	0	0	0	1	1	0	0	1	1	0	1	1	0
3461736	Data_visualization	200803	1	0	0	0	1	1	0	0	2	2	0	2	2	0
3461736	Data_visualization	200806	1	0	0	0	1	1	0	0	3	3	0	3	3	0
3461736	Data_visualization	200807	1	0	0	0	1	1	0	0	4	4	0	4	4	0
3461736	Data_visualization	200808	4	0	0	0	1	1	0	0	8	4	0	8	4	0
3461736	Data_visualization	200809	11	0	0	0	5	4	0	0	19	8	0	17	7	0
3461736	Data_visualization	200810	3	1	0	0	3	1	1	0	22	10	1	18	7	0
3461736	Data_visualization	200811	4	1	0	0	4	3	1	0	26	13	2	21	9	0
3461736	Data_visualization	200812	3	1	0	0	2	1	1	0	29	14	3	22	9	0
3461736	Data_visualization	200901	4	1	0	0	4	2	1	0	33	17	4	24	10	0
3461736	Data_visualization	200902	8	1	0	0	6	4	1	0	41	22	5	30	13	1
3461736	Data_visualization	200903	7	1	0	0	5	4	1	0	48	25	6	36	16	1
3461736	Data_visualization	200905	5	1	0	0	2	2	1	0	53	25	7	41	16	2
3461736	Data_visualization	200907	4	0	0	0	4	3	0	0	57	29	7	44	19	2
3461736	Data_visualization	200908	1	0	0	0	1	1	0	0	58	30	7	45	20	2
3461736	Data_visualization	200909	10	2	0	0	6	4	2	0	68	35	9	52	23	3
3461736	Data_visualization	200910	11	2	0	0	7	3	1	0	79	40	11	56	24	4
3461736	Data_visualization	200911	7	0	0	0	5	4	0	0	86	44	11	62	27	4
3461736	Data_visualization	200912	7	0	0	0	1	1	0	0	93	44	11	69	27	4
3461736	Data_visualization	201001	2	0	0	0	1	0	0	0	95	45	11	69	27	4
3461736	Data_visualization	201002	4	1	0	0	3	3	1	0	99	48	12	73	30	5
3461736	Data_visualization	201003	2	0	0	0	2	2	0	0	101	50	12	75	32	5
3461736	Data_visualization	201004	1	0	0	0	1	1	0	0	102	51	12	76	33	5
3461736	Data_visualization	201005	1	0	0	0	1	1	0	0	103	52	12	77	34	5
3461736	Data_visualization	201006	3	0	0	0	1	1	0	0	106	52	12	80	34	5
3461736	Data_visualization	201007	1	0	0	0	1	1	0	0	107	53	12	81	35	5
3461736	Data_visualization	201008	3	0	0	0	2	0	0	0	110	55	12	81	35	5
3461736	Data_visualization	201009	11	2	0	0	8	4	2	0	121	62	14	86	38	6
3461736	Data_visualization	201010	4	0	0	0	3	0	0	0	125	65	14	86	38	6
3461736	Data_visualization	201011	21	1	0	0	10	6	1	0	146	74	15	96	43	7
3461736	Data_visualization	201012	7	0	0	0	5	2	0	0	153	79	15	99	45	7
3461736	Data_visualization	201101	14	1	0	0	7	5	1	0	167	85	16	108	49	7
3461736	Data_visualization	201102	3	0	0	0	3	1	0	0	170	87	16	109	49	7
3461736	Data_visualization	201103	8	0	0	0	5	4	0	0	178	91	16	116	52	7
3461736	Data_visualization	201104	7	3	1	0	4	2	2	1	185	94	19	120	53	9
3461736	Data_visualization	201105	9	1	0	0	8	6	1	0	194	101	20	127	58	10
3461736	Data_visualization	201106	6	0	0	0	6	5	0	0	200	106	20	132	62	10
3461736	Data_visualization	201107	3	1	0	0	3	2	1	0	203	109	21	134	64	10
3461736	Data_visualization	201108	9	2	1	0	6	3	2	1	212	114	23	140	66	11
3461736	Data_visualization	201109	7	1	0	0	5	2	1	0	219	117	24	142	67	11
3461736	Data_visualization	201110	3	0	0	0	3	2	0	0	222	120	24	144	69	11
3461736	Data_visualization	201111	7	0	0	0	6	4	0	0	229	126	24	149	73	11
3461736	Data_visualization	201112	5	1	0	0	4	2	1	0	234	129	25	152	74	11
3461736	Data_visualization	201202	4	1	0	0	4	3	1	0	238	132	26	155	76	12
3461736	Data_visualization	201203	15	2	0	0	11	8	2	0	253	141	28	165	82	13
3461736	Data_visualization	201204	6	0	0	0	5	4	0	0	259	144	28	170	84	13
3461736	Data_visualization	201205	1	0	0	0	1	0	0	0	260	145	28	170	84	13
3461736	Data_visualization	201206	6	0	0	0	5	5	0	0	266	149	28	176	88	13
3461736	Data_visualization	201207	1	0	0	0	1	0	0	0	267	150	28	176	88	13
3461736	Data_visualization	201208	7	1	0	0	5	5	1	0	274	154	29	183	92	14
3461736	Data_visualization	201209	4	1	0	0	4	3	1	0	278	156	30	186	93	14
3461736	Data_visualization	201210	2	0	0	0	2	1	0	0	280	158	30	187	94	14
3461736	Data_visualization	201211	5	1	0	0	4	4	1	0	285	162	31	192	98	15
3461736	Data_visualization	201212	7	1	0	0	6	3	1	0	292	168	32	195	101	15
3461736	Data_visualization	201301	8	0	0	0	5	3	0	0	300	172	32	200	103	15
3461736	Data_visualization	201302	11	4	0	0	9	4	3	0	311	181	36	206	107	17
3461736	Data_visualization	201303	9	0	0	0	7	7	0	0	320	187	36	215	113	17
3461736	Data_visualization	201304	6	0	0	0	5	3	0	0	326	192	36	219	116	17
3461736	Data_visualization	201305	16	0	0	0	8	5	0	0	342	199	36	231	120	17
3461736	Data_visualization	201306	9	0	0	0	9	2	0	0	351	208	36	233	122	17
3461736	Data_visualization	201307	1	0	0	0	1	0	0	0	352	209	36	233	122	17
3461736	Data_visualization	201308	9	1	0	0	6	4	1	0	361	214	37	240	125	18
3461736	Data_visualization	201309	8	2	0	0	6	5	1	0	369	218	39	247	128	20
3461736	Data_visualization	201310	2	0	0	0	2	1	0	0	371	220	39	248	129	20
3461736	Data_visualization	201311	1	0	0	0	1	0	0	0	372	221	39	248	129	20
3461736	Data_visualization	201312	12	0	0	0	5	5	0	0	384	225	39	260	133	20
3461736	Data_visualization	201401	22	3	0	0	12	8	3	0	406	234	42	276	138	23
3461736	Data_visualization	201402	1	0	0	0	1	1	0	0	407	235	42	277	139	23
3461736	Data_visualization	201403	2	1	0	0	2	2	1	0	409	237	43	279	141	24
3461736	Data_visualization	201404	1	0	0	0	1	0	0	0	410	238	43	279	141	24
3461736	Data_visualization	201405	2	0	0	0	2	2	0	0	412	240	43	281	143	24
3461736	Data_visualization	201406	1	0	0	0	1	1	0	0	413	241	43	282	144	24
3461736	Data_visualization	201407	2	0	0	0	2	2	0	0	415	243	43	284	146	24
3461736	Data_visualization	201408	4	0	0	0	4	2	0	0	419	247	43	286	148	24
3461736	Data_visualization	201409	2	0	0	0	2	2	0	0	421	248	43	288	149	24
3461736	Data_visualization	201410	29	0	0	0	5	2	0	0	450	253	43	312	151	24
3461736	Data_visualization	201411	40	1	0	0	5	5	1	0	490	256	44	352	154	25
3461736	Data_visualization	201412	17	2	0	0	6	4	2	0	507	259	46	366	155	25
3461736	Data_visualization	201501	1	0	0	0	1	1	0	0	508	259	46	367	155	25
3461736	Data_visualization	201502	6	0	0	0	4	3	0	0	514	261	46	372	156	25
3461736	Data_visualization	201504	3	0	0	0	3	3	0	0	517	264	46	375	159	25
3461736	Data_visualization	201505	3	0	0	0	2	2	0	0	520	265	46	378	160	25
3461736	Data_visualization	201506	14	0	0	0	5	5	0	0	534	267	46	392	162	25
3461736	Data_visualization	201507	8	1	0	0	5	4	1	0	542	270	47	399	164	25
3461736	Data_visualization	201508	1	0	0	0	1	1	0	0	543	271	47	400	165	25
3461736	Data_visualization	201509	3	0	0	0	2	1	0	0	546	272	47	401	165	25
3461736	Data_visualization	201510	9	1	0	0	6	5	1	0	555	277	48	409	169	26
3461736	Data_visualization	201511	1	0	0	0	1	0	0	0	556	278	48	409	169	26
3461736	Data_visualization	201512	14	1	0	0	10	7	1	0	570	287	49	419	175	26
3461736	Data_visualization	201601	6	0	0	0	5	4	0	0	576	292	49	424	179	26
3461736	Data_visualization	201602	2	0	0	0	1	1	0	0	578	292	49	426	179	26
3461736	Data_visualization	201603	2	0	0	0	2	2	0	0	580	294	49	428	181	26
3461736	Data_visualization	201604	6	0	0	0	5	3	0	0	586	298	49	431	183	26
3461736	Data_visualization	201605	8	0	0	0	6	5	0	0	594	302	49	438	185	26
3461736	Data_visualization	201606	6	0	0	0	4	2	0	0	600	306	49	441	187	26
3461736	Data_visualization	201607	1	0	0	0	1	1	0	0	601	307	49	442	188	26
3461736	Data_visualization	201608	1	0	0	0	1	1	0	0	602	308	49	443	189	26
3461736	Data_visualization	201609	2	0	0	0	2	1	0	0	604	310	49	444	190	26
3461736	Data_visualization	201610	5	1	0	0	5	3	1	0	609	313	50	447	191	26
3461736	Data_visualization	201611	4	1	0	0	3	2	1	0	613	316	51	449	193	26
3461736	Data_visualization	201612	8	2	0	0	7	5	2	0	621	320	53	454	195	26
3461736	Data_visualization	201701	2	0	0	0	2	2	0	0	623	321	53	456	196	26
3461736	Data_visualization	201702	6	0	0	0	5	5	0	0	629	325	53	462	200	26
3461736	Data_visualization	201703	9	2	0	0	5	3	1	0	638	329	55	466	202	27
3461736	Data_visualization	201704	1	0	0	0	1	1	0	0	639	330	55	467	203	27
3461736	Data_visualization	201705	1	0	0	0	1	1	0	0	640	331	55	468	204	27
3461736	Data_visualization	201706	2	0	0	0	1	1	0	0	642	331	55	470	204	27
3461736	Data_visualization	201707	4	0	0	0	2	2	0	0	646	333	55	474	206	27
3461736	Data_visualization	201708	3	0	0	0	2	1	0	0	649	335	55	475	207	27
3461736	Data_visualization	201709	6	0	0	0	3	2	0	0	655	338	55	480	209	27
3461736	Data_visualization	201710	1	0	0	0	1	1	0	0	656	339	55	481	210	27
3461736	Data_visualization	201711	12	0	0	0	4	3	0	0	668	342	55	492	212	27
3461736	Data_visualization	201712	17	0	0	0	7	5	0	0	685	348	55	507	216	27
3461736	Data_visualization	201801	1	0	0	0	1	1	0	0	686	349	55	508	217	27
3461736	Data_visualization	201802	9	0	0	0	7	5	0	0	695	354	55	514	220	27
3461736	Data_visualization	201803	8	2	0	0	8	4	2	0	703	362	57	518	224	27
3461736	Data_visualization	201804	5	0	0	0	3	3	0	0	708	365	57	523	227	27
3461736	Data_visualization	201805	5	1	0	0	4	3	1	0	713	369	58	527	230	27
3461736	Data_visualization	201806	2	0	0	0	2	2	0	0	715	371	58	529	232	27
3461736	Data_visualization	201807	5	1	0	0	5	4	1	0	720	376	59	533	236	27
864364	Dataflow	200411	2	0	0	0	2	1	0	0	2	2	0	1	1	0
864364	Dataflow	200501	2	0	0	0	2	1	0	0	4	4	0	2	2	0
864364	Dataflow	200506	1	0	0	0	1	1	0	0	5	5	0	3	3	0
864364	Dataflow	200507	1	0	0	0	1	1	0	0	6	6	0	4	4	0
864364	Dataflow	200508	2	0	0	0	1	1	0	0	8	6	0	6	4	0
864364	Dataflow	200509	1	0	0	0	1	0	0	0	9	7	0	6	4	0
864364	Dataflow	200512	7	0	0	0	4	1	0	0	16	11	0	8	5	0
864364	Dataflow	200601	1	0	0	0	1	1	0	0	17	12	0	9	6	0
864364	Dataflow	200603	15	0	0	0	2	1	0	0	32	14	0	23	7	0
864364	Dataflow	200604	2	0	0	0	2	2	0	0	34	15	0	25	8	0
864364	Dataflow	200605	1	0	0	0	1	1	0	0	35	16	0	26	9	0
864364	Dataflow	200606	3	1	0	0	3	2	1	0	38	19	1	28	11	0
864364	Dataflow	200607	1	0	0	0	1	1	0	0	39	20	1	29	12	0
864364	Dataflow	200608	2	0	0	0	2	0	0	0	41	22	1	29	12	0
864364	Dataflow	200609	2	0	0	0	2	2	0	0	43	24	1	31	14	0
864364	Dataflow	200610	5	0	0	0	5	2	0	0	48	29	1	33	16	0
864364	Dataflow	200611	3	0	0	0	3	2	0	0	51	32	1	35	18	0
864364	Dataflow	200612	15	1	0	0	7	2	1	0	66	39	2	37	20	0
864364	Dataflow	200701	3	0	0	0	3	3	0	0	69	42	2	40	23	0
864364	Dataflow	200702	6	1	0	0	5	3	1	0	75	47	3	43	26	0
864364	Dataflow	200703	1	0	0	0	1	1	0	0	76	48	3	44	27	0
864364	Dataflow	200704	1	0	0	0	1	0	0	0	77	49	3	44	27	0
864364	Dataflow	200706	6	0	0	0	4	1	0	0	83	52	3	45	27	0
864364	Dataflow	200707	4	0	0	0	4	2	0	0	87	56	3	47	29	0
864364	Dataflow	200708	3	0	0	0	2	2	0	0	90	57	3	50	30	0
864364	Dataflow	200709	3	0	0	0	1	1	0	0	93	57	3	53	30	0
864364	Dataflow	200710	4	0	0	0	2	1	0	0	97	59	3	56	31	0
864364	Dataflow	200711	4	0	0	0	4	2	0	0	101	63	3	58	33	0
864364	Dataflow	200712	1	0	0	0	1	1	0	0	102	64	3	59	34	0
864364	Dataflow	200801	2	0	0	0	1	1	0	0	104	65	3	61	35	0
864364	Dataflow	200802	4	0	0	0	3	1	0	0	108	68	3	62	36	0
864364	Dataflow	200803	14	3	0	0	8	2	3	0	122	75	6	64	37	0
864364	Dataflow	200804	2	0	0	0	2	1	0	0	124	76	6	65	37	0
864364	Dataflow	200805	3	0	0	0	3	2	0	0	127	79	6	67	39	0
864364	Dataflow	200806	2	0	0	0	2	1	0	0	129	81	6	68	40	0
864364	Dataflow	200807	4	0	0	0	4	2	0	0	133	84	6	70	41	0
864364	Dataflow	200808	1	0	0	0	1	1	0	0	134	85	6	71	42	0
864364	Dataflow	200809	1	0	0	0	1	1	0	0	135	86	6	72	43	0
864364	Dataflow	200810	9	2	0	0	4	3	2	0	144	90	8	75	46	0
864364	Dataflow	200811	2	0	0	0	1	0	0	0	146	91	8	75	46	0
864364	Dataflow	200812	5	2	0	0	4	2	2	0	151	95	10	77	48	0
864364	Dataflow	200901	3	0	0	0	2	1	0	0	154	97	10	78	49	0
864364	Dataflow	200902	6	3	0	0	4	3	3	0	160	100	13	81	51	0
864364	Dataflow	200903	2	0	0	0	1	0	0	0	162	101	13	81	51	0
864364	Dataflow	200904	1	0	0	0	1	0	0	0	163	102	13	81	51	0
864364	Dataflow	200905	1	0	0	0	1	1	0	0	164	103	13	82	52	0
864364	Dataflow	200906	5	1	0	0	5	2	1	0	169	108	14	84	54	0
864364	Dataflow	200907	3	0	0	0	1	1	0	0	172	109	14	87	55	0
864364	Dataflow	200909	2	0	0	0	2	0	0	0	174	111	14	87	55	0
864364	Dataflow	200910	3	0	0	0	2	1	0	0	177	113	14	88	56	0
864364	Dataflow	201001	1	0	0	0	1	0	0	0	178	114	14	88	56	0
864364	Dataflow	201002	2	0	0	0	2	1	0	0	180	115	14	89	57	0
864364	Dataflow	201005	2	0	0	0	2	0	0	0	182	116	14	89	57	0
864364	Dataflow	201006	1	0	0	0	1	1	0	0	183	117	14	90	58	0
864364	Dataflow	201008	2	0	0	0	2	0	0	0	185	119	14	90	58	0
864364	Dataflow	201010	2	0	0	0	2	2	0	0	187	121	14	92	60	0
864364	Dataflow	201011	4	1	0	0	4	2	1	0	191	125	15	94	62	0
864364	Dataflow	201101	3	1	0	0	2	0	1	0	194	127	16	94	62	0
864364	Dataflow	201102	3	0	0	0	2	1	0	0	197	129	16	95	63	0
864364	Dataflow	201104	3	0	0	0	2	2	0	0	200	131	16	98	65	0
864364	Dataflow	201106	1	0	0	0	1	1	0	0	201	132	16	99	66	0
864364	Dataflow	201107	2	1	0	0	2	1	1	0	203	134	17	100	67	0
864364	Dataflow	201110	1	0	0	0	1	0	0	0	204	135	17	100	67	0
864364	Dataflow	201111	1	0	0	0	1	1	0	0	205	136	17	101	68	0
864364	Dataflow	201202	2	1	0	0	2	1	1	0	207	138	18	102	69	0
864364	Dataflow	201205	1	0	0	0	1	0	0	0	208	139	18	102	69	0
864364	Dataflow	201207	4	3	1	0	3	2	3	1	212	141	21	104	70	1
864364	Dataflow	201209	1	0	0	0	1	1	0	0	213	142	21	105	71	1
864364	Dataflow	201212	1	0	0	0	1	0	0	0	214	143	21	105	71	1
864364	Dataflow	201302	4	1	0	0	4	2	1	0	218	147	22	107	73	1
864364	Dataflow	201304	1	0	0	0	1	1	0	0	219	148	22	108	74	1
864364	Dataflow	201306	2	0	0	0	2	2	0	0	221	150	22	110	76	1
864364	Dataflow	201308	2	0	0	0	2	1	0	0	223	152	22	111	77	1
864364	Dataflow	201309	7	0	0	0	4	3	0	0	230	155	22	117	79	1
864364	Dataflow	201310	4	1	0	0	3	1	1	0	234	157	23	118	79	1
864364	Dataflow	201311	1	0	0	0	1	0	0	0	235	158	23	118	79	1
864364	Dataflow	201312	2	0	0	0	2	2	0	0	237	159	23	120	80	1
864364	Dataflow	201402	1	0	0	0	1	0	0	0	238	160	23	120	80	1
864364	Dataflow	201403	4	1	0	0	4	2	1	0	242	163	24	122	81	1
864364	Dataflow	201411	1	0	0	0	1	0	0	0	243	164	24	122	81	1
864364	Dataflow	201503	3	1	0	0	3	1	1	0	246	167	25	123	82	1
864364	Dataflow	201504	3	0	0	0	2	1	0	0	249	168	25	124	82	1
864364	Dataflow	201506	1	0	0	0	1	0	0	0	250	169	25	124	82	1
864364	Dataflow	201509	2	0	0	0	2	1	0	0	252	171	25	125	83	1
864364	Dataflow	201510	3	1	0	0	2	1	1	0	255	173	26	126	84	1
864364	Dataflow	201511	5	0	0	0	5	2	0	0	260	178	26	128	86	1
864364	Dataflow	201602	1	0	0	0	1	1	0	0	261	179	26	129	87	1
864364	Dataflow	201604	1	0	0	0	1	1	0	0	262	180	26	130	88	1
864364	Dataflow	201607	2	0	0	0	2	1	0	0	264	182	26	131	89	1
864364	Dataflow	201608	1	0	0	0	1	1	0	0	265	183	26	132	90	1
864364	Dataflow	201609	2	0	0	0	2	2	0	0	267	185	26	134	91	1
864364	Dataflow	201611	1	0	0	0	1	1	0	0	268	186	26	135	92	1
864364	Dataflow	201701	2	0	0	0	2	1	0	0	270	188	26	136	93	1
864364	Dataflow	201702	2	1	0	0	2	2	1	0	272	190	27	138	95	2
864364	Dataflow	201703	3	0	0	0	2	2	0	0	275	192	27	141	97	2
864364	Dataflow	201705	1	0	0	0	1	0	0	0	276	193	27	141	97	2
864364	Dataflow	201709	3	1	0	0	3	2	1	0	279	196	28	143	99	2
864364	Dataflow	201710	1	0	0	0	1	1	0	0	280	197	28	144	100	2
864364	Dataflow	201801	2	0	0	0	2	1	0	0	282	199	28	145	101	2
864364	Dataflow	201802	2	0	0	0	2	0	0	0	284	201	28	145	101	2
864364	Dataflow	201805	2	0	0	0	1	1	0	0	286	202	28	147	102	2
864364	Dataflow	201806	3	1	0	0	2	0	1	0	289	204	29	147	102	2
1500599	Datagram_Transport_Layer_Security	200506	2	0	0	0	2	0	0	0	2	2	0	0	0	0
1500599	Datagram_Transport_Layer_Security	200507	1	0	0	0	1	1	0	0	3	3	0	1	1	0
1500599	Datagram_Transport_Layer_Security	200508	4	0	0	0	2	1	0	0	7	5	0	2	2	0
1500599	Datagram_Transport_Layer_Security	200604	1	0	0	0	1	1	0	0	8	6	0	3	3	0
1500599	Datagram_Transport_Layer_Security	200605	1	0	0	0	1	1	0	0	9	7	0	4	4	0
1500599	Datagram_Transport_Layer_Security	200606	2	0	0	0	2	2	0	0	11	9	0	6	6	0
1500599	Datagram_Transport_Layer_Security	200612	2	0	0	0	2	0	0	0	13	11	0	6	6	0
1500599	Datagram_Transport_Layer_Security	200703	1	0	0	0	1	1	0	0	14	12	0	7	7	0
1500599	Datagram_Transport_Layer_Security	200705	2	0	0	0	2	2	0	0	16	14	0	9	9	0
1500599	Datagram_Transport_Layer_Security	200706	1	0	0	0	1	1	0	0	17	15	0	10	10	0
1500599	Datagram_Transport_Layer_Security	200708	1	0	0	0	1	1	0	0	18	16	0	11	11	0
1500599	Datagram_Transport_Layer_Security	200709	3	0	0	0	1	1	0	0	21	17	0	14	12	0
1500599	Datagram_Transport_Layer_Security	200711	2	0	0	0	1	1	0	0	23	18	0	16	13	0
1500599	Datagram_Transport_Layer_Security	200712	1	0	0	0	1	1	0	0	24	19	0	17	14	0
1500599	Datagram_Transport_Layer_Security	200807	1	0	0	0	1	1	0	0	25	20	0	18	15	0
1500599	Datagram_Transport_Layer_Security	200809	1	0	0	0	1	1	0	0	26	21	0	19	16	0
1500599	Datagram_Transport_Layer_Security	200810	2	1	0	0	2	2	1	0	28	23	1	21	18	1
1500599	Datagram_Transport_Layer_Security	200811	1	0	0	0	1	0	0	0	29	24	1	21	18	1
1500599	Datagram_Transport_Layer_Security	200907	2	1	0	0	2	2	1	0	31	26	2	23	20	2
1500599	Datagram_Transport_Layer_Security	200911	1	0	0	0	1	1	0	0	32	27	2	24	21	2
1500599	Datagram_Transport_Layer_Security	201008	2	0	0	0	1	1	0	0	34	28	2	26	22	2
1500599	Datagram_Transport_Layer_Security	201011	1	0	0	0	1	1	0	0	35	29	2	27	23	2
1500599	Datagram_Transport_Layer_Security	201103	2	1	0	0	2	1	1	0	37	31	3	28	24	2
1500599	Datagram_Transport_Layer_Security	201105	2	1	0	0	2	1	1	0	39	32	4	29	24	2
1500599	Datagram_Transport_Layer_Security	201108	2	0	0	0	2	2	0	0	41	33	4	31	25	2
1500599	Datagram_Transport_Layer_Security	201112	2	1	0	0	2	1	1	0	43	35	5	32	26	2
1500599	Datagram_Transport_Layer_Security	201201	1	0	0	0	1	0	0	0	44	36	5	32	26	2
1500599	Datagram_Transport_Layer_Security	201204	1	0	0	0	1	0	0	0	45	37	5	32	26	2
1500599	Datagram_Transport_Layer_Security	201205	1	0	0	0	1	0	0	0	46	38	5	32	26	2
1500599	Datagram_Transport_Layer_Security	201208	2	1	0	0	2	1	1	0	48	40	6	33	27	2
1500599	Datagram_Transport_Layer_Security	201211	1	0	0	0	1	1	0	0	49	41	6	34	28	2
1500599	Datagram_Transport_Layer_Security	201212	6	0	0	0	4	4	0	0	55	45	6	40	32	2
1500599	Datagram_Transport_Layer_Security	201302	7	0	0	0	3	2	0	0	62	47	6	46	33	2
1500599	Datagram_Transport_Layer_Security	201303	3	0	0	0	3	3	0	0	65	49	6	49	35	2
1500599	Datagram_Transport_Layer_Security	201305	4	0	0	0	4	4	0	0	69	50	6	53	36	2
1500599	Datagram_Transport_Layer_Security	201306	2	0	0	0	1	1	0	0	71	51	6	55	37	2
1500599	Datagram_Transport_Layer_Security	201307	3	0	0	0	2	1	0	0	74	52	6	56	37	2
1500599	Datagram_Transport_Layer_Security	201308	4	0	0	0	3	1	0	0	78	55	6	58	37	2
1500599	Datagram_Transport_Layer_Security	201309	3	0	0	0	2	1	0	0	81	57	6	59	38	2
1500599	Datagram_Transport_Layer_Security	201311	2	0	0	0	2	1	0	0	83	58	6	60	38	2
1500599	Datagram_Transport_Layer_Security	201312	4	0	0	0	3	1	0	0	87	61	6	62	39	2
1500599	Datagram_Transport_Layer_Security	201401	1	0	0	0	1	1	0	0	88	62	6	63	39	2
1500599	Datagram_Transport_Layer_Security	201402	1	0	0	0	1	1	0	0	89	62	6	64	39	2
1500599	Datagram_Transport_Layer_Security	201403	1	0	0	0	1	0	0	0	90	63	6	64	39	2
1500599	Datagram_Transport_Layer_Security	201404	1	0	0	0	1	1	0	0	91	63	6	65	39	2
1500599	Datagram_Transport_Layer_Security	201406	3	0	0	0	3	3	0	0	94	66	6	68	42	2
1500599	Datagram_Transport_Layer_Security	201407	1	0	0	0	1	1	0	0	95	67	6	69	43	2
1500599	Datagram_Transport_Layer_Security	201408	5	0	0	0	3	3	0	0	100	69	6	74	45	2
1500599	Datagram_Transport_Layer_Security	201409	3	0	0	0	3	3	0	0	103	72	6	77	48	2
1500599	Datagram_Transport_Layer_Security	201410	2	0	0	0	2	1	0	0	105	73	6	78	48	2
1500599	Datagram_Transport_Layer_Security	201411	3	0	0	0	2	1	0	0	108	74	6	80	48	2
1500599	Datagram_Transport_Layer_Security	201501	3	0	0	0	3	3	0	0	111	76	6	83	49	2
1500599	Datagram_Transport_Layer_Security	201502	7	1	0	0	4	1	1	0	118	79	7	86	49	2
1500599	Datagram_Transport_Layer_Security	201503	4	0	0	0	3	2	0	0	122	80	7	89	49	2
1500599	Datagram_Transport_Layer_Security	201505	5	0	0	0	3	3	0	0	127	81	7	94	50	2
1500599	Datagram_Transport_Layer_Security	201506	4	0	0	0	2	2	0	0	131	81	7	98	50	2
1500599	Datagram_Transport_Layer_Security	201507	2	0	0	0	2	2	0	0	133	81	7	100	50	2
1500599	Datagram_Transport_Layer_Security	201508	1	0	0	0	1	1	0	0	134	82	7	101	51	2
1500599	Datagram_Transport_Layer_Security	201509	3	0	0	0	2	2	0	0	137	83	7	104	52	2
1500599	Datagram_Transport_Layer_Security	201510	1	0	0	0	1	0	0	0	138	84	7	104	52	2
1500599	Datagram_Transport_Layer_Security	201511	3	0	0	0	2	0	0	0	141	86	7	104	52	2
1500599	Datagram_Transport_Layer_Security	201602	1	0	0	0	1	1	0	0	142	87	7	105	53	2
1500599	Datagram_Transport_Layer_Security	201606	1	0	0	0	1	0	0	0	143	88	7	105	53	2
1500599	Datagram_Transport_Layer_Security	201608	1	0	0	0	1	1	0	0	144	89	7	106	54	2
1500599	Datagram_Transport_Layer_Security	201609	1	0	0	0	1	1	0	0	145	90	7	107	55	2
1500599	Datagram_Transport_Layer_Security	201611	1	0	0	0	1	0	0	0	146	91	7	107	55	2
1500599	Datagram_Transport_Layer_Security	201612	1	0	0	0	1	1	0	0	147	92	7	108	56	2
1500599	Datagram_Transport_Layer_Security	201702	1	0	0	0	1	1	0	0	148	93	7	109	57	2
1500599	Datagram_Transport_Layer_Security	201704	5	0	0	0	2	1	0	0	153	95	7	113	58	2
1500599	Datagram_Transport_Layer_Security	201705	1	0	0	0	1	1	0	0	154	96	7	114	59	2
1500599	Datagram_Transport_Layer_Security	201706	2	0	0	0	2	2	0	0	156	98	7	116	60	2
1500599	Datagram_Transport_Layer_Security	201708	1	0	0	0	1	1	0	0	157	99	7	117	61	2
1500599	Datagram_Transport_Layer_Security	201709	1	0	0	0	1	1	0	0	158	100	7	118	62	2
1500599	Datagram_Transport_Layer_Security	201710	1	0	0	0	1	1	0	0	159	101	7	119	63	2
1500599	Datagram_Transport_Layer_Security	201801	2	1	0	0	2	1	1	0	161	103	8	120	64	2
1500599	Datagram_Transport_Layer_Security	201803	2	0	0	0	2	1	0	0	163	104	8	121	64	2
1500599	Datagram_Transport_Layer_Security	201804	1	0	0	0	1	1	0	0	164	105	8	122	65	2
1500599	Datagram_Transport_Layer_Security	201805	2	0	0	0	1	1	0	0	166	106	8	124	66	2
1500599	Datagram_Transport_Layer_Security	201806	1	0	0	0	1	1	0	0	167	107	8	125	66	2
8242	Debian	200111	2	0	0	0	2	2	0	0	2	2	0	2	2	0
8242	Debian	200112	1	0	0	0	1	1	0	0	3	3	0	3	3	0
8242	Debian	200202	1	0	0	0	1	1	0	0	4	4	0	4	4	0
8242	Debian	200203	1	0	0	0	1	1	0	0	5	5	0	5	4	0
8242	Debian	200205	2	0	0	0	2	1	0	0	7	7	0	6	5	0
8242	Debian	200207	2	0	0	0	1	0	0	0	9	8	0	6	5	0
8242	Debian	200209	2	0	0	0	2	0	0	0	11	10	0	6	5	0
8242	Debian	200210	4	0	0	0	4	3	0	0	15	14	0	9	8	0
8242	Debian	200211	3	0	0	0	2	1	0	0	18	16	0	11	9	0
8242	Debian	200212	6	0	0	0	5	5	0	0	24	21	0	17	14	0
8242	Debian	200302	2	0	0	0	2	1	0	0	26	23	0	18	15	0
8242	Debian	200303	6	0	0	0	5	4	0	0	32	28	0	22	19	0
8242	Debian	200304	3	0	0	0	2	2	0	0	35	30	0	25	21	0
8242	Debian	200305	4	0	0	0	3	3	0	0	39	33	0	29	24	0
8242	Debian	200306	1	0	0	0	1	1	0	0	40	34	0	30	25	0
8242	Debian	200307	2	0	0	0	2	1	0	0	42	35	0	31	25	0
8242	Debian	200308	8	0	0	0	6	4	0	0	50	41	0	36	29	0
8242	Debian	200309	5	0	0	0	4	2	0	0	55	44	0	39	30	0
8242	Debian	200310	14	0	0	0	5	4	0	0	69	49	0	50	34	0
8242	Debian	200311	14	0	0	0	8	3	0	0	83	56	0	53	36	0
8242	Debian	200312	14	0	0	0	10	4	0	0	97	65	0	60	39	0
8242	Debian	200401	6	0	0	0	5	3	0	0	103	70	0	63	42	0
8242	Debian	200402	10	0	0	0	10	5	0	0	113	78	0	68	46	0
8242	Debian	200403	29	1	0	0	18	12	1	0	142	94	1	88	56	1
8242	Debian	200404	18	0	0	0	7	6	0	0	160	98	1	105	59	1
8242	Debian	200405	16	0	0	0	11	7	0	0	176	107	1	114	64	1
8242	Debian	200406	9	0	0	0	6	4	0	0	185	112	1	121	67	1
8242	Debian	200407	32	0	0	0	13	7	0	0	217	122	1	146	71	1
8242	Debian	200408	19	1	0	0	14	9	1	0	236	134	2	160	78	2
8242	Debian	200409	28	4	0	0	16	8	3	0	264	146	6	179	82	4
8242	Debian	200410	23	5	0	0	16	9	3	0	287	160	11	195	89	5
8242	Debian	200411	17	3	0	0	13	9	2	0	304	169	14	208	94	6
8242	Debian	200412	17	1	0	0	14	8	1	0	321	180	15	218	99	6
8242	Debian	200501	19	2	0	0	14	7	2	0	340	190	17	229	103	7
8242	Debian	200502	11	1	0	0	10	5	1	0	351	197	18	235	105	8
8242	Debian	200503	7	0	0	0	7	5	0	0	358	203	18	240	109	8
8242	Debian	200504	15	1	0	0	10	6	1	0	373	212	19	248	114	8
8242	Debian	200505	20	0	0	0	16	10	0	0	393	227	19	260	123	8
8242	Debian	200506	18	1	0	0	14	9	1	0	411	240	20	272	131	8
8242	Debian	200507	44	2	0	0	25	15	2	0	455	260	22	303	141	8
8242	Debian	200508	32	3	0	0	22	12	3	0	487	273	25	323	144	8
8242	Debian	200509	25	3	0	0	16	10	2	0	512	286	28	340	151	8
8242	Debian	200510	29	2	0	0	16	10	1	0	541	298	30	355	157	8
8242	Debian	200511	23	3	0	0	21	15	3	0	564	312	33	371	165	11
8242	Debian	200512	24	1	0	0	18	10	1	0	588	327	34	384	172	12
8242	Debian	200601	16	0	0	0	13	3	0	0	604	340	34	387	175	12
8242	Debian	200602	18	0	0	0	17	12	0	0	622	351	34	400	181	12
8242	Debian	200603	12	0	0	0	10	9	0	0	634	357	34	411	186	12
8242	Debian	200604	34	1	0	0	20	13	1	0	668	374	35	438	196	12
8242	Debian	200605	37	5	1	0	23	16	4	1	705	392	40	467	207	16
8242	Debian	200606	28	2	0	0	16	9	2	0	733	404	42	488	212	16
8242	Debian	200607	32	4	0	0	22	11	4	0	765	424	46	507	221	17
8242	Debian	200608	20	0	0	0	15	6	0	0	785	436	46	516	224	17
8242	Debian	200609	30	2	0	0	21	14	2	0	815	451	48	536	233	17
8242	Debian	200610	30	0	0	0	23	15	0	0	845	469	48	555	243	17
8242	Debian	200611	22	0	0	0	14	6	0	0	867	480	48	566	246	17
8242	Debian	200612	23	0	0	0	22	10	0	0	890	499	48	576	254	17
8242	Debian	200701	24	1	0	0	15	8	1	0	914	513	49	591	261	17
8242	Debian	200702	46	4	0	0	28	18	4	0	960	535	53	625	273	18
8242	Debian	200703	33	3	0	0	25	14	3	0	993	556	56	644	283	18
8242	Debian	200704	30	6	0	0	21	16	5	0	1023	571	62	669	293	20
8242	Debian	200705	75	8	0	0	48	24	6	0	1098	613	70	715	311	22
8242	Debian	200706	44	5	0	0	26	17	5	0	1142	630	75	750	319	23
8242	Debian	200707	9	1	0	0	9	6	1	0	1151	636	76	756	322	23
8242	Debian	200708	17	5	0	0	14	8	3	0	1168	645	81	767	325	24
8242	Debian	200709	35	2	0	0	19	12	2	0	1203	661	83	794	334	24
8242	Debian	200710	10	0	0	0	8	8	0	0	1213	666	83	804	339	24
8242	Debian	200711	20	3	0	0	16	12	3	0	1233	678	86	818	347	24
8242	Debian	200712	14	1	0	0	14	6	1	0	1247	688	87	824	349	24
8242	Debian	200801	13	3	1	0	9	7	3	1	1260	694	90	835	353	26
8242	Debian	200802	50	2	0	0	23	16	2	0	1310	709	92	867	361	27
8242	Debian	200803	39	6	2	1	19	15	5	2	1349	722	98	900	370	32
8242	Debian	200804	26	1	0	0	17	15	1	0	1375	732	99	923	378	33
8242	Debian	200805	38	0	0	0	23	15	0	0	1413	748	99	945	386	33
8242	Debian	200806	40	1	0	0	15	11	1	0	1453	757	100	981	391	34
8242	Debian	200807	27	2	0	0	19	16	2	0	1480	771	102	1005	402	35
8242	Debian	200808	32	5	0	0	20	15	3	0	1512	786	107	1032	412	39
8242	Debian	200809	51	3	0	0	33	19	3	0	1563	811	110	1066	423	39
8242	Debian	200810	34	2	0	0	17	9	2	0	1597	822	112	1091	426	39
8242	Debian	200811	50	2	0	0	26	19	2	0	1647	842	114	1134	439	39
8242	Debian	200812	58	0	0	0	21	12	0	0	1705	857	114	1181	445	39
8242	Debian	200901	41	0	0	0	22	18	0	0	1746	873	114	1217	457	39
8242	Debian	200902	33	1	0	0	18	12	1	0	1779	883	115	1242	461	39
8242	Debian	200903	118	8	0	0	54	35	6	0	1897	921	123	1334	480	42
8242	Debian	200904	35	3	0	0	27	13	3	0	1932	939	126	1353	484	42
8242	Debian	200905	15	2	0	0	14	9	2	0	1947	949	128	1362	490	42
8242	Debian	200906	43	1	0	0	32	13	1	0	1990	974	129	1383	497	42
8242	Debian	200907	25	3	0	0	14	7	1	0	2015	983	132	1398	500	43
8242	Debian	200908	22	3	0	0	19	10	2	0	2037	998	135	1409	506	44
8242	Debian	200909	19	1	0	0	16	11	1	0	2056	1010	136	1423	513	44
8242	Debian	200910	40	0	0	0	14	10	0	0	2096	1018	136	1455	517	44
8242	Debian	200911	39	5	2	0	25	12	5	2	2135	1037	141	1477	523	47
8242	Debian	200912	18	1	0	0	13	9	1	0	2153	1047	142	1490	529	48
8242	Debian	201001	14	0	0	0	13	8	0	0	2167	1055	142	1499	533	48
8242	Debian	201002	22	3	1	0	17	6	3	1	2189	1070	145	1505	537	49
8242	Debian	201003	19	2	0	0	12	6	2	0	2208	1080	147	1515	541	49
8242	Debian	201004	22	1	0	0	18	9	1	0	2230	1093	148	1525	545	49
8242	Debian	201005	23	2	0	0	18	7	2	0	2253	1109	150	1536	550	49
8242	Debian	201006	15	1	0	0	14	7	1	0	2268	1119	151	1543	553	49
8242	Debian	201007	10	0	0	0	8	4	0	0	2278	1126	151	1549	556	49
8242	Debian	201008	17	1	0	0	15	7	1	0	2295	1139	152	1556	562	49
8242	Debian	201009	17	0	0	0	15	4	0	0	2312	1153	152	1561	566	49
8242	Debian	201010	32	5	1	0	18	15	4	1	2344	1166	157	1590	577	53
8242	Debian	201011	7	0	0	0	6	4	0	0	2351	1169	157	1595	579	53
8242	Debian	201012	19	1	0	0	15	9	1	0	2370	1180	158	1605	584	53
8242	Debian	201101	17	0	0	0	13	6	0	0	2387	1191	158	1613	589	53
8242	Debian	201102	36	4	0	0	27	11	4	0	2423	1209	162	1629	594	53
8242	Debian	201103	66	12	1	0	36	13	9	1	2489	1236	174	1653	600	56
8242	Debian	201104	11	2	0	0	10	7	2	0	2500	1244	176	1661	605	57
8242	Debian	201105	17	0	0	0	10	7	0	0	2517	1251	176	1675	610	57
8242	Debian	201106	23	3	0	0	18	7	2	0	2540	1265	179	1686	614	57
8242	Debian	201107	8	1	0	0	7	4	1	0	2548	1270	180	1691	616	57
8242	Debian	201108	20	1	0	0	12	8	1	0	2568	1278	181	1706	620	58
8242	Debian	201109	17	0	0	0	12	7	0	0	2585	1287	181	1716	624	58
8242	Debian	201110	31	4	2	1	21	12	3	2	2616	1300	185	1735	629	61
8242	Debian	201111	18	0	0	0	10	4	0	0	2634	1306	185	1747	630	61
8242	Debian	201112	12	2	0	0	12	5	2	0	2646	1317	187	1752	634	61
8242	Debian	201201	20	0	0	0	10	6	0	0	2666	1325	187	1767	638	61
8242	Debian	201202	19	1	0	0	15	9	1	0	2685	1334	188	1779	641	61
8242	Debian	201203	19	3	0	0	16	11	3	0	2704	1346	191	1793	649	62
8242	Debian	201204	8	1	0	0	8	5	1	0	2712	1352	192	1798	652	63
8242	Debian	201205	22	1	0	0	15	10	1	0	2734	1361	193	1815	656	64
8242	Debian	201206	14	1	0	0	10	5	1	0	2748	1369	194	1822	659	64
8242	Debian	201207	32	6	0	0	17	11	5	0	2780	1380	200	1840	664	66
8242	Debian	201208	9	1	0	0	5	3	1	0	2789	1384	201	1847	666	66
8242	Debian	201209	29	3	0	0	19	9	3	0	2818	1400	204	1859	672	67
8242	Debian	201210	7	2	0	0	7	3	2	0	2825	1407	206	1862	675	68
8242	Debian	201211	43	5	0	0	23	10	5	0	2868	1427	211	1885	683	69
8242	Debian	201212	11	0	0	0	9	6	0	0	2879	1435	211	1893	687	69
8242	Debian	201301	25	7	0	0	20	14	6	0	2904	1450	218	1911	696	72
8242	Debian	201302	27	4	0	0	21	11	3	0	2931	1466	222	1926	702	73
8242	Debian	201303	20	3	0	0	12	7	2	0	2951	1475	225	1938	707	73
8242	Debian	201304	9	2	0	0	7	4	2	0	2960	1479	227	1944	708	73
8242	Debian	201305	64	3	0	0	36	22	3	0	3024	1512	230	1979	726	74
8242	Debian	201306	88	4	0	0	48	29	4	0	3112	1546	234	2040	742	75
8242	Debian	201307	68	11	6	2	20	13	5	4	3180	1560	245	2097	749	82
8242	Debian	201308	19	1	0	0	17	12	1	0	3199	1569	246	2111	755	82
8242	Debian	201309	18	2	0	0	13	9	2	0	3217	1575	248	2123	758	82
8242	Debian	201310	13	2	0	0	10	7	2	0	3230	1579	250	2133	760	83
8242	Debian	201311	24	2	0	0	13	8	2	0	3254	1589	252	2150	765	83
8242	Debian	201312	20	4	0	0	14	6	3	0	3274	1599	256	2159	768	84
8242	Debian	201401	18	0	0	0	9	7	0	0	3292	1605	256	2175	772	84
8242	Debian	201402	18	3	0	0	10	9	3	0	3310	1611	259	2192	777	86
8242	Debian	201403	54	10	3	1	17	10	7	2	3364	1621	269	2222	781	89
8242	Debian	201404	20	0	0	0	14	11	0	0	3384	1630	269	2238	787	89
8242	Debian	201405	24	1	0	0	17	15	1	0	3408	1642	270	2260	798	90
8242	Debian	201406	64	2	0	0	17	13	2	0	3472	1650	272	2286	803	91
8242	Debian	201407	179	1	0	0	16	11	1	0	3651	1660	273	2346	809	91
8242	Debian	201408	255	0	0	0	10	8	0	0	3906	1662	273	2358	810	91
8242	Debian	201409	138	1	0	0	11	5	1	0	4044	1671	274	2363	814	91
8242	Debian	201410	34	4	1	0	13	7	3	1	4078	1681	278	2377	819	92
8242	Debian	201411	56	4	0	0	15	10	4	0	4134	1691	282	2395	825	94
8242	Debian	201412	61	3	0	0	21	12	2	0	4195	1709	285	2411	834	97
8242	Debian	201501	8	1	0	0	7	5	1	0	4203	1713	286	2416	836	98
8242	Debian	201502	14	1	0	0	10	7	1	0	4217	1718	287	2424	839	98
8242	Debian	201503	32	0	0	0	11	11	0	0	4249	1722	287	2456	843	98
8242	Debian	201504	29	6	2	0	14	11	5	2	4278	1731	293	2481	849	104
8242	Debian	201505	59	12	6	3	31	19	7	2	4337	1753	305	2522	858	114
8242	Debian	201506	6	0	0	0	5	3	0	0	4343	1756	305	2526	859	114
8242	Debian	201507	6	0	0	0	5	4	0	0	4349	1761	305	2531	863	114
8242	Debian	201508	14	1	0	0	9	5	1	0	4363	1767	306	2537	865	114
8242	Debian	201509	11	0	0	0	9	7	0	0	4374	1772	306	2545	869	114
8242	Debian	201510	17	1	0	0	12	8	1	0	4391	1781	307	2557	873	115
8242	Debian	201511	13	0	0	0	10	5	0	0	4404	1788	307	2564	875	115
8242	Debian	201512	10	0	0	0	7	7	0	0	4414	1789	307	2574	875	115
8242	Debian	201601	15	1	0	0	10	9	1	0	4429	1792	308	2588	877	116
8242	Debian	201602	5	0	0	0	5	4	0	0	4434	1796	308	2592	880	116
8242	Debian	201603	18	3	0	0	14	9	3	0	4452	1803	311	2604	883	119
8242	Debian	201604	13	2	0	0	9	6	2	0	4465	1806	313	2614	884	120
8242	Debian	201605	11	2	0	0	8	5	2	0	4476	1810	315	2620	885	121
8242	Debian	201606	6	0	0	0	6	5	0	0	4482	1815	315	2625	889	121
8242	Debian	201607	9	2	0	0	7	5	2	0	4491	1818	317	2631	890	122
8242	Debian	201608	7	0	0	0	5	3	0	0	4498	1823	317	2636	892	122
8242	Debian	201609	10	0	0	0	9	8	0	0	4508	1827	317	2645	894	122
8242	Debian	201610	10	3	0	0	10	6	3	0	4518	1832	320	2651	894	123
8242	Debian	201611	16	2	0	0	10	9	1	0	4534	1835	322	2666	896	125
8242	Debian	201612	10	2	0	0	6	4	1	0	4544	1838	324	2673	897	126
8242	Debian	201701	16	0	0	0	9	8	0	0	4560	1843	324	2688	901	126
8242	Debian	201702	26	1	0	0	15	12	1	0	4586	1854	325	2710	910	126
8242	Debian	201703	4	0	0	0	2	2	0	0	4590	1855	325	2714	911	126
8242	Debian	201704	3	0	0	0	2	2	0	0	4593	1855	325	2717	911	126
8242	Debian	201705	14	2	0	0	8	6	1	0	4607	1863	327	2728	915	128
8242	Debian	201706	10	1	0	0	5	3	1	0	4617	1865	328	2736	915	129
8242	Debian	201707	6	0	0	0	5	5	0	0	4623	1869	328	2742	919	129
8242	Debian	201708	4	0	0	0	4	1	0	0	4627	1873	328	2743	920	129
8242	Debian	201709	8	2	0	0	8	5	2	0	4635	1878	330	2748	922	129
8242	Debian	201710	11	0	0	0	10	8	0	0	4646	1886	330	2757	928	129
8242	Debian	201711	5	0	0	0	5	3	0	0	4651	1889	330	2760	929	129
8242	Debian	201712	5	0	0	0	2	2	0	0	4656	1890	330	2765	930	129
8242	Debian	201801	6	0	0	0	5	4	0	0	4662	1893	330	2770	932	129
8242	Debian	201802	12	0	0	0	8	7	0	0	4674	1898	330	2781	934	129
8242	Debian	201803	9	0	0	0	7	4	0	0	4683	1903	330	2785	936	129
8242	Debian	201804	11	4	1	0	8	6	4	1	4694	1909	334	2794	940	132
8242	Debian	201805	11	2	0	0	7	4	2	0	4705	1915	336	2799	943	132
8242	Debian	201806	6	0	0	0	5	4	0	0	4711	1918	336	2803	945	132
8242	Debian	201807	6	1	0	0	4	3	1	0	4717	1921	337	2808	947	133
454403	Deep_web	200403	1	0	0	0	1	1	0	0	1	1	0	1	1	0
454403	Deep_web	200404	4	0	0	0	2	2	0	0	5	3	0	5	3	0
454403	Deep_web	200405	2	0	0	0	1	0	0	0	7	4	0	5	3	0
454403	Deep_web	200406	1	0	0	0	1	1	0	0	8	5	0	6	4	0
454403	Deep_web	200409	1	0	0	0	1	1	0	0	9	5	0	7	4	0
454403	Deep_web	200410	2	1	0	0	2	1	1	0	11	7	1	8	5	0
454403	Deep_web	200412	1	0	0	0	1	0	0	0	12	8	1	8	5	0
454403	Deep_web	200501	3	0	0	0	1	0	0	0	15	9	1	8	5	0
454403	Deep_web	200502	4	0	0	0	3	3	0	0	19	12	1	12	8	0
454403	Deep_web	200503	2	0	0	0	2	1	0	0	21	14	1	13	9	0
454403	Deep_web	200504	1	1	0	0	1	1	1	0	22	15	2	14	10	0
454403	Deep_web	200505	1	0	0	0	1	1	0	0	23	16	2	15	11	0
454403	Deep_web	200506	3	0	0	0	3	2	0	0	26	18	2	17	12	0
454403	Deep_web	200507	10	2	0	0	7	2	1	0	36	25	4	20	14	0
454403	Deep_web	200508	6	0	0	0	5	2	0	0	42	30	4	22	16	0
454403	Deep_web	200509	6	0	0	0	5	2	0	0	48	35	4	24	18	0
454403	Deep_web	200510	5	0	0	0	4	1	0	0	53	39	4	25	19	0
454403	Deep_web	200511	8	0	0	0	5	1	0	0	61	44	4	29	20	0
454403	Deep_web	200512	3	0	0	0	3	1	0	0	64	47	4	30	21	0
454403	Deep_web	200601	5	0	0	0	3	1	0	0	69	50	4	33	22	0
454403	Deep_web	200602	6	0	0	0	6	4	0	0	75	56	4	37	26	0
454403	Deep_web	200603	2	0	0	0	1	0	0	0	77	57	4	37	26	0
454403	Deep_web	200604	8	1	0	0	7	4	1	0	85	59	5	42	27	0
454403	Deep_web	200605	7	0	0	0	6	5	0	0	92	64	5	48	31	0
454403	Deep_web	200606	21	0	0	0	3	3	0	0	113	66	5	69	33	0
454403	Deep_web	200607	3	0	0	0	3	2	0	0	116	68	5	71	35	0
454403	Deep_web	200608	6	1	0	0	5	1	1	0	122	73	6	72	36	0
454403	Deep_web	200609	4	0	0	0	4	3	0	0	126	76	6	75	38	0
454403	Deep_web	200610	14	0	0	0	7	3	0	0	140	81	6	84	40	0
454403	Deep_web	200611	12	2	0	0	9	4	2	0	152	90	8	89	44	1
454403	Deep_web	200612	8	2	0	0	8	4	2	0	160	96	10	93	47	1
454403	Deep_web	200701	5	0	0	0	3	2	0	0	165	99	10	96	49	1
454403	Deep_web	200702	24	1	0	0	10	4	1	0	189	109	11	112	53	1
454403	Deep_web	200703	33	0	0	0	14	8	0	0	222	119	11	126	57	1
454403	Deep_web	200704	8	0	0	0	7	2	0	0	230	125	11	128	58	1
454403	Deep_web	200705	9	1	0	0	8	3	1	0	239	132	12	132	60	1
454403	Deep_web	200706	16	3	0	0	9	7	2	0	255	139	15	143	65	1
454403	Deep_web	200707	3	0	0	0	3	2	0	0	258	142	15	145	67	1
454403	Deep_web	200708	30	2	0	0	16	9	2	0	288	156	17	163	74	2
454403	Deep_web	200709	3	0	0	0	3	1	0	0	291	158	17	164	74	2
454403	Deep_web	200710	7	0	0	0	5	3	0	0	298	162	17	168	76	2
454403	Deep_web	200711	8	1	0	0	8	6	1	0	306	167	18	174	79	2
454403	Deep_web	200712	18	1	0	0	6	3	1	0	324	172	19	178	81	2
454403	Deep_web	200801	4	0	0	0	4	3	0	0	328	176	19	181	84	2
454403	Deep_web	200802	4	1	0	0	3	2	1	0	332	179	20	183	86	2
454403	Deep_web	200803	9	0	0	0	6	4	0	0	341	185	20	189	90	2
454403	Deep_web	200804	7	1	0	0	5	3	1	0	348	190	21	193	93	2
454403	Deep_web	200805	14	1	0	0	10	4	1	0	362	198	22	200	95	2
454403	Deep_web	200806	2	0	0	0	2	2	0	0	364	200	22	202	97	2
454403	Deep_web	200807	4	0	0	0	4	4	0	0	368	202	22	206	99	2
454403	Deep_web	200808	6	0	0	0	6	4	0	0	374	205	22	210	101	2
454403	Deep_web	200809	1	0	0	0	1	1	0	0	375	206	22	211	102	2
454403	Deep_web	200810	6	1	0	0	5	3	1	0	381	209	23	215	103	2
454403	Deep_web	200811	3	1	0	0	3	2	1	0	384	212	24	217	105	2
454403	Deep_web	200812	2	1	0	0	2	1	1	0	386	213	25	218	105	2
454403	Deep_web	200901	7	0	0	0	4	3	0	0	393	217	25	224	108	2
454403	Deep_web	200902	9	0	0	0	8	5	0	0	402	223	25	230	111	2
454403	Deep_web	200903	24	1	0	0	18	12	1	0	426	239	26	245	121	2
454403	Deep_web	200904	27	5	0	0	15	7	4	0	453	252	31	256	126	2
454403	Deep_web	200905	9	2	0	0	7	4	2	0	462	254	33	261	127	2
454403	Deep_web	200907	1	0	0	0	1	1	0	0	463	255	33	262	128	2
454403	Deep_web	200908	3	1	0	0	3	2	1	0	466	256	34	264	129	2
454403	Deep_web	200909	13	10	5	2	6	2	5	2	479	260	44	268	129	4
454403	Deep_web	200911	12	7	3	2	8	2	5	2	491	265	51	272	130	6
454403	Deep_web	200912	7	2	0	0	6	3	1	0	498	271	53	275	133	7
454403	Deep_web	201001	2	0	0	0	2	2	0	0	500	272	53	277	134	7
454403	Deep_web	201002	5	1	0	0	5	4	1	0	505	275	54	281	136	7
454403	Deep_web	201003	4	0	0	0	3	1	0	0	509	278	54	282	137	7
454403	Deep_web	201004	7	1	0	0	7	4	1	0	516	284	55	286	140	7
454403	Deep_web	201005	1	0	0	0	1	1	0	0	517	285	55	287	141	7
454403	Deep_web	201007	6	1	0	0	5	2	1	0	523	289	56	289	142	7
454403	Deep_web	201009	2	0	0	0	2	2	0	0	525	291	56	291	144	7
454403	Deep_web	201011	1	0	0	0	1	0	0	0	526	292	56	291	144	7
454403	Deep_web	201012	14	5	0	0	9	3	2	0	540	301	61	297	147	7
454403	Deep_web	201101	3	0	0	0	3	3	0	0	543	303	61	300	149	7
454403	Deep_web	201102	8	1	0	0	7	3	1	0	551	310	62	303	152	7
454403	Deep_web	201103	5	0	0	0	4	1	0	0	556	313	62	304	152	7
454403	Deep_web	201104	8	2	0	0	4	2	2	0	564	316	64	306	153	7
454403	Deep_web	201105	3	1	0	0	3	2	1	0	567	318	65	308	154	7
454403	Deep_web	201106	8	1	0	0	5	3	1	0	575	321	66	314	155	7
454403	Deep_web	201107	17	3	0	0	13	5	3	0	592	332	69	322	158	8
454403	Deep_web	201108	15	5	0	0	11	7	4	0	607	340	74	331	162	8
454403	Deep_web	201109	6	3	0	0	4	3	3	0	613	344	77	334	165	8
454403	Deep_web	201110	10	2	0	0	9	4	2	0	623	352	79	338	168	8
454403	Deep_web	201111	11	0	0	0	4	1	0	0	634	356	79	339	169	8
454403	Deep_web	201112	26	10	0	0	17	8	6	0	660	370	89	353	174	8
454403	Deep_web	201201	3	0	0	0	1	1	0	0	663	371	89	356	175	8
454403	Deep_web	201202	13	2	0	0	12	8	2	0	676	379	91	365	179	9
454403	Deep_web	201203	10	5	2	1	8	5	4	2	686	385	96	371	182	11
454403	Deep_web	201204	9	2	0	0	9	3	2	0	695	392	98	374	183	11
454403	Deep_web	201205	11	1	0	0	9	5	1	0	706	399	99	380	186	11
454403	Deep_web	201206	10	2	0	0	5	3	1	0	716	403	101	386	188	12
454403	Deep_web	201207	8	3	0	0	6	5	3	0	724	407	104	392	191	13
454403	Deep_web	201208	28	7	0	0	19	9	6	0	752	423	111	404	197	14
454403	Deep_web	201209	3	1	0	0	3	2	1	0	755	425	112	406	198	14
454403	Deep_web	201210	17	5	0	0	10	5	3	0	772	433	117	415	201	14
454403	Deep_web	201211	15	6	0	0	13	9	5	0	787	442	123	425	206	16
454403	Deep_web	201212	12	3	0	0	12	8	3	0	799	449	126	433	209	17
454403	Deep_web	201301	4	1	0	0	4	2	1	0	803	452	127	435	210	17
454403	Deep_web	201302	15	3	0	0	14	10	3	0	818	462	130	446	216	17
454403	Deep_web	201303	20	8	0	0	13	7	5	0	838	472	138	456	220	17
454403	Deep_web	201304	11	4	0	0	10	6	4	0	849	479	142	463	223	17
454403	Deep_web	201305	8	2	0	0	7	3	2	0	857	485	144	466	225	17
454403	Deep_web	201306	10	3	0	0	9	4	3	0	867	491	147	471	226	17
454403	Deep_web	201307	13	1	0	0	10	7	1	0	880	500	148	480	232	17
454403	Deep_web	201308	6	1	0	0	6	3	1	0	886	505	149	483	234	17
454403	Deep_web	201309	1	0	0	0	1	0	0	0	887	506	149	483	234	17
454403	Deep_web	201310	20	5	0	0	12	4	3	0	907	516	154	489	236	17
454403	Deep_web	201311	23	8	0	0	18	9	7	0	930	530	162	499	242	17
454403	Deep_web	201312	15	2	0	0	12	4	1	0	945	540	164	504	245	18
454403	Deep_web	201401	18	4	0	0	13	9	3	0	963	550	168	515	251	19
454403	Deep_web	201402	41	6	0	0	21	17	5	0	1004	568	174	551	265	22
454403	Deep_web	201403	34	10	0	0	24	12	6	0	1038	587	184	569	272	23
454403	Deep_web	201404	21	6	0	0	13	7	5	0	1059	596	190	579	275	23
454403	Deep_web	201405	22	3	0	0	14	7	3	0	1081	607	193	586	279	23
454403	Deep_web	201406	14	2	0	0	12	9	2	0	1095	616	195	596	285	23
454403	Deep_web	201407	13	3	0	0	12	4	3	0	1108	625	198	600	286	23
454403	Deep_web	201408	7	1	0	0	6	5	1	0	1115	630	199	606	290	23
454403	Deep_web	201409	10	3	0	0	8	5	3	0	1125	636	202	612	292	24
454403	Deep_web	201410	30	10	0	0	19	12	8	0	1155	651	212	630	300	30
454403	Deep_web	201411	15	5	0	0	11	7	5	0	1170	658	217	639	302	33
454403	Deep_web	201412	41	8	0	0	21	13	6	0	1211	676	225	672	311	35
454403	Deep_web	201501	19	3	0	0	9	8	3	0	1230	681	228	689	315	37
454403	Deep_web	201502	36	11	0	0	16	9	4	0	1266	694	239	707	320	41
454403	Deep_web	201503	19	6	0	0	16	10	5	0	1285	706	245	719	326	44
454403	Deep_web	201504	19	5	0	0	11	9	5	0	1304	714	250	735	331	46
454403	Deep_web	201505	54	18	0	0	35	19	14	0	1358	741	268	769	342	54
454403	Deep_web	201506	124	36	2	1	56	29	20	2	1482	789	304	860	358	64
454403	Deep_web	201507	24	7	0	0	16	11	6	0	1506	799	311	874	363	64
454403	Deep_web	201508	16	5	0	0	13	8	5	0	1522	808	316	885	367	66
454403	Deep_web	201509	43	9	0	0	24	14	9	0	1565	825	325	916	374	67
454403	Deep_web	201510	14	0	0	0	9	6	0	0	1579	832	325	923	378	67
454403	Deep_web	201511	33	14	0	0	22	15	10	0	1612	849	339	942	388	70
454403	Deep_web	201512	18	6	0	0	12	11	4	0	1630	858	345	959	394	75
454403	Deep_web	201601	9	4	0	0	8	5	4	0	1639	863	349	964	396	76
454403	Deep_web	201602	17	3	0	0	11	7	2	0	1656	871	352	976	400	78
454403	Deep_web	201603	27	10	0	0	21	15	8	0	1683	886	362	996	408	81
454403	Deep_web	201604	41	13	0	0	27	19	10	0	1724	907	375	1029	417	87
454403	Deep_web	201605	36	16	2	0	19	13	12	1	1760	919	391	1050	423	95
454403	Deep_web	201606	32	14	0	0	22	12	8	0	1792	937	405	1069	428	99
454403	Deep_web	201607	39	15	0	0	25	15	9	0	1831	954	420	1093	432	105
454403	Deep_web	201608	29	13	0	0	20	12	8	0	1860	969	433	1113	437	110
454403	Deep_web	201609	17	8	1	0	14	7	7	1	1877	978	441	1121	439	112
454403	Deep_web	201610	6	3	0	0	5	3	3	0	1883	981	444	1124	440	112
454403	Deep_web	201611	42	19	0	0	27	16	12	0	1925	1002	463	1149	447	117
454403	Deep_web	201612	33	8	0	0	24	18	5	0	1958	1021	471	1176	459	121
454403	Deep_web	201701	37	14	1	0	26	18	11	1	1995	1041	485	1199	469	128
454403	Deep_web	201702	23	7	0	0	17	12	5	0	2018	1051	492	1217	472	131
454403	Deep_web	201703	22	10	0	0	19	11	8	0	2040	1064	502	1231	476	133
454403	Deep_web	201704	23	11	0	0	17	11	6	0	2063	1076	513	1248	482	139
454403	Deep_web	201705	16	8	0	0	13	7	5	0	2079	1085	521	1258	485	141
454403	Deep_web	201706	22	7	0	0	17	13	6	0	2101	1099	528	1275	495	146
454403	Deep_web	201707	12	5	0	0	12	5	5	0	2113	1109	533	1280	498	146
454403	Deep_web	201708	20	8	0	0	18	10	7	0	2133	1123	541	1292	504	147
454403	Deep_web	201709	17	6	0	0	15	9	5	0	2150	1136	547	1302	510	148
454403	Deep_web	201710	12	5	0	0	10	5	3	0	2162	1145	552	1309	514	148
454403	Deep_web	201711	18	5	0	0	13	8	5	0	2180	1153	557	1322	517	148
454403	Deep_web	201712	23	8	0	0	17	12	8	0	2203	1165	565	1338	524	150
454403	Deep_web	201801	14	6	0	0	12	7	4	0	2217	1173	571	1347	527	151
454403	Deep_web	201802	11	5	0	0	11	7	5	0	2228	1182	576	1354	531	152
454403	Deep_web	201803	26	10	0	0	20	13	8	0	2254	1196	586	1371	537	156
454403	Deep_web	201804	19	7	0	0	17	12	7	0	2273	1208	593	1385	542	159
454403	Deep_web	201805	22	6	0	0	14	11	6	0	2295	1216	599	1402	547	161
454403	Deep_web	201806	14	4	0	0	12	7	4	0	2309	1225	603	1410	549	161
454403	Deep_web	201807	16	7	0	0	10	8	6	0	2325	1231	610	1419	552	161
39776	Denial-of-service_attack	200210	1	0	0	0	1	0	0	0	1	1	0	0	0	0
39776	Denial-of-service_attack	200211	3	0	0	0	3	3	0	0	4	4	0	3	3	0
39776	Denial-of-service_attack	200212	1	0	0	0	1	1	0	0	5	5	0	4	4	0
39776	Denial-of-service_attack	200301	1	0	0	0	1	1	0	0	6	6	0	5	5	0
39776	Denial-of-service_attack	200305	5	0	0	0	4	1	0	0	11	10	0	6	6	0
39776	Denial-of-service_attack	200306	2	0	0	0	2	0	0	0	13	12	0	6	6	0
39776	Denial-of-service_attack	200307	1	0	0	0	1	0	0	0	14	13	0	6	6	0
39776	Denial-of-service_attack	200308	1	0	0	0	1	0	0	0	15	14	0	6	6	0
39776	Denial-of-service_attack	200309	3	0	0	0	3	3	0	0	18	17	0	9	9	0
39776	Denial-of-service_attack	200310	1	0	0	0	1	1	0	0	19	18	0	10	10	0
39776	Denial-of-service_attack	200312	3	0	0	0	2	2	0	0	22	20	0	13	12	0
39776	Denial-of-service_attack	200402	5	0	0	0	3	3	0	0	27	23	0	18	15	0
39776	Denial-of-service_attack	200403	1	0	0	0	1	1	0	0	28	24	0	19	16	0
39776	Denial-of-service_attack	200404	48	13	2	1	26	8	7	2	76	49	13	37	23	1
39776	Denial-of-service_attack	200405	8	0	0	0	4	3	0	0	84	52	13	41	25	1
39776	Denial-of-service_attack	200406	5	0	0	0	3	1	0	0	89	55	13	42	26	1
39776	Denial-of-service_attack	200407	11	0	0	0	8	5	0	0	100	63	13	50	31	1
39776	Denial-of-service_attack	200408	7	0	0	0	5	5	0	0	107	67	13	57	35	1
39776	Denial-of-service_attack	200409	3	1	0	0	3	1	1	0	110	69	14	58	35	1
39776	Denial-of-service_attack	200410	3	2	0	0	2	2	1	0	113	70	16	61	36	2
39776	Denial-of-service_attack	200411	6	0	0	0	5	4	0	0	119	74	16	66	39	2
39776	Denial-of-service_attack	200412	8	0	0	0	7	5	0	0	127	79	16	72	42	2
39776	Denial-of-service_attack	200501	9	1	0	0	7	5	1	0	136	84	17	79	45	2
39776	Denial-of-service_attack	200502	3	1	0	0	3	2	1	0	139	87	18	81	47	2
39776	Denial-of-service_attack	200503	3	0	0	0	3	2	0	0	142	89	18	83	48	2
39776	Denial-of-service_attack	200504	3	0	0	0	3	2	0	0	145	92	18	85	50	2
39776	Denial-of-service_attack	200505	13	1	0	0	9	3	1	0	158	100	19	88	52	2
39776	Denial-of-service_attack	200506	13	2	0	0	10	5	2	0	171	108	21	95	55	2
39776	Denial-of-service_attack	200507	11	3	0	0	11	5	3	0	182	118	24	100	59	2
39776	Denial-of-service_attack	200508	8	3	0	0	7	3	3	0	190	124	27	104	61	2
39776	Denial-of-service_attack	200509	40	3	0	0	28	14	3	0	230	148	30	125	71	2
39776	Denial-of-service_attack	200510	28	5	0	0	17	7	4	0	258	164	35	135	77	4
39776	Denial-of-service_attack	200511	22	5	0	0	17	7	4	0	280	180	40	144	83	4
39776	Denial-of-service_attack	200512	11	2	0	0	7	5	2	0	291	186	42	149	87	4
39776	Denial-of-service_attack	200601	14	1	0	0	9	7	1	0	305	193	43	159	92	4
39776	Denial-of-service_attack	200602	14	0	0	0	12	8	0	0	319	203	43	168	98	4
39776	Denial-of-service_attack	200603	15	4	0	0	12	5	4	0	334	215	47	173	103	4
39776	Denial-of-service_attack	200604	14	2	0	0	13	7	2	0	348	227	49	181	109	4
39776	Denial-of-service_attack	200605	49	10	0	0	33	19	10	0	397	259	59	207	128	4
39776	Denial-of-service_attack	200606	64	6	0	0	42	17	6	0	461	297	65	231	142	5
39776	Denial-of-service_attack	200607	56	5	0	0	30	15	5	0	517	325	70	263	156	5
39776	Denial-of-service_attack	200608	89	9	0	0	42	17	7	0	606	364	79	306	171	5
39776	Denial-of-service_attack	200609	64	4	0	0	33	14	3	0	670	395	83	341	183	5
39776	Denial-of-service_attack	200610	47	5	0	0	37	17	5	0	717	429	88	360	197	5
39776	Denial-of-service_attack	200611	21	2	0	0	16	7	2	0	738	444	90	369	203	6
39776	Denial-of-service_attack	200612	39	10	0	0	28	11	6	0	777	470	100	390	212	7
39776	Denial-of-service_attack	200701	20	3	0	0	15	5	3	0	797	484	103	397	216	7
39776	Denial-of-service_attack	200702	13	2	0	0	11	5	2	0	810	493	105	404	219	7
39776	Denial-of-service_attack	200703	18	4	0	0	13	6	4	0	828	506	109	411	225	9
39776	Denial-of-service_attack	200704	46	10	0	0	29	16	7	0	874	535	119	435	241	11
39776	Denial-of-service_attack	200705	26	3	0	0	21	10	3	0	900	555	122	449	250	12
39776	Denial-of-service_attack	200706	23	1	0	0	13	8	1	0	923	567	123	465	257	12
39776	Denial-of-service_attack	200707	18	2	0	0	13	5	2	0	941	580	125	470	262	12
39776	Denial-of-service_attack	200708	36	3	0	0	15	7	3	0	977	595	128	478	269	12
39776	Denial-of-service_attack	200709	40	1	0	0	19	13	1	0	1017	612	129	511	281	12
39776	Denial-of-service_attack	200710	26	5	0	0	19	11	5	0	1043	627	134	526	289	14
39776	Denial-of-service_attack	200711	44	15	0	0	33	11	9	0	1087	657	149	543	297	14
39776	Denial-of-service_attack	200712	21	6	0	0	16	7	3	0	1108	671	155	553	302	14
39776	Denial-of-service_attack	200801	15	2	0	0	11	6	2	0	1123	680	157	561	306	14
39776	Denial-of-service_attack	200802	33	5	0	0	28	14	4	0	1156	701	162	579	313	15
39776	Denial-of-service_attack	200803	50	10	0	0	26	14	5	0	1206	724	172	613	324	15
39776	Denial-of-service_attack	200804	27	7	0	0	20	13	3	0	1233	740	179	633	333	18
39776	Denial-of-service_attack	200805	22	4	0	0	18	12	4	0	1255	757	183	646	344	19
39776	Denial-of-service_attack	200806	31	9	1	0	16	10	7	1	1286	769	192	668	350	21
39776	Denial-of-service_attack	200807	33	5	0	0	23	11	5	0	1319	791	197	683	360	23
39776	Denial-of-service_attack	200808	21	4	0	0	18	5	4	0	1340	807	201	690	363	23
39776	Denial-of-service_attack	200809	19	2	0	0	14	8	2	0	1359	820	203	700	370	24
39776	Denial-of-service_attack	200810	21	4	0	0	18	7	4	0	1380	837	207	708	376	25
39776	Denial-of-service_attack	200811	30	4	0	0	19	6	4	0	1410	856	211	718	382	25
39776	Denial-of-service_attack	200812	41	4	0	0	22	9	3	0	1451	877	215	736	390	25
39776	Denial-of-service_attack	200901	26	7	1	0	23	14	7	1	1477	897	222	752	401	27
39776	Denial-of-service_attack	200902	71	19	0	0	37	12	8	0	1548	931	241	785	410	28
39776	Denial-of-service_attack	200903	36	8	1	0	26	14	5	1	1584	955	249	806	422	30
39776	Denial-of-service_attack	200904	28	4	0	0	15	5	4	0	1612	969	253	817	426	30
39776	Denial-of-service_attack	200905	32	7	0	0	22	13	6	0	1644	989	260	831	437	31
39776	Denial-of-service_attack	200906	37	11	1	0	27	10	8	1	1681	1014	271	848	446	33
39776	Denial-of-service_attack	200907	21	3	0	0	15	10	3	0	1702	1026	274	861	453	34
39776	Denial-of-service_attack	200908	31	11	0	0	23	13	8	0	1733	1042	285	877	459	34
39776	Denial-of-service_attack	200909	57	8	0	0	45	22	8	0	1790	1082	293	905	477	34
39776	Denial-of-service_attack	200910	64	11	0	0	47	24	8	0	1854	1125	304	944	497	36
39776	Denial-of-service_attack	200911	39	15	0	0	30	14	11	0	1893	1150	319	963	506	37
39776	Denial-of-service_attack	200912	18	6	0	0	13	7	5	0	1911	1161	325	972	511	37
39776	Denial-of-service_attack	201001	22	4	0	0	21	8	4	0	1933	1180	329	981	517	37
39776	Denial-of-service_attack	201002	29	7	0	0	16	7	5	0	1962	1192	336	994	520	37
39776	Denial-of-service_attack	201003	48	12	0	0	32	14	8	0	2010	1219	348	1020	529	40
39776	Denial-of-service_attack	201004	33	6	0	0	23	11	6	0	2043	1236	354	1032	534	40
39776	Denial-of-service_attack	201005	27	9	0	0	21	10	6	0	2070	1256	363	1047	543	42
39776	Denial-of-service_attack	201006	35	7	0	0	19	11	5	0	2105	1272	370	1073	551	43
39776	Denial-of-service_attack	201007	19	6	0	0	15	9	4	0	2124	1285	376	1085	558	43
39776	Denial-of-service_attack	201008	18	4	0	0	12	5	4	0	2142	1296	380	1091	562	44
39776	Denial-of-service_attack	201009	13	4	0	0	12	5	4	0	2155	1306	384	1096	565	45
39776	Denial-of-service_attack	201010	24	4	0	0	19	6	4	0	2179	1323	388	1104	569	45
39776	Denial-of-service_attack	201011	11	4	0	0	11	5	4	0	2190	1332	392	1109	572	45
39776	Denial-of-service_attack	201012	40	6	0	0	23	8	5	0	2230	1352	398	1127	577	46
39776	Denial-of-service_attack	201101	68	11	0	0	55	29	8	0	2298	1401	409	1162	600	49
39776	Denial-of-service_attack	201102	43	9	0	0	24	10	3	0	2341	1422	418	1180	607	50
39776	Denial-of-service_attack	201103	26	7	0	0	19	9	5	0	2367	1436	425	1192	611	50
39776	Denial-of-service_attack	201104	19	7	0	0	15	6	5	0	2386	1446	432	1200	613	50
39776	Denial-of-service_attack	201105	25	7	0	0	20	10	4	0	2411	1460	439	1213	617	51
39776	Denial-of-service_attack	201106	33	9	0	0	23	10	4	0	2444	1477	448	1229	621	52
39776	Denial-of-service_attack	201107	51	10	2	0	31	18	8	1	2495	1504	458	1261	635	54
39776	Denial-of-service_attack	201108	21	5	0	0	16	9	5	0	2516	1514	463	1273	638	54
39776	Denial-of-service_attack	201109	12	4	0	0	11	3	3	0	2528	1524	467	1277	640	54
39776	Denial-of-service_attack	201110	12	4	0	0	10	5	3	0	2540	1530	471	1283	641	54
39776	Denial-of-service_attack	201111	39	9	0	0	27	15	6	0	2579	1552	480	1305	651	55
39776	Denial-of-service_attack	201112	18	4	0	0	16	6	4	0	2597	1565	484	1311	654	55
39776	Denial-of-service_attack	201201	12	3	0	0	12	8	3	0	2609	1573	487	1319	658	56
39776	Denial-of-service_attack	201202	15	3	0	0	13	8	3	0	2624	1583	490	1327	663	57
39776	Denial-of-service_attack	201203	29	10	0	0	22	14	8	0	2653	1602	500	1343	674	58
39776	Denial-of-service_attack	201204	19	6	0	0	13	7	3	0	2672	1610	506	1355	676	59
39776	Denial-of-service_attack	201205	21	7	0	0	18	9	6	0	2693	1622	513	1365	679	60
39776	Denial-of-service_attack	201206	37	13	0	0	30	19	12	0	2730	1645	526	1388	691	62
39776	Denial-of-service_attack	201207	16	4	0	0	14	8	4	0	2746	1655	530	1397	695	63
39776	Denial-of-service_attack	201208	17	5	0	0	13	7	3	0	2763	1664	535	1407	698	65
39776	Denial-of-service_attack	201209	22	9	1	0	18	9	7	1	2785	1679	544	1419	704	68
39776	Denial-of-service_attack	201210	24	12	1	0	18	5	7	1	2809	1693	556	1429	705	69
39776	Denial-of-service_attack	201211	15	6	0	0	12	6	5	0	2824	1702	562	1436	708	71
39776	Denial-of-service_attack	201212	23	4	0	0	14	8	4	0	2847	1711	566	1452	711	73
39776	Denial-of-service_attack	201301	28	8	0	0	16	10	6	0	2875	1723	574	1465	717	74
39776	Denial-of-service_attack	201302	26	9	1	0	17	6	6	1	2901	1738	583	1475	721	75
39776	Denial-of-service_attack	201303	34	7	0	0	20	11	4	0	2935	1755	590	1495	729	78
39776	Denial-of-service_attack	201304	20	5	0	0	17	11	4	0	2955	1769	595	1509	737	78
39776	Denial-of-service_attack	201305	35	8	0	0	26	10	7	0	2990	1792	603	1524	745	80
39776	Denial-of-service_attack	201306	39	12	0	0	25	12	7	0	3029	1812	615	1544	752	81
39776	Denial-of-service_attack	201307	15	4	0	0	13	6	4	0	3044	1820	619	1552	754	81
39776	Denial-of-service_attack	201308	26	7	0	0	20	12	7	0	3070	1838	626	1566	764	81
39776	Denial-of-service_attack	201309	29	13	0	0	23	14	10	0	3099	1858	639	1585	775	85
39776	Denial-of-service_attack	201310	37	9	0	0	21	10	7	0	3136	1875	648	1602	781	85
39776	Denial-of-service_attack	201311	26	6	0	0	16	9	5	0	3162	1883	654	1614	783	86
39776	Denial-of-service_attack	201312	40	15	0	0	32	15	11	0	3202	1907	669	1635	790	88
39776	Denial-of-service_attack	201401	8	2	0	0	8	5	2	0	3210	1911	671	1640	791	88
39776	Denial-of-service_attack	201402	26	2	0	0	20	13	2	0	3236	1929	673	1655	802	88
39776	Denial-of-service_attack	201403	21	6	0	0	17	8	5	0	3257	1943	679	1664	807	89
39776	Denial-of-service_attack	201404	41	14	0	0	32	19	10	0	3298	1967	693	1690	818	92
39776	Denial-of-service_attack	201405	13	2	0	0	12	7	2	0	3311	1976	695	1698	822	92
39776	Denial-of-service_attack	201406	12	3	0	0	10	8	3	0	3323	1984	698	1706	828	92
39776	Denial-of-service_attack	201407	24	4	0	0	18	13	4	0	3347	1996	702	1725	835	95
39776	Denial-of-service_attack	201408	19	4	0	0	16	10	3	0	3366	2009	706	1738	842	96
39776	Denial-of-service_attack	201409	19	1	0	0	14	7	1	0	3385	2019	707	1747	845	96
39776	Denial-of-service_attack	201410	13	4	0	0	11	8	4	0	3398	2027	711	1756	850	98
39776	Denial-of-service_attack	201411	14	3	0	0	12	8	3	0	3412	2035	714	1765	853	100
39776	Denial-of-service_attack	201412	7	1	0	0	6	3	1	0	3419	2040	715	1768	855	100
39776	Denial-of-service_attack	201501	26	7	0	0	18	14	4	0	3445	2055	722	1788	866	104
39776	Denial-of-service_attack	201502	23	6	0	0	18	11	5	0	3468	2067	728	1802	869	106
39776	Denial-of-service_attack	201503	7	1	0	0	6	2	1	0	3475	2072	729	1805	870	106
39776	Denial-of-service_attack	201504	12	3	0	0	9	2	2	0	3487	2080	732	1808	871	106
39776	Denial-of-service_attack	201505	15	4	0	0	9	7	3	0	3502	2087	736	1820	876	108
39776	Denial-of-service_attack	201506	17	4	0	0	10	4	4	0	3519	2095	740	1824	877	108
39776	Denial-of-service_attack	201507	43	3	0	0	12	6	2	0	3562	2104	743	1860	880	108
39776	Denial-of-service_attack	201508	35	6	0	0	22	10	3	0	3597	2121	749	1880	884	109
39776	Denial-of-service_attack	201509	20	7	0	0	17	12	7	0	3617	2134	756	1893	892	111
39776	Denial-of-service_attack	201510	16	3	0	0	14	9	3	0	3633	2145	759	1903	898	113
39776	Denial-of-service_attack	201511	3	0	0	0	3	2	0	0	3636	2148	759	1905	900	113
39776	Denial-of-service_attack	201512	27	5	0	0	20	9	5	0	3663	2164	764	1918	905	113
39776	Denial-of-service_attack	201601	15	3	0	0	12	7	3	0	3678	2171	767	1928	907	113
39776	Denial-of-service_attack	201602	19	3	0	0	15	8	3	0	3697	2183	770	1938	912	113
39776	Denial-of-service_attack	201603	31	8	0	0	20	13	8	0	3728	2197	778	1961	919	114
39776	Denial-of-service_attack	201604	15	3	0	0	9	7	3	0	3743	2203	781	1974	923	115
39776	Denial-of-service_attack	201605	17	5	1	0	10	6	5	1	3760	2208	786	1984	924	116
39776	Denial-of-service_attack	201606	29	3	0	0	16	13	3	0	3789	2219	789	2009	932	119
39776	Denial-of-service_attack	201607	9	2	0	0	8	5	1	0	3798	2224	791	2015	933	119
39776	Denial-of-service_attack	201608	25	2	0	0	16	11	1	0	3823	2235	793	2033	938	120
39776	Denial-of-service_attack	201609	23	6	0	0	14	12	4	0	3846	2245	799	2051	946	123
39776	Denial-of-service_attack	201610	21	2	0	0	11	8	2	0	3867	2251	801	2067	949	123
39776	Denial-of-service_attack	201611	51	10	0	0	35	26	7	0	3918	2281	811	2109	969	126
39776	Denial-of-service_attack	201612	12	3	0	0	11	8	2	0	3930	2289	814	2118	973	126
39776	Denial-of-service_attack	201701	16	2	1	0	13	11	2	1	3946	2298	816	2131	980	128
39776	Denial-of-service_attack	201702	30	12	0	0	22	16	8	0	3976	2313	828	2154	988	136
39776	Denial-of-service_attack	201703	12	2	0	0	12	10	2	0	3988	2321	830	2164	993	138
39776	Denial-of-service_attack	201704	20	6	0	0	14	9	5	0	4008	2331	836	2179	997	140
39776	Denial-of-service_attack	201705	13	4	0	0	10	6	4	0	4021	2337	840	2186	999	141
39776	Denial-of-service_attack	201706	14	6	0	0	10	6	4	0	4035	2346	846	2194	1004	142
39776	Denial-of-service_attack	201707	14	4	2	1	10	9	3	2	4049	2351	850	2207	1007	146
39776	Denial-of-service_attack	201708	3	0	0	0	3	2	0	0	4052	2352	850	2209	1007	146
39776	Denial-of-service_attack	201709	8	1	0	0	7	4	1	0	4060	2358	851	2213	1010	146
39776	Denial-of-service_attack	201710	14	4	0	0	14	11	4	0	4074	2368	855	2224	1016	147
39776	Denial-of-service_attack	201711	18	3	0	0	13	11	2	0	4092	2376	858	2240	1022	148
39776	Denial-of-service_attack	201712	12	5	0	0	10	6	4	0	4104	2381	863	2247	1022	149
39776	Denial-of-service_attack	201801	13	4	0	0	12	8	3	0	4117	2387	867	2256	1024	149
39776	Denial-of-service_attack	201802	21	8	1	0	16	11	7	1	4138	2396	875	2269	1028	152
39776	Denial-of-service_attack	201803	16	6	0	0	13	11	6	0	4154	2405	881	2283	1035	156
39776	Denial-of-service_attack	201804	27	3	0	0	12	8	2	0	4181	2416	884	2293	1039	157
39776	Denial-of-service_attack	201805	21	9	0	0	16	12	7	0	4202	2428	893	2308	1046	161
39776	Denial-of-service_attack	201806	13	2	0	0	10	8	2	0	4215	2436	895	2319	1052	162
39776	Denial-of-service_attack	201807	7	2	0	0	7	5	2	0	4222	2441	897	2324	1055	162
1226927	Digital_currency	200412	1	0	0	0	1	1	0	0	1	1	0	1	1	0
1226927	Digital_currency	201302	1	0	0	0	1	1	0	0	2	2	0	2	2	0
1226927	Digital_currency	201303	6	0	0	0	1	1	0	0	8	3	0	8	3	0
1226927	Digital_currency	201304	68	0	0	0	6	5	0	0	76	8	0	75	7	0
1226927	Digital_currency	201305	35	2	0	0	15	6	2	0	111	21	2	98	11	0
1226927	Digital_currency	201306	139	19	1	0	24	16	7	1	250	40	21	225	24	13
1226927	Digital_currency	201307	45	8	2	0	11	10	6	1	295	48	29	269	31	21
1226927	Digital_currency	201310	16	2	0	0	6	5	2	0	311	53	31	284	35	23
1226927	Digital_currency	201311	4	0	0	0	2	2	0	0	315	54	31	288	36	23
1226927	Digital_currency	201312	15	5	1	0	6	4	3	1	330	58	36	298	38	28
1226927	Digital_currency	201401	16	1	0	0	5	4	1	0	346	61	37	313	40	28
1226927	Digital_currency	201402	53	14	7	4	23	19	8	4	399	81	51	350	56	39
1226927	Digital_currency	201403	9	1	0	0	7	5	1	0	408	87	52	357	61	39
1226927	Digital_currency	201404	11	0	0	0	6	4	0	0	419	92	52	366	64	39
1226927	Digital_currency	201405	14	0	0	0	8	6	0	0	433	98	52	378	68	39
1226927	Digital_currency	201406	4	0	0	0	4	3	0	0	437	101	52	381	70	39
1226927	Digital_currency	201407	2	0	0	0	2	2	0	0	439	103	52	383	72	39
1226927	Digital_currency	201408	2	1	0	0	2	0	1	0	441	105	53	383	72	39
1226927	Digital_currency	201409	9	0	0	0	3	2	0	0	450	106	53	391	72	39
1226927	Digital_currency	201410	3	1	0	0	2	1	1	0	453	108	54	392	73	39
1226927	Digital_currency	201411	5	1	0	0	4	3	1	0	458	110	55	396	74	39
1226927	Digital_currency	201412	4	0	0	0	4	3	0	0	462	111	55	399	74	39
1226927	Digital_currency	201501	24	5	4	3	8	7	2	2	486	115	60	420	77	44
1226927	Digital_currency	201502	4	0	0	0	3	2	0	0	490	118	60	422	79	44
1226927	Digital_currency	201503	8	0	0	0	5	3	0	0	498	121	60	428	80	44
1226927	Digital_currency	201504	6	1	0	0	6	4	1	0	504	125	61	432	82	45
1226927	Digital_currency	201505	2	1	0	0	2	1	1	0	506	126	62	433	82	45
1226927	Digital_currency	201506	7	0	0	0	5	5	0	0	513	128	62	440	84	45
1226927	Digital_currency	201507	1	0	0	0	1	0	0	0	514	129	62	440	84	45
1226927	Digital_currency	201508	2	1	0	0	2	2	1	0	516	129	63	442	84	45
1226927	Digital_currency	201509	6	0	0	0	4	4	0	0	522	132	63	448	86	45
1226927	Digital_currency	201510	6	0	0	0	2	2	0	0	528	133	63	454	87	45
1226927	Digital_currency	201512	5	3	2	1	2	1	2	2	533	134	66	456	87	46
1226927	Digital_currency	201601	8	3	0	0	6	4	3	0	541	139	69	460	90	47
1226927	Digital_currency	201603	1	0	0	0	1	1	0	0	542	140	69	461	91	47
1226927	Digital_currency	201604	2	1	0	0	2	1	1	0	544	141	70	462	91	47
1226927	Digital_currency	201605	4	2	0	0	2	2	1	0	548	143	72	466	93	49
1226927	Digital_currency	201607	10	3	0	0	7	5	2	0	558	148	75	474	96	51
1226927	Digital_currency	201608	1	0	0	0	1	1	0	0	559	149	75	475	97	51
1226927	Digital_currency	201609	1	0	0	0	1	0	0	0	560	150	75	475	97	51
1226927	Digital_currency	201610	6	0	0	0	4	2	0	0	566	153	75	477	98	51
1226927	Digital_currency	201611	38	0	0	0	4	4	0	0	604	155	75	515	100	51
1226927	Digital_currency	201612	7	2	0	0	7	5	2	0	611	161	77	520	104	52
1226927	Digital_currency	201701	6	0	0	0	5	4	0	0	617	163	77	525	105	52
1226927	Digital_currency	201702	10	1	0	0	6	6	1	0	627	168	78	535	110	53
1226927	Digital_currency	201703	2	0	0	0	2	1	0	0	629	169	78	536	111	53
1226927	Digital_currency	201704	7	0	0	0	2	2	0	0	636	170	78	543	112	53
1226927	Digital_currency	201705	4	1	0	0	3	2	1	0	640	172	79	546	113	53
1226927	Digital_currency	201706	10	1	0	0	5	5	1	0	650	176	80	556	117	54
1226927	Digital_currency	201707	5	1	0	0	5	4	1	0	655	179	81	560	119	54
1226927	Digital_currency	201708	7	1	0	0	6	5	1	0	662	184	82	566	123	55
1226927	Digital_currency	201709	21	3	0	0	14	8	3	0	683	195	85	579	128	56
1226927	Digital_currency	201710	11	3	1	0	9	9	3	1	694	200	88	590	133	59
1226927	Digital_currency	201711	15	1	0	0	8	6	1	0	709	206	89	602	137	59
1226927	Digital_currency	201712	4	0	0	0	3	3	0	0	713	209	89	606	140	59
1226927	Digital_currency	201801	16	5	0	0	14	9	4	0	729	220	94	617	146	61
1226927	Digital_currency	201802	10	1	0	0	8	7	1	0	739	226	95	626	151	62
1226927	Digital_currency	201803	22	8	1	0	17	12	7	1	761	236	103	642	156	66
1226927	Digital_currency	201804	4	1	0	0	3	2	1	0	765	238	104	645	157	67
1226927	Digital_currency	201805	12	2	0	0	6	4	2	0	777	241	106	655	158	67
1226927	Digital_currency	201806	8	2	0	0	8	8	2	0	785	247	108	663	162	69
1226927	Digital_currency	201807	8	1	0	0	7	5	1	0	793	250	109	669	163	70
39068	Digital_electronics	200204	4	0	0	0	2	2	0	0	4	2	0	4	2	0
39068	Digital_electronics	200208	1	0	0	0	1	1	0	0	5	3	0	5	3	0
39068	Digital_electronics	200209	2	0	0	0	1	1	0	0	7	4	0	7	4	0
39068	Digital_electronics	200302	1	0	0	0	1	1	0	0	8	5	0	8	5	0
39068	Digital_electronics	200304	1	0	0	0	1	1	0	0	9	5	0	9	5	0
39068	Digital_electronics	200306	1	0	0	0	1	0	0	0	10	6	0	9	5	0
39068	Digital_electronics	200309	2	1	0	0	2	1	1	0	12	7	1	10	5	0
39068	Digital_electronics	200310	2	0	0	0	1	0	0	0	14	8	1	10	5	0
39068	Digital_electronics	200311	8	0	0	0	4	1	0	0	22	12	1	12	6	0
39068	Digital_electronics	200401	1	0	0	0	1	1	0	0	23	12	1	13	6	0
39068	Digital_electronics	200405	4	0	0	0	1	1	0	0	27	13	1	17	7	0
39068	Digital_electronics	200406	1	0	0	0	1	1	0	0	28	14	1	18	8	0
39068	Digital_electronics	200407	3	0	0	0	3	2	0	0	31	17	1	20	10	0
39068	Digital_electronics	200408	1	0	0	0	1	0	0	0	32	18	1	20	10	0
39068	Digital_electronics	200409	2	0	0	0	1	1	0	0	34	19	1	22	11	0
39068	Digital_electronics	200410	6	2	0	0	4	2	1	0	40	23	3	25	13	0
39068	Digital_electronics	200501	2	0	0	0	2	2	0	0	42	25	3	27	15	0
39068	Digital_electronics	200502	2	0	0	0	2	0	0	0	44	27	3	27	15	0
39068	Digital_electronics	200503	2	0	0	0	2	1	0	0	46	29	3	28	16	0
39068	Digital_electronics	200504	13	0	0	0	3	2	0	0	59	32	3	33	18	0
39068	Digital_electronics	200505	5	0	0	0	2	1	0	0	64	33	3	34	19	0
39068	Digital_electronics	200506	19	0	0	0	2	1	0	0	83	33	3	36	19	0
39068	Digital_electronics	200507	20	1	0	0	10	4	1	0	103	41	4	43	22	0
39068	Digital_electronics	200508	5	0	0	0	5	1	0	0	108	45	4	44	23	0
39068	Digital_electronics	200509	8	0	0	0	5	4	0	0	116	50	4	48	27	0
39068	Digital_electronics	200510	6	2	0	0	5	2	2	0	122	55	6	51	29	0
39068	Digital_electronics	200511	9	0	0	0	6	3	0	0	131	60	6	56	32	0
39068	Digital_electronics	200512	3	0	0	0	3	1	0	0	134	62	6	57	33	0
39068	Digital_electronics	200601	2	0	0	0	2	2	0	0	136	64	6	59	35	0
39068	Digital_electronics	200602	30	2	1	0	4	2	2	1	166	68	8	61	37	1
39068	Digital_electronics	200603	14	0	0	0	7	5	0	0	180	73	8	73	42	1
39068	Digital_electronics	200605	3	0	0	0	2	2	0	0	183	74	8	76	43	1
39068	Digital_electronics	200606	4	0	0	0	3	2	0	0	187	76	8	79	44	1
39068	Digital_electronics	200607	5	0	0	0	4	3	0	0	192	79	8	83	46	1
39068	Digital_electronics	200608	7	1	0	0	6	3	1	0	199	83	9	87	47	1
39068	Digital_electronics	200609	6	2	0	0	6	4	2	0	205	88	11	91	50	1
39068	Digital_electronics	200610	16	7	1	0	11	7	6	1	221	97	18	98	55	3
39068	Digital_electronics	200611	6	1	0	0	6	4	1	0	227	103	19	102	59	3
39068	Digital_electronics	200612	9	4	0	0	6	4	3	0	236	106	23	108	61	4
39068	Digital_electronics	200701	18	3	0	0	10	7	3	0	254	113	26	122	65	4
39068	Digital_electronics	200702	18	7	2	1	13	6	4	2	272	124	33	132	69	7
39068	Digital_electronics	200703	13	3	2	2	7	4	2	1	285	129	36	142	71	9
39068	Digital_electronics	200704	4	1	1	1	3	3	1	1	289	130	37	146	72	10
39068	Digital_electronics	200705	5	1	0	0	3	2	1	0	294	132	38	150	73	11
39068	Digital_electronics	200706	6	3	0	0	6	3	3	0	300	135	41	153	73	11
39068	Digital_electronics	200707	5	2	0	0	5	2	2	0	305	139	43	155	74	11
39068	Digital_electronics	200708	4	0	0	0	3	3	0	0	309	142	43	159	77	11
39068	Digital_electronics	200709	9	1	0	0	6	4	1	0	318	145	44	166	78	12
39068	Digital_electronics	200710	23	0	0	0	8	4	0	0	341	150	44	183	79	12
39068	Digital_electronics	200711	22	1	0	0	15	10	1	0	363	160	45	200	84	12
39068	Digital_electronics	200712	4	1	0	0	3	2	1	0	367	163	46	202	86	12
39068	Digital_electronics	200801	8	1	0	0	7	4	1	0	375	170	47	207	90	12
39068	Digital_electronics	200802	5	1	0	0	5	1	1	0	380	174	48	208	90	12
39068	Digital_electronics	200803	7	1	0	0	7	6	1	0	387	180	49	214	95	13
39068	Digital_electronics	200804	12	4	0	0	10	4	4	0	399	189	53	220	98	13
39068	Digital_electronics	200805	7	1	0	0	6	4	1	0	406	192	54	224	99	14
39068	Digital_electronics	200806	12	6	1	0	8	5	6	1	418	199	60	229	103	15
39068	Digital_electronics	200807	8	3	0	0	6	6	3	0	426	204	63	237	108	18
39068	Digital_electronics	200808	5	2	0	0	5	4	2	0	431	207	65	241	110	19
39068	Digital_electronics	200809	14	1	0	0	8	3	1	0	445	213	66	246	111	19
39068	Digital_electronics	200810	19	4	0	0	11	6	4	0	464	221	70	252	114	19
39068	Digital_electronics	200811	28	3	0	0	14	6	3	0	492	234	73	258	119	19
39068	Digital_electronics	200812	33	8	0	0	11	6	7	0	525	243	81	265	124	20
39068	Digital_electronics	200901	1	0	0	0	1	1	0	0	526	244	81	266	125	20
39068	Digital_electronics	200902	1	0	0	0	1	1	0	0	527	245	81	267	126	20
39068	Digital_electronics	200903	2	1	0	0	2	1	1	0	529	247	82	268	127	20
39068	Digital_electronics	200904	9	5	1	0	6	3	4	1	538	251	87	272	129	21
39068	Digital_electronics	200905	11	1	0	0	9	4	1	0	549	258	88	277	132	21
39068	Digital_electronics	200906	5	0	0	0	5	3	0	0	554	263	88	280	135	21
39068	Digital_electronics	200907	4	1	0	0	4	2	1	0	558	266	89	282	136	21
39068	Digital_electronics	200908	9	5	1	0	6	3	4	1	567	270	94	287	137	23
39068	Digital_electronics	200909	10	3	0	0	7	5	2	0	577	275	97	295	140	24
39068	Digital_electronics	200910	10	2	0	0	6	3	2	0	587	279	99	299	141	24
39068	Digital_electronics	200911	14	4	0	0	10	6	3	0	601	287	103	308	145	24
39068	Digital_electronics	200912	11	5	0	0	8	3	3	0	612	294	108	313	147	24
39068	Digital_electronics	201001	9	2	0	0	6	4	2	0	621	299	110	317	150	24
39068	Digital_electronics	201002	6	3	0	0	6	2	3	0	627	305	113	319	152	24
39068	Digital_electronics	201003	13	3	0	0	8	5	1	0	640	311	116	328	156	25
39068	Digital_electronics	201004	6	1	0	0	6	3	1	0	646	316	117	331	158	25
39068	Digital_electronics	201005	5	2	0	0	2	1	1	0	651	318	119	333	159	25
39068	Digital_electronics	201006	11	3	0	0	8	5	3	0	662	323	122	341	161	25
39068	Digital_electronics	201007	11	1	0	0	6	4	1	0	673	329	123	350	165	25
39068	Digital_electronics	201008	5	1	0	0	4	2	1	0	678	332	124	352	166	25
39068	Digital_electronics	201009	7	1	0	0	6	2	1	0	685	337	125	354	167	25
39068	Digital_electronics	201010	22	4	0	0	11	8	4	0	707	345	129	365	172	25
39068	Digital_electronics	201011	11	1	0	0	5	2	1	0	718	349	130	371	173	25
39068	Digital_electronics	201012	2	0	0	0	1	1	0	0	720	350	130	373	174	25
39068	Digital_electronics	201101	7	2	0	0	7	3	2	0	727	357	132	376	177	25
39068	Digital_electronics	201102	2	0	0	0	2	1	0	0	729	358	132	377	177	25
39068	Digital_electronics	201103	3	0	0	0	2	1	0	0	732	359	132	379	178	25
39068	Digital_electronics	201104	13	2	0	0	7	6	2	0	745	365	134	389	183	26
39068	Digital_electronics	201106	5	1	0	0	5	4	1	0	750	369	135	393	186	26
39068	Digital_electronics	201107	2	0	0	0	2	1	0	0	752	371	135	394	187	26
39068	Digital_electronics	201108	8	1	0	0	7	4	1	0	760	377	136	399	190	26
39068	Digital_electronics	201109	3	0	0	0	1	0	0	0	763	378	136	399	190	26
39068	Digital_electronics	201110	5	1	0	0	5	4	1	0	768	382	137	403	193	26
39068	Digital_electronics	201111	12	1	0	0	8	4	1	0	780	389	138	411	196	26
39068	Digital_electronics	201112	2	0	0	0	1	1	0	0	782	389	138	413	196	26
39068	Digital_electronics	201201	6	1	0	0	5	3	1	0	788	391	139	416	196	26
39068	Digital_electronics	201202	2	0	0	0	2	0	0	0	790	393	139	416	196	26
39068	Digital_electronics	201203	6	1	0	0	4	2	1	0	796	396	140	419	197	26
39068	Digital_electronics	201204	4	0	0	0	4	4	0	0	800	398	140	423	199	26
39068	Digital_electronics	201205	4	0	0	0	3	1	0	0	804	400	140	425	199	26
39068	Digital_electronics	201206	10	3	0	0	6	3	3	0	814	404	143	428	200	27
39068	Digital_electronics	201207	5	2	0	0	5	2	2	0	819	409	145	430	202	27
39068	Digital_electronics	201208	1	0	0	0	1	1	0	0	820	409	145	431	202	27
39068	Digital_electronics	201209	6	0	0	0	3	2	0	0	826	411	145	435	203	27
39068	Digital_electronics	201210	9	0	0	0	3	2	0	0	835	412	145	443	203	27
39068	Digital_electronics	201211	18	5	0	0	11	4	3	0	853	420	150	450	204	27
39068	Digital_electronics	201212	4	1	0	0	4	3	1	0	857	424	151	453	207	27
39068	Digital_electronics	201301	4	0	0	0	4	4	0	0	861	427	151	457	210	27
39068	Digital_electronics	201302	2	1	0	0	2	1	1	0	863	428	152	458	210	27
39068	Digital_electronics	201303	4	1	0	0	4	3	1	0	867	431	153	461	212	27
39068	Digital_electronics	201306	1	0	0	0	1	1	0	0	868	432	153	462	213	27
39068	Digital_electronics	201307	5	2	0	0	5	2	2	0	873	437	155	464	215	27
39068	Digital_electronics	201308	4	1	0	0	3	2	1	0	877	438	156	466	215	27
39068	Digital_electronics	201310	2	0	0	0	1	1	0	0	879	439	156	468	216	27
39068	Digital_electronics	201311	1	0	0	0	1	0	0	0	880	440	156	468	216	27
39068	Digital_electronics	201312	2	1	0	0	2	1	1	0	882	441	157	469	216	27
39068	Digital_electronics	201401	2	1	0	0	2	1	1	0	884	442	158	470	216	27
39068	Digital_electronics	201402	2	0	0	0	2	1	0	0	886	444	158	471	217	27
39068	Digital_electronics	201403	1	0	0	0	1	0	0	0	887	445	158	471	217	27
39068	Digital_electronics	201404	6	3	0	0	4	2	2	0	893	448	161	474	218	27
39068	Digital_electronics	201405	1	0	0	0	1	0	0	0	894	449	161	474	218	27
39068	Digital_electronics	201406	2	1	0	0	2	1	1	0	896	450	162	475	218	27
39068	Digital_electronics	201407	5	1	0	0	3	1	1	0	901	453	163	476	219	27
39068	Digital_electronics	201408	2	0	0	0	2	1	0	0	903	455	163	477	220	27
39068	Digital_electronics	201409	1	1	0	0	1	0	1	0	904	456	164	477	220	27
39068	Digital_electronics	201410	3	0	0	0	1	1	0	0	907	456	164	480	220	27
39068	Digital_electronics	201411	6	1	0	0	5	2	1	0	913	460	165	483	221	27
39068	Digital_electronics	201501	8	4	0	0	8	5	4	0	921	467	169	488	225	28
39068	Digital_electronics	201502	2	0	0	0	2	2	0	0	923	469	169	490	227	28
39068	Digital_electronics	201503	4	1	0	0	3	2	1	0	927	471	170	493	228	28
39068	Digital_electronics	201504	4	0	0	0	3	1	0	0	931	474	170	494	229	28
39068	Digital_electronics	201505	1	0	0	0	1	1	0	0	932	474	170	495	229	28
39068	Digital_electronics	201506	2	1	0	0	2	1	1	0	934	475	171	496	229	28
39068	Digital_electronics	201507	2	1	0	0	2	1	1	0	936	477	172	497	230	28
39068	Digital_electronics	201508	5	0	0	0	1	0	0	0	941	478	172	497	230	28
39068	Digital_electronics	201509	13	1	0	0	6	5	1	0	954	483	173	509	234	28
39068	Digital_electronics	201510	7	0	0	0	7	6	0	0	961	488	173	515	238	28
39068	Digital_electronics	201511	8	4	0	0	6	2	2	0	969	493	177	519	239	28
39068	Digital_electronics	201512	5	0	0	0	4	4	0	0	974	496	177	524	242	28
39068	Digital_electronics	201602	15	3	1	0	4	4	3	1	989	496	180	539	242	31
39068	Digital_electronics	201603	4	1	0	0	3	2	1	0	993	498	181	542	243	31
39068	Digital_electronics	201604	14	5	0	0	7	7	4	0	1007	505	186	556	250	36
39068	Digital_electronics	201605	1	0	0	0	1	1	0	0	1008	505	186	557	250	36
39068	Digital_electronics	201606	3	1	0	0	3	3	1	0	1011	507	187	560	252	37
39068	Digital_electronics	201608	1	0	0	0	1	0	0	0	1012	508	187	560	252	37
39068	Digital_electronics	201609	9	1	0	0	4	3	1	0	1021	510	188	568	253	38
39068	Digital_electronics	201610	12	3	0	0	7	5	3	0	1033	515	191	576	256	38
39068	Digital_electronics	201611	3	0	0	0	3	3	0	0	1036	516	191	579	257	38
39068	Digital_electronics	201701	3	1	0	0	3	1	1	0	1039	518	192	580	257	38
39068	Digital_electronics	201702	6	0	0	0	5	5	0	0	1045	522	192	586	261	38
39068	Digital_electronics	201703	7	2	0	0	5	4	2	0	1052	523	194	590	261	39
39068	Digital_electronics	201704	2	0	0	0	1	1	0	0	1054	524	194	592	262	39
39068	Digital_electronics	201705	6	1	0	0	4	2	1	0	1060	528	195	594	264	39
39068	Digital_electronics	201706	4	1	0	0	4	3	1	0	1064	530	196	597	265	39
39068	Digital_electronics	201707	3	1	0	0	3	3	1	0	1067	533	197	600	267	40
39068	Digital_electronics	201708	2	0	0	0	2	2	0	0	1069	534	197	602	268	40
39068	Digital_electronics	201709	7	2	0	0	5	4	2	0	1076	538	199	608	271	41
39068	Digital_electronics	201710	18	1	0	0	6	5	1	0	1094	542	200	623	274	41
39068	Digital_electronics	201801	1	0	0	0	1	1	0	0	1095	542	200	624	274	41
39068	Digital_electronics	201805	2	0	0	0	2	1	0	0	1097	543	200	625	274	41
39068	Digital_electronics	201806	9	4	0	0	4	3	2	0	1106	546	204	630	276	41
16066056	Digital_modeling_and_fabrication	200804	16	0	0	0	4	4	0	0	16	4	0	16	4	0
16066056	Digital_modeling_and_fabrication	200902	3	0	0	0	2	2	0	0	19	5	0	19	5	0
16066056	Digital_modeling_and_fabrication	200905	1	0	0	0	1	1	0	0	20	6	0	20	6	0
16066056	Digital_modeling_and_fabrication	200906	1	0	0	0	1	1	0	0	21	7	0	21	7	0
16066056	Digital_modeling_and_fabrication	200908	1	0	0	0	1	1	0	0	22	8	0	22	8	0
16066056	Digital_modeling_and_fabrication	200910	2	0	0	0	1	1	0	0	24	9	0	24	9	0
16066056	Digital_modeling_and_fabrication	201001	1	0	0	0	1	1	0	0	25	10	0	25	10	0
16066056	Digital_modeling_and_fabrication	201012	1	0	0	0	1	1	0	0	26	11	0	26	11	0
16066056	Digital_modeling_and_fabrication	201101	4	0	0	0	3	3	0	0	30	13	0	30	13	0
16066056	Digital_modeling_and_fabrication	201104	2	0	0	0	1	1	0	0	32	14	0	32	14	0
16066056	Digital_modeling_and_fabrication	201108	2	0	0	0	2	2	0	0	34	16	0	34	16	0
16066056	Digital_modeling_and_fabrication	201201	1	0	0	0	1	0	0	0	35	17	0	34	16	0
16066056	Digital_modeling_and_fabrication	201202	3	1	0	0	3	3	1	0	38	19	1	37	18	1
16066056	Digital_modeling_and_fabrication	201204	3	1	0	0	2	2	1	0	41	20	2	40	19	2
16066056	Digital_modeling_and_fabrication	201205	1	0	0	0	1	1	0	0	42	21	2	41	20	2
16066056	Digital_modeling_and_fabrication	201212	1	0	0	0	1	1	0	0	43	22	2	42	21	2
16066056	Digital_modeling_and_fabrication	201303	1	0	0	0	1	0	0	0	44	23	2	42	21	2
16066056	Digital_modeling_and_fabrication	201304	1	0	0	0	1	0	0	0	45	24	2	42	21	2
16066056	Digital_modeling_and_fabrication	201305	1	0	0	0	1	0	0	0	46	25	2	42	21	2
16066056	Digital_modeling_and_fabrication	201306	2	0	0	0	1	0	0	0	48	26	2	42	21	2
16066056	Digital_modeling_and_fabrication	201309	1	0	0	0	1	1	0	0	49	27	2	43	22	2
16066056	Digital_modeling_and_fabrication	201312	1	0	0	0	1	1	0	0	50	28	2	44	23	2
16066056	Digital_modeling_and_fabrication	201402	4	0	0	0	1	1	0	0	54	29	2	48	24	2
16066056	Digital_modeling_and_fabrication	201403	2	1	0	0	2	1	1	0	56	31	3	49	25	2
16066056	Digital_modeling_and_fabrication	201407	5	0	0	0	2	2	0	0	61	33	3	54	27	2
16066056	Digital_modeling_and_fabrication	201408	5	0	0	0	2	2	0	0	66	34	3	59	28	2
16066056	Digital_modeling_and_fabrication	201411	1	0	0	0	1	0	0	0	67	35	3	59	28	2
16066056	Digital_modeling_and_fabrication	201509	6	0	0	0	4	3	0	0	73	39	3	64	31	2
16066056	Digital_modeling_and_fabrication	201511	2	0	0	0	1	1	0	0	75	40	3	66	32	2
16066056	Digital_modeling_and_fabrication	201602	1	0	0	0	1	0	0	0	76	41	3	66	32	2
16066056	Digital_modeling_and_fabrication	201603	1	0	0	0	1	1	0	0	77	42	3	67	33	2
16066056	Digital_modeling_and_fabrication	201606	1	0	0	0	1	0	0	0	78	43	3	67	33	2
16066056	Digital_modeling_and_fabrication	201609	1	0	0	0	1	1	0	0	79	44	3	68	34	2
16066056	Digital_modeling_and_fabrication	201610	3	0	0	0	1	0	0	0	82	45	3	68	34	2
16066056	Digital_modeling_and_fabrication	201611	2	0	0	0	2	2	0	0	84	47	3	70	36	2
16066056	Digital_modeling_and_fabrication	201701	2	0	0	0	1	1	0	0	86	47	3	72	36	2
16066056	Digital_modeling_and_fabrication	201706	1	0	0	0	1	0	0	0	87	48	3	72	36	2
16066056	Digital_modeling_and_fabrication	201707	2	0	0	0	1	1	0	0	89	49	3	74	37	2
16066056	Digital_modeling_and_fabrication	201710	1	0	0	0	1	1	0	0	90	50	3	75	38	2
16066056	Digital_modeling_and_fabrication	201711	18	0	0	0	1	1	0	0	108	51	3	93	39	2
16066056	Digital_modeling_and_fabrication	201801	2	0	0	0	1	1	0	0	110	52	3	95	40	2
16066056	Digital_modeling_and_fabrication	201802	1	0	0	0	1	0	0	0	111	53	3	95	40	2
59644	Digital_signature	200302	4	0	0	0	3	1	0	0	4	3	0	1	1	0
59644	Digital_signature	200305	2	0	0	0	1	1	0	0	6	4	0	3	2	0
59644	Digital_signature	200307	1	0	0	0	1	0	0	0	7	5	0	3	2	0
59644	Digital_signature	200309	1	0	0	0	1	0	0	0	8	6	0	3	2	0
59644	Digital_signature	200311	9	1	0	0	4	3	1	0	17	10	1	11	5	1
59644	Digital_signature	200402	2	0	0	0	2	0	0	0	19	12	1	11	5	1
59644	Digital_signature	200403	1	0	0	0	1	1	0	0	20	13	1	12	6	1
59644	Digital_signature	200404	3	0	0	0	2	2	0	0	23	15	1	15	8	1
59644	Digital_signature	200405	11	0	0	0	5	2	0	0	34	19	1	22	9	1
59644	Digital_signature	200406	21	0	0	0	2	2	0	0	55	20	1	43	10	1
59644	Digital_signature	200407	2	0	0	0	2	0	0	0	57	22	1	43	10	1
59644	Digital_signature	200408	3	0	0	0	2	2	0	0	60	22	1	46	10	1
59644	Digital_signature	200410	1	0	0	0	1	0	0	0	61	23	1	46	10	1
59644	Digital_signature	200411	7	1	0	0	6	4	1	0	68	27	2	51	12	1
59644	Digital_signature	200412	3	1	0	0	3	1	1	0	71	30	3	52	13	1
59644	Digital_signature	200501	9	1	0	0	8	4	1	0	80	37	4	57	16	1
59644	Digital_signature	200502	5	0	0	0	5	3	0	0	85	42	4	60	19	1
59644	Digital_signature	200503	2	0	0	0	2	2	0	0	87	44	4	62	21	1
59644	Digital_signature	200504	11	0	0	0	5	3	0	0	98	48	4	71	23	1
59644	Digital_signature	200505	4	1	0	0	4	1	1	0	102	51	5	72	23	1
59644	Digital_signature	200506	3	1	0	0	3	1	1	0	105	54	6	73	24	1
59644	Digital_signature	200507	6	1	0	0	4	1	1	0	111	58	7	76	25	1
59644	Digital_signature	200508	6	1	0	0	6	2	1	0	117	63	8	78	26	1
59644	Digital_signature	200509	8	0	0	0	7	4	0	0	125	68	8	83	28	1
59644	Digital_signature	200510	14	3	0	0	11	6	3	0	139	78	11	92	33	1
59644	Digital_signature	200511	8	2	0	0	4	2	2	0	147	81	13	94	34	1
59644	Digital_signature	200512	13	2	0	0	9	3	2	0	160	89	15	98	36	1
59644	Digital_signature	200601	8	2	0	0	7	4	2	0	168	96	17	103	40	1
59644	Digital_signature	200602	19	5	0	0	12	8	4	0	187	106	22	112	46	1
59644	Digital_signature	200603	13	1	0	0	8	3	1	0	200	114	23	115	49	1
59644	Digital_signature	200604	11	0	0	0	9	3	0	0	211	122	23	120	51	1
59644	Digital_signature	200605	19	2	0	0	15	8	2	0	230	135	25	131	57	3
59644	Digital_signature	200606	19	2	0	0	16	9	2	0	249	149	27	140	64	3
59644	Digital_signature	200607	27	1	0	0	13	4	1	0	276	159	28	155	66	3
59644	Digital_signature	200608	46	3	0	0	22	11	3	0	322	177	31	182	73	3
59644	Digital_signature	200609	31	3	0	0	23	7	3	0	353	196	34	191	77	3
59644	Digital_signature	200610	8	0	0	0	7	3	0	0	361	202	34	194	79	3
59644	Digital_signature	200611	13	5	2	1	9	4	4	2	374	211	39	199	83	4
59644	Digital_signature	200612	28	4	0	0	9	3	1	0	402	218	43	211	84	5
59644	Digital_signature	200701	20	3	0	0	9	3	2	0	422	225	46	220	85	5
59644	Digital_signature	200702	5	0	0	0	4	1	0	0	427	229	46	222	86	5
59644	Digital_signature	200703	31	3	0	0	17	8	2	0	458	244	49	241	92	6
59644	Digital_signature	200704	19	4	0	0	14	5	3	0	477	256	53	247	96	6
59644	Digital_signature	200705	18	4	0	0	14	6	2	0	495	268	57	255	100	7
59644	Digital_signature	200706	12	1	0	0	10	6	1	0	507	276	58	261	104	8
59644	Digital_signature	200707	17	5	0	0	12	7	4	0	524	286	63	270	109	9
59644	Digital_signature	200708	25	1	0	0	16	7	1	0	549	300	64	283	114	9
59644	Digital_signature	200709	8	2	0	0	7	2	2	0	557	305	66	285	114	9
59644	Digital_signature	200710	4	1	0	0	4	3	1	0	561	308	67	288	116	10
59644	Digital_signature	200711	17	6	0	0	11	6	5	0	578	318	73	295	121	12
59644	Digital_signature	200712	25	8	0	0	14	4	4	0	603	329	81	305	123	12
59644	Digital_signature	200801	6	3	0	0	5	3	3	0	609	333	84	308	125	12
59644	Digital_signature	200802	11	1	0	0	6	3	1	0	620	338	85	313	127	12
59644	Digital_signature	200803	2	0	0	0	2	0	0	0	622	340	85	313	127	12
59644	Digital_signature	200804	10	2	0	0	7	3	2	0	632	346	87	317	130	12
59644	Digital_signature	200805	13	3	0	0	10	5	3	0	645	354	90	325	133	12
59644	Digital_signature	200806	18	5	0	0	13	6	4	0	663	365	95	334	137	13
59644	Digital_signature	200807	20	3	0	0	15	9	3	0	683	378	98	347	144	13
59644	Digital_signature	200808	7	2	0	0	6	3	2	0	690	382	100	350	145	13
59644	Digital_signature	200809	16	1	0	0	9	6	1	0	706	387	101	359	147	13
59644	Digital_signature	200810	10	2	0	0	8	4	2	0	716	394	103	363	150	13
59644	Digital_signature	200811	13	2	0	0	11	8	2	0	729	402	105	372	155	14
59644	Digital_signature	200812	11	3	0	0	9	6	3	0	740	410	108	379	160	14
59644	Digital_signature	200901	2	1	0	0	2	1	1	0	742	411	109	380	160	14
59644	Digital_signature	200902	21	3	0	0	9	5	2	0	763	418	112	386	163	15
59644	Digital_signature	200903	4	2	0	0	3	1	1	0	767	420	114	388	163	15
59644	Digital_signature	200904	21	5	0	0	15	9	5	0	788	432	119	403	169	16
59644	Digital_signature	200905	9	1	0	0	5	3	1	0	797	435	120	409	170	16
59644	Digital_signature	200906	13	3	0	0	7	5	2	0	810	441	123	420	174	17
59644	Digital_signature	200907	3	0	0	0	2	2	0	0	813	443	123	423	176	17
59644	Digital_signature	200908	5	1	0	0	4	3	1	0	818	446	124	427	178	17
59644	Digital_signature	200909	5	1	0	0	3	2	1	0	823	448	125	431	179	17
59644	Digital_signature	200910	2	0	0	0	1	0	0	0	825	449	125	431	179	17
59644	Digital_signature	200911	13	5	0	0	10	7	4	0	838	455	130	440	182	18
59644	Digital_signature	200912	12	2	0	0	9	5	2	0	850	463	132	445	186	18
59644	Digital_signature	201001	8	2	0	0	6	3	2	0	858	468	134	448	188	19
59644	Digital_signature	201002	8	2	0	0	8	5	2	0	866	475	136	453	192	19
59644	Digital_signature	201003	3	1	0	0	3	1	1	0	869	478	137	454	193	19
59644	Digital_signature	201004	14	5	0	0	10	5	4	0	883	487	142	460	197	19
59644	Digital_signature	201005	23	8	0	0	11	6	3	0	906	497	150	474	202	20
59644	Digital_signature	201006	7	1	0	0	5	2	1	0	913	501	151	476	203	20
59644	Digital_signature	201007	7	0	0	0	6	2	0	0	920	507	151	478	205	20
59644	Digital_signature	201008	8	1	0	0	4	2	1	0	928	511	152	483	207	20
59644	Digital_signature	201009	8	2	0	0	6	3	2	0	936	515	154	487	208	20
59644	Digital_signature	201010	16	4	0	0	10	5	3	0	952	522	158	494	210	20
59644	Digital_signature	201011	12	5	0	0	9	4	5	0	964	530	163	498	213	20
59644	Digital_signature	201012	2	1	0	0	2	1	1	0	966	531	164	499	213	20
59644	Digital_signature	201102	7	2	0	0	7	3	2	0	973	537	166	502	215	20
59644	Digital_signature	201103	12	3	0	0	7	4	3	0	985	541	169	507	217	21
59644	Digital_signature	201104	11	5	0	0	7	5	3	0	996	546	174	514	220	22
59644	Digital_signature	201105	6	1	0	0	6	4	1	0	1002	552	175	518	224	22
59644	Digital_signature	201106	12	3	0	0	10	5	3	0	1014	560	178	524	227	22
59644	Digital_signature	201107	4	1	0	0	4	3	1	0	1018	563	179	527	229	22
59644	Digital_signature	201108	5	1	0	0	3	0	1	0	1023	566	180	527	229	22
59644	Digital_signature	201109	5	2	0	0	5	3	2	0	1028	569	182	530	230	22
59644	Digital_signature	201110	8	1	0	0	8	7	1	0	1036	575	183	537	235	22
59644	Digital_signature	201111	9	3	0	0	7	6	3	0	1045	580	186	544	239	23
59644	Digital_signature	201112	8	1	0	0	5	3	1	0	1053	584	187	550	241	23
59644	Digital_signature	201201	6	3	0	0	5	3	3	0	1059	587	190	553	242	23
59644	Digital_signature	201202	5	1	0	0	3	1	1	0	1064	589	191	554	242	23
59644	Digital_signature	201203	8	1	0	0	7	5	1	0	1072	594	192	559	246	24
59644	Digital_signature	201204	9	1	0	0	7	2	1	0	1081	600	193	561	247	24
59644	Digital_signature	201205	8	1	0	0	2	1	1	0	1089	601	194	563	247	24
59644	Digital_signature	201206	3	1	0	0	3	3	1	0	1092	603	195	566	249	25
59644	Digital_signature	201207	4	1	0	0	4	2	1	0	1096	606	196	568	250	26
59644	Digital_signature	201208	15	3	0	0	10	7	3	0	1111	614	199	579	255	27
59644	Digital_signature	201209	3	0	0	0	3	1	0	0	1114	616	199	580	255	27
59644	Digital_signature	201210	12	4	0	0	8	5	4	0	1126	621	203	589	257	29
59644	Digital_signature	201211	15	5	0	0	10	6	5	0	1141	628	208	595	260	29
59644	Digital_signature	201212	5	1	0	0	5	4	1	0	1146	633	209	599	264	30
59644	Digital_signature	201302	8	2	0	0	6	3	2	0	1154	637	211	603	265	30
59644	Digital_signature	201303	6	1	0	0	6	3	1	0	1160	641	212	606	266	30
59644	Digital_signature	201304	2	1	0	0	2	1	1	0	1162	642	213	607	266	30
59644	Digital_signature	201305	11	3	0	0	8	5	2	0	1173	650	216	613	271	30
59644	Digital_signature	201306	16	5	0	0	11	6	4	0	1189	657	221	620	273	30
59644	Digital_signature	201307	14	4	0	0	11	5	4	0	1203	665	225	625	275	30
59644	Digital_signature	201308	6	1	0	0	4	3	1	0	1209	667	226	629	276	30
59644	Digital_signature	201309	3	1	0	0	3	1	1	0	1212	669	227	630	276	30
59644	Digital_signature	201310	1	0	0	0	1	1	0	0	1213	670	227	631	277	30
59644	Digital_signature	201311	10	3	0	0	8	4	3	0	1223	676	230	635	279	31
59644	Digital_signature	201312	9	2	0	0	6	4	1	0	1232	681	232	640	282	31
59644	Digital_signature	201401	9	2	0	0	7	2	2	0	1241	688	234	642	284	31
59644	Digital_signature	201402	14	4	0	0	11	7	4	0	1255	697	238	652	289	33
59644	Digital_signature	201403	3	0	0	0	2	0	0	0	1258	699	238	652	289	33
59644	Digital_signature	201404	12	2	0	0	8	5	2	0	1270	705	240	660	292	34
59644	Digital_signature	201405	3	1	0	0	3	1	1	0	1273	708	241	661	293	34
59644	Digital_signature	201406	1	0	0	0	1	0	0	0	1274	709	241	661	293	34
59644	Digital_signature	201407	6	1	0	0	4	2	1	0	1280	711	242	664	293	35
59644	Digital_signature	201408	1	0	0	0	1	1	0	0	1281	711	242	665	293	35
59644	Digital_signature	201409	13	3	0	0	7	3	2	0	1294	717	245	672	295	36
59644	Digital_signature	201410	4	1	0	0	3	2	1	0	1298	720	246	674	297	36
59644	Digital_signature	201411	2	0	0	0	2	2	0	0	1300	722	246	676	299	36
59644	Digital_signature	201412	3	1	0	0	3	1	1	0	1303	725	247	677	300	36
59644	Digital_signature	201501	3	2	0	0	3	2	2	0	1306	726	249	679	300	36
59644	Digital_signature	201502	1	0	0	0	1	1	0	0	1307	727	249	680	301	36
59644	Digital_signature	201503	6	3	0	0	6	4	3	0	1313	730	252	684	302	37
59644	Digital_signature	201504	9	3	0	0	7	5	2	0	1322	734	255	691	304	38
59644	Digital_signature	201505	15	5	0	0	14	5	5	0	1337	744	260	696	305	38
59644	Digital_signature	201506	6	0	0	0	4	2	0	0	1343	748	260	700	307	38
59644	Digital_signature	201507	13	4	0	0	8	4	2	0	1356	754	264	707	308	38
59644	Digital_signature	201508	4	0	0	0	3	0	0	0	1360	757	264	707	308	38
59644	Digital_signature	201509	23	4	0	0	13	6	3	0	1383	769	268	714	313	38
59644	Digital_signature	201510	13	4	0	0	7	4	3	0	1396	774	272	719	315	39
59644	Digital_signature	201511	11	4	0	0	7	4	3	0	1407	779	276	724	317	40
59644	Digital_signature	201512	8	2	0	0	5	4	2	0	1415	784	278	731	321	41
59644	Digital_signature	201601	6	2	0	0	6	3	2	0	1421	788	280	734	322	41
59644	Digital_signature	201602	21	3	0	0	13	9	3	0	1442	797	283	750	327	42
59644	Digital_signature	201603	5	1	0	0	4	2	1	0	1447	801	284	752	329	42
59644	Digital_signature	201604	9	3	0	0	7	4	1	0	1456	807	287	758	332	43
59644	Digital_signature	201605	5	1	0	0	5	4	1	0	1461	810	288	762	334	43
59644	Digital_signature	201606	2	0	0	0	2	1	0	0	1463	812	288	763	334	43
59644	Digital_signature	201607	3	0	0	0	3	3	0	0	1466	815	288	766	337	43
59644	Digital_signature	201608	12	3	0	0	9	5	3	0	1478	821	291	774	339	44
59644	Digital_signature	201609	10	4	0	0	7	3	4	0	1488	826	295	778	340	44
59644	Digital_signature	201610	19	4	0	0	12	4	1	0	1507	836	299	787	342	45
59644	Digital_signature	201611	3	1	0	0	3	2	1	0	1510	838	300	789	343	46
59644	Digital_signature	201612	8	2	0	0	7	4	2	0	1518	844	302	793	346	47
59644	Digital_signature	201701	10	1	0	0	5	4	1	0	1528	848	303	802	348	48
59644	Digital_signature	201702	10	3	1	0	8	4	3	1	1538	854	306	806	350	50
59644	Digital_signature	201703	16	4	0	0	9	4	3	0	1554	861	310	812	352	50
59644	Digital_signature	201704	12	5	0	0	9	6	5	0	1566	868	315	818	356	51
59644	Digital_signature	201705	1	0	0	0	1	0	0	0	1567	869	315	818	356	51
59644	Digital_signature	201706	5	0	0	0	5	3	0	0	1572	873	315	821	357	51
59644	Digital_signature	201707	1	0	0	0	1	1	0	0	1573	874	315	822	358	51
59644	Digital_signature	201708	6	2	0	0	6	5	2	0	1579	879	317	827	361	52
59644	Digital_signature	201709	10	2	0	0	8	6	2	0	1589	885	319	833	362	54
59644	Digital_signature	201710	18	7	0	0	18	11	7	0	1607	900	326	844	369	56
59644	Digital_signature	201711	5	1	0	0	4	3	1	0	1612	903	327	848	371	56
59644	Digital_signature	201712	12	4	0	0	10	6	4	0	1624	912	331	856	374	58
59644	Digital_signature	201801	4	1	0	0	4	3	1	0	1628	915	332	859	375	59
59644	Digital_signature	201802	8	2	0	0	6	4	2	0	1636	921	334	864	378	60
59644	Digital_signature	201803	12	4	0	0	10	9	4	0	1648	931	338	875	384	64
59644	Digital_signature	201804	8	3	0	0	8	8	3	0	1656	937	341	883	388	67
59644	Digital_signature	201805	6	0	0	0	5	5	0	0	1662	942	341	889	392	67
59644	Digital_signature	201806	5	1	0	0	4	3	1	0	1667	946	342	892	394	68
59644	Digital_signature	201807	1	0	0	0	1	1	0	0	1668	946	342	893	394	68
47896295	Digital_twin	201510	15	1	0	0	4	4	1	0	15	4	1	15	4	1
47896295	Digital_twin	201512	2	0	0	0	2	2	0	0	17	6	1	17	6	1
47896295	Digital_twin	201602	2	0	0	0	2	1	0	0	19	8	1	18	7	1
47896295	Digital_twin	201603	2	1	0	0	2	1	1	0	21	9	2	19	7	1
47896295	Digital_twin	201605	4	0	0	0	2	2	0	0	25	11	2	23	9	1
47896295	Digital_twin	201607	1	0	0	0	1	1	0	0	26	12	2	24	10	1
47896295	Digital_twin	201610	2	0	0	0	2	1	0	0	28	14	2	25	11	1
47896295	Digital_twin	201611	2	0	0	0	1	0	0	0	30	15	2	25	11	1
47896295	Digital_twin	201701	1	0	0	0	1	0	0	0	31	16	2	25	11	1
47896295	Digital_twin	201703	1	0	0	0	1	0	0	0	32	17	2	25	11	1
47896295	Digital_twin	201706	5	0	0	0	4	4	0	0	37	21	2	30	15	1
47896295	Digital_twin	201707	8	0	0	0	4	3	0	0	45	25	2	37	18	1
47896295	Digital_twin	201708	5	0	0	0	4	3	0	0	50	29	2	41	21	1
47896295	Digital_twin	201709	2	0	0	0	1	0	0	0	52	30	2	41	21	1
47896295	Digital_twin	201711	1	0	0	0	1	1	0	0	53	31	2	42	22	1
47896295	Digital_twin	201801	1	0	0	0	1	1	0	0	54	32	2	43	23	1
47896295	Digital_twin	201803	1	0	0	0	1	1	0	0	55	33	2	44	24	1
47896295	Digital_twin	201805	1	0	0	0	1	1	0	0	56	34	2	45	25	1
47896295	Digital_twin	201806	2	0	0	0	2	2	0	0	58	36	2	47	27	1
47896295	Digital_twin	201807	2	1	0	0	2	2	1	0	60	38	3	49	29	2
8501	Distributed_computing	200202	1	0	0	0	1	1	0	0	1	1	0	1	1	0
8501	Distributed_computing	200204	2	0	0	0	2	1	0	0	3	3	0	2	1	0
8501	Distributed_computing	200205	3	0	0	0	2	1	0	0	6	5	0	3	2	0
8501	Distributed_computing	200206	1	0	0	0	1	1	0	0	7	6	0	4	3	0
8501	Distributed_computing	200209	2	0	0	0	1	0	0	0	9	7	0	4	3	0
8501	Distributed_computing	200210	3	0	0	0	2	2	0	0	12	9	0	7	5	0
8501	Distributed_computing	200212	4	0	0	0	3	3	0	0	16	11	0	11	7	0
8501	Distributed_computing	200301	1	0	0	0	1	1	0	0	17	12	0	12	8	0
8501	Distributed_computing	200303	5	0	0	0	4	3	0	0	22	15	0	16	10	0
8501	Distributed_computing	200304	3	0	0	0	2	2	0	0	25	17	0	19	12	0
8501	Distributed_computing	200305	4	0	0	0	4	0	0	0	29	21	0	19	12	0
8501	Distributed_computing	200306	5	1	0	0	4	2	1	0	34	25	1	22	14	0
8501	Distributed_computing	200307	3	0	0	0	3	1	0	0	37	28	1	23	15	0
8501	Distributed_computing	200308	3	0	0	0	3	2	0	0	40	31	1	25	17	0
8501	Distributed_computing	200309	2	0	0	0	2	1	0	0	42	33	1	26	18	0
8501	Distributed_computing	200310	5	0	0	0	4	3	0	0	47	37	1	30	21	0
8501	Distributed_computing	200312	2	0	0	0	2	2	0	0	49	39	1	32	23	0
8501	Distributed_computing	200401	2	0	0	0	2	2	0	0	51	41	1	34	25	0
8501	Distributed_computing	200402	5	0	0	0	4	4	0	0	56	45	1	39	29	0
8501	Distributed_computing	200403	5	0	0	0	5	3	0	0	61	50	1	42	32	0
8501	Distributed_computing	200404	7	0	0	0	5	3	0	0	68	55	1	45	35	0
8501	Distributed_computing	200405	5	0	0	0	4	3	0	0	73	58	1	49	37	0
8501	Distributed_computing	200406	5	0	0	0	4	3	0	0	78	62	1	53	40	0
8501	Distributed_computing	200407	3	0	0	0	2	0	0	0	81	64	1	53	40	0
8501	Distributed_computing	200408	9	0	0	0	6	3	0	0	90	69	1	59	42	0
8501	Distributed_computing	200409	7	0	0	0	5	3	0	0	97	73	1	64	44	0
8501	Distributed_computing	200410	14	0	0	0	7	3	0	0	111	79	1	72	46	0
8501	Distributed_computing	200411	15	0	0	0	10	5	0	0	126	89	1	79	51	0
8501	Distributed_computing	200412	11	2	0	0	7	4	2	0	137	94	3	84	53	1
8501	Distributed_computing	200501	13	0	0	0	9	8	0	0	150	102	3	96	60	1
8501	Distributed_computing	200502	8	2	0	0	7	5	2	0	158	109	5	102	65	1
8501	Distributed_computing	200503	5	0	0	0	4	1	0	0	163	113	5	103	66	1
8501	Distributed_computing	200504	43	0	0	0	12	8	0	0	206	125	5	140	74	1
8501	Distributed_computing	200505	14	1	0	0	11	4	1	0	220	136	6	145	78	1
8501	Distributed_computing	200506	9	0	0	0	9	7	0	0	229	145	6	152	85	1
8501	Distributed_computing	200507	9	0	0	0	9	4	0	0	238	153	6	156	88	1
8501	Distributed_computing	200508	25	1	0	0	15	7	1	0	263	167	7	173	94	1
8501	Distributed_computing	200509	12	1	0	0	9	5	1	0	275	175	8	180	98	1
8501	Distributed_computing	200510	35	1	0	0	17	7	1	0	310	189	9	201	102	1
8501	Distributed_computing	200511	26	2	0	0	12	6	2	0	336	198	11	207	105	1
8501	Distributed_computing	200512	15	1	0	0	8	5	1	0	351	205	12	215	109	2
8501	Distributed_computing	200601	17	3	0	0	12	7	3	0	368	213	15	225	112	2
8501	Distributed_computing	200602	16	2	0	0	14	7	2	0	384	227	17	232	119	2
8501	Distributed_computing	200603	12	1	0	0	10	5	1	0	396	236	18	239	123	2
8501	Distributed_computing	200604	14	1	0	0	10	7	1	0	410	244	19	248	128	2
8501	Distributed_computing	200605	11	0	0	0	9	7	0	0	421	253	19	256	135	2
8501	Distributed_computing	200606	56	6	0	0	20	11	4	0	477	271	25	302	144	3
8501	Distributed_computing	200607	13	0	0	0	10	5	0	0	490	278	25	307	146	3
8501	Distributed_computing	200608	8	1	0	0	7	2	1	0	498	283	26	309	146	3
8501	Distributed_computing	200609	12	2	0	0	8	5	2	0	510	288	28	317	148	3
8501	Distributed_computing	200610	23	3	0	0	12	5	2	0	533	297	31	332	150	3
8501	Distributed_computing	200611	6	2	0	0	6	3	2	0	539	301	33	335	152	3
8501	Distributed_computing	200612	8	2	0	0	6	3	1	0	547	305	35	339	153	3
8501	Distributed_computing	200701	15	2	0	0	11	4	2	0	562	313	37	344	154	3
8501	Distributed_computing	200702	13	2	0	0	11	6	2	0	575	322	39	352	158	3
8501	Distributed_computing	200703	16	7	0	0	9	4	4	0	591	328	46	359	159	3
8501	Distributed_computing	200704	24	6	0	0	20	11	6	0	615	345	52	371	167	4
8501	Distributed_computing	200705	37	6	0	0	23	12	4	0	652	367	58	393	178	6
8501	Distributed_computing	200706	15	1	0	0	9	6	1	0	667	374	59	402	182	6
8501	Distributed_computing	200707	13	0	0	0	7	3	0	0	680	381	59	405	185	6
8501	Distributed_computing	200708	19	4	0	0	12	7	3	0	699	393	63	413	192	6
8501	Distributed_computing	200709	5	1	0	0	5	2	1	0	704	397	64	415	193	6
8501	Distributed_computing	200710	15	1	0	0	9	5	1	0	719	405	65	426	197	6
8501	Distributed_computing	200711	14	1	0	0	10	4	1	0	733	413	66	434	199	6
8501	Distributed_computing	200712	6	1	0	0	6	4	1	0	739	417	67	438	201	7
8501	Distributed_computing	200801	5	0	0	0	5	2	0	0	744	421	67	440	202	7
8501	Distributed_computing	200802	4	1	0	0	4	2	1	0	748	423	68	442	202	7
8501	Distributed_computing	200803	12	3	0	0	9	5	3	0	760	430	71	448	205	7
8501	Distributed_computing	200804	6	3	1	0	5	4	3	1	766	434	74	452	208	8
8501	Distributed_computing	200805	16	3	0	0	11	6	3	0	782	445	77	461	214	9
8501	Distributed_computing	200806	5	0	0	0	5	3	0	0	787	450	77	464	217	9
8501	Distributed_computing	200807	7	0	0	0	5	4	0	0	794	454	77	468	220	9
8501	Distributed_computing	200808	5	0	0	0	4	2	0	0	799	458	77	470	222	9
8501	Distributed_computing	200809	3	0	0	0	3	3	0	0	802	461	77	473	225	9
8501	Distributed_computing	200810	9	0	0	0	8	3	0	0	811	469	77	476	228	9
8501	Distributed_computing	200811	14	4	1	0	10	8	3	1	825	478	81	488	235	12
8501	Distributed_computing	200812	4	0	0	0	3	2	0	0	829	481	81	490	237	12
8501	Distributed_computing	200901	16	3	0	0	13	8	3	0	845	494	84	501	245	13
8501	Distributed_computing	200902	9	2	0	0	6	4	2	0	854	499	86	508	248	13
8501	Distributed_computing	200903	15	4	0	0	12	6	4	0	869	509	90	516	252	13
8501	Distributed_computing	200904	4	0	0	0	4	4	0	0	873	513	90	520	256	13
8501	Distributed_computing	200905	10	4	0	0	9	5	4	0	883	521	94	526	260	13
8501	Distributed_computing	200906	14	4	0	0	10	4	2	0	897	529	98	533	262	13
8501	Distributed_computing	200907	8	3	0	0	7	4	2	0	905	534	101	538	264	14
8501	Distributed_computing	200908	20	1	0	0	7	4	1	0	925	538	102	555	265	14
8501	Distributed_computing	200909	51	1	0	0	7	4	1	0	976	544	103	601	268	14
8501	Distributed_computing	200910	8	4	0	0	8	4	4	0	984	551	107	605	271	14
8501	Distributed_computing	200911	15	3	0	0	8	5	2	0	999	557	110	615	274	14
8501	Distributed_computing	200912	5	1	0	0	4	1	1	0	1004	561	111	616	275	14
8501	Distributed_computing	201001	5	0	0	0	4	3	0	0	1009	563	111	620	276	14
8501	Distributed_computing	201002	2	1	0	0	2	1	1	0	1011	564	112	621	276	14
8501	Distributed_computing	201003	3	1	0	0	3	2	1	0	1014	567	113	623	278	14
8501	Distributed_computing	201004	2	0	0	0	2	1	0	0	1016	569	113	624	279	14
8501	Distributed_computing	201005	5	1	0	0	4	4	1	0	1021	573	114	629	283	15
8501	Distributed_computing	201006	4	1	0	0	4	3	1	0	1025	576	115	632	285	15
8501	Distributed_computing	201007	5	1	0	0	4	3	1	0	1030	579	116	635	287	15
8501	Distributed_computing	201008	1	1	0	0	1	1	1	0	1031	580	117	636	288	16
8501	Distributed_computing	201009	12	2	0	0	11	6	2	0	1043	588	119	643	291	16
8501	Distributed_computing	201010	12	0	0	0	9	7	0	0	1055	595	119	652	296	16
8501	Distributed_computing	201101	5	1	0	0	5	3	1	0	1060	599	120	655	298	16
8501	Distributed_computing	201102	7	1	0	0	7	4	1	0	1067	605	121	659	301	16
8501	Distributed_computing	201103	9	2	0	0	7	4	2	0	1076	612	123	663	305	16
8501	Distributed_computing	201105	7	2	0	0	7	5	2	0	1083	617	125	668	308	17
8501	Distributed_computing	201106	1	0	0	0	1	1	0	0	1084	617	125	669	308	17
8501	Distributed_computing	201107	3	0	0	0	3	3	0	0	1087	618	125	672	309	17
8501	Distributed_computing	201108	5	1	0	0	5	3	1	0	1092	622	126	675	311	17
8501	Distributed_computing	201109	3	0	0	0	3	2	0	0	1095	625	126	677	313	17
8501	Distributed_computing	201110	1	0	0	0	1	0	0	0	1096	626	126	677	313	17
8501	Distributed_computing	201111	1	0	0	0	1	1	0	0	1097	627	126	678	314	17
8501	Distributed_computing	201112	4	2	0	0	4	1	2	0	1101	631	128	679	315	17
8501	Distributed_computing	201201	4	1	0	0	4	3	1	0	1105	634	129	682	317	17
8501	Distributed_computing	201202	2	0	0	0	1	0	0	0	1107	635	129	682	317	17
8501	Distributed_computing	201203	5	1	0	0	3	2	1	0	1112	638	130	686	319	18
8501	Distributed_computing	201204	3	0	0	0	3	2	0	0	1115	641	130	688	321	18
8501	Distributed_computing	201205	3	0	0	0	3	1	0	0	1118	643	130	689	321	18
8501	Distributed_computing	201206	9	2	0	0	7	6	2	0	1127	649	132	697	326	19
8501	Distributed_computing	201207	5	2	0	0	5	3	2	0	1132	652	134	700	327	19
8501	Distributed_computing	201208	8	0	0	0	8	5	0	0	1140	659	134	705	331	19
8501	Distributed_computing	201209	2	1	0	0	2	1	1	0	1142	661	135	706	332	19
8501	Distributed_computing	201210	6	2	0	0	6	4	2	0	1148	667	137	710	336	20
8501	Distributed_computing	201211	2	0	0	0	2	2	0	0	1150	669	137	712	338	20
8501	Distributed_computing	201212	11	3	0	0	8	6	3	0	1161	677	140	721	344	22
8501	Distributed_computing	201301	8	1	0	0	7	5	1	0	1169	682	141	727	347	22
8501	Distributed_computing	201302	3	0	0	0	3	2	0	0	1172	685	141	729	349	22
8501	Distributed_computing	201303	7	1	0	0	5	3	1	0	1179	690	142	732	352	22
8501	Distributed_computing	201304	5	0	0	0	5	4	0	0	1184	693	142	736	354	22
8501	Distributed_computing	201305	2	0	0	0	2	1	0	0	1186	695	142	737	355	22
8501	Distributed_computing	201306	4	0	0	0	3	1	0	0	1190	698	142	739	356	22
8501	Distributed_computing	201307	2	0	0	0	2	1	0	0	1192	699	142	740	356	22
8501	Distributed_computing	201308	3	0	0	0	2	1	0	0	1195	701	142	742	357	22
8501	Distributed_computing	201309	2	0	0	0	2	2	0	0	1197	703	142	744	359	22
8501	Distributed_computing	201310	2	1	0	0	2	1	1	0	1199	705	143	745	360	22
8501	Distributed_computing	201311	6	1	0	0	5	3	1	0	1205	710	144	749	363	22
8501	Distributed_computing	201312	2	0	0	0	1	1	0	0	1207	711	144	751	364	22
8501	Distributed_computing	201401	3	1	0	0	3	2	1	0	1210	713	145	753	365	22
8501	Distributed_computing	201402	2	1	0	0	2	2	1	0	1212	714	146	755	366	23
8501	Distributed_computing	201403	15	4	0	0	9	5	3	0	1227	723	150	763	371	23
8501	Distributed_computing	201404	4	2	0	0	4	2	2	0	1231	727	152	765	373	23
8501	Distributed_computing	201405	5	0	0	0	2	1	0	0	1236	729	152	766	374	23
8501	Distributed_computing	201406	2	0	0	0	1	1	0	0	1238	730	152	768	375	23
8501	Distributed_computing	201407	5	1	0	0	5	4	1	0	1243	735	153	772	379	24
8501	Distributed_computing	201408	4	1	0	0	4	3	1	0	1247	738	154	775	381	24
8501	Distributed_computing	201409	6	3	0	0	4	2	2	0	1253	742	157	778	383	24
8501	Distributed_computing	201410	5	0	0	0	5	3	0	0	1258	747	157	781	386	24
8501	Distributed_computing	201411	1	0	0	0	1	0	0	0	1259	748	157	781	386	24
8501	Distributed_computing	201412	2	0	0	0	1	1	0	0	1261	749	157	783	387	24
8501	Distributed_computing	201501	3	1	0	0	3	2	1	0	1264	752	158	785	389	24
8501	Distributed_computing	201502	1	0	0	0	1	1	0	0	1265	752	158	786	389	24
8501	Distributed_computing	201504	4	0	0	0	3	2	0	0	1269	755	158	788	391	24
8501	Distributed_computing	201505	2	0	0	0	2	1	0	0	1271	757	158	789	392	24
8501	Distributed_computing	201506	5	1	0	0	5	3	1	0	1276	760	159	792	393	24
8501	Distributed_computing	201507	3	0	0	0	3	2	0	0	1279	763	159	794	395	24
8501	Distributed_computing	201508	4	2	0	0	4	1	2	0	1283	767	161	795	396	24
8501	Distributed_computing	201510	5	1	0	0	5	4	1	0	1288	771	162	799	399	25
8501	Distributed_computing	201511	3	0	0	0	3	2	0	0	1291	773	162	801	400	25
8501	Distributed_computing	201512	10	1	0	0	5	3	1	0	1301	778	163	809	403	25
8501	Distributed_computing	201601	4	0	0	0	4	2	0	0	1305	781	163	811	404	25
8501	Distributed_computing	201602	6	1	0	0	6	5	1	0	1311	787	164	816	408	25
8501	Distributed_computing	201604	3	0	0	0	3	1	0	0	1314	789	164	817	408	25
8501	Distributed_computing	201605	4	1	0	0	3	1	1	0	1318	791	165	818	408	25
8501	Distributed_computing	201606	3	0	0	0	3	2	0	0	1321	794	165	820	410	25
8501	Distributed_computing	201607	8	0	0	0	7	5	0	0	1329	799	165	826	412	25
8501	Distributed_computing	201608	7	3	0	0	5	4	3	0	1336	803	168	832	415	27
8501	Distributed_computing	201609	4	2	0	0	4	3	2	0	1340	806	170	835	416	28
8501	Distributed_computing	201610	2	0	0	0	2	1	0	0	1342	808	170	836	417	28
8501	Distributed_computing	201611	19	1	0	0	7	4	1	0	1361	814	171	851	419	28
8501	Distributed_computing	201612	3	0	0	0	2	0	0	0	1364	816	171	851	419	28
8501	Distributed_computing	201701	3	0	0	0	3	3	0	0	1367	819	171	854	422	28
8501	Distributed_computing	201703	7	0	0	0	5	4	0	0	1374	824	171	860	426	28
8501	Distributed_computing	201705	7	2	0	0	5	5	1	0	1381	828	173	867	430	30
8501	Distributed_computing	201706	1	0	0	0	1	1	0	0	1382	829	173	868	431	30
8501	Distributed_computing	201707	14	1	0	0	3	2	1	0	1396	831	174	870	432	30
8501	Distributed_computing	201708	2	0	0	0	1	1	0	0	1398	832	174	872	433	30
8501	Distributed_computing	201709	6	3	0	0	5	3	3	0	1404	835	177	875	434	30
8501	Distributed_computing	201710	8	2	0	0	7	5	2	0	1412	840	179	880	437	30
8501	Distributed_computing	201711	2	0	0	0	2	2	0	0	1414	842	179	882	439	30
8501	Distributed_computing	201712	8	2	0	0	6	4	2	0	1422	846	181	887	441	30
8501	Distributed_computing	201801	1	0	0	0	1	0	0	0	1423	847	181	887	441	30
8501	Distributed_computing	201803	3	1	0	0	3	3	1	0	1426	850	182	890	443	31
8501	Distributed_computing	201804	1	0	0	0	1	1	0	0	1427	851	182	891	444	31
8501	Distributed_computing	201805	6	0	0	0	5	4	0	0	1433	856	182	896	448	31
8501	Distributed_computing	201806	4	1	0	0	4	3	1	0	1437	858	183	899	449	31
8501	Distributed_computing	201807	1	0	0	0	1	1	0	0	1438	859	183	900	450	31
50414407	Distributed_ledger	201608	4	0	0	0	4	4	0	0	4	4	0	4	4	0
50414407	Distributed_ledger	201609	10	0	0	0	3	2	0	0	14	7	0	13	6	0
50414407	Distributed_ledger	201611	3	0	0	0	2	2	0	0	17	9	0	16	8	0
50414407	Distributed_ledger	201612	6	1	0	0	3	3	1	0	23	11	1	22	10	1
50414407	Distributed_ledger	201701	2	0	0	0	1	1	0	0	25	11	1	24	10	1
50414407	Distributed_ledger	201706	1	0	0	0	1	1	0	0	26	12	1	25	11	1
50414407	Distributed_ledger	201707	1	0	0	0	1	1	0	0	27	13	1	26	12	1
50414407	Distributed_ledger	201708	2	0	0	0	2	1	0	0	29	15	1	27	13	1
50414407	Distributed_ledger	201709	1	0	0	0	1	1	0	0	30	16	1	28	14	1
50414407	Distributed_ledger	201710	6	1	0	0	5	2	1	0	36	21	2	30	16	2
50414407	Distributed_ledger	201711	11	0	0	0	7	6	0	0	47	28	2	40	21	2
50414407	Distributed_ledger	201712	8	1	0	0	6	5	1	0	55	34	3	46	26	2
50414407	Distributed_ledger	201801	5	1	0	0	5	2	1	0	60	38	4	48	27	2
50414407	Distributed_ledger	201802	3	1	0	0	3	2	1	0	63	40	5	50	27	2
50414407	Distributed_ledger	201803	6	1	0	0	4	4	1	0	69	44	6	56	31	3
50414407	Distributed_ledger	201804	13	0	0	0	5	4	0	0	82	47	6	67	33	3
50414407	Distributed_ledger	201806	16	4	0	0	12	9	4	0	98	58	10	77	40	5
50414407	Distributed_ledger	201807	2	0	0	0	2	2	0	0	100	59	10	79	41	5
40149201	Docker_(software)	201308	11	0	0	0	3	3	0	0	11	3	0	11	3	0
40149201	Docker_(software)	201309	12	1	0	0	10	10	1	0	23	11	1	23	11	1
40149201	Docker_(software)	201310	11	0	0	0	7	6	0	0	34	15	1	33	14	1
40149201	Docker_(software)	201311	7	0	0	0	6	5	0	0	41	20	1	39	18	1
40149201	Docker_(software)	201312	19	0	0	0	7	3	0	0	60	27	1	53	21	1
40149201	Docker_(software)	201401	2	0	0	0	2	2	0	0	62	28	1	55	22	1
40149201	Docker_(software)	201402	8	0	0	0	5	3	0	0	70	31	1	60	23	1
40149201	Docker_(software)	201403	6	0	0	0	4	4	0	0	76	33	1	66	25	1
40149201	Docker_(software)	201404	15	0	0	0	6	5	0	0	91	38	1	79	29	1
40149201	Docker_(software)	201405	4	0	0	0	3	2	0	0	95	39	1	82	29	1
40149201	Docker_(software)	201406	15	1	0	0	8	7	1	0	110	46	2	96	35	2
40149201	Docker_(software)	201407	13	0	0	0	9	5	0	0	123	54	2	105	39	2
40149201	Docker_(software)	201408	17	0	0	0	8	5	0	0	140	61	2	119	43	2
40149201	Docker_(software)	201409	11	1	0	0	6	5	1	0	151	66	3	129	47	2
40149201	Docker_(software)	201410	18	2	0	0	12	9	2	0	169	75	5	143	53	4
40149201	Docker_(software)	201411	12	0	0	0	5	4	0	0	181	78	5	151	55	4
40149201	Docker_(software)	201412	9	2	0	0	6	4	2	0	190	83	7	156	58	5
40149201	Docker_(software)	201501	3	1	0	0	3	2	1	0	193	85	8	158	59	5
40149201	Docker_(software)	201502	22	2	0	0	7	6	1	0	215	89	10	179	62	7
40149201	Docker_(software)	201503	2	0	0	0	1	1	0	0	217	90	10	181	63	7
40149201	Docker_(software)	201504	9	2	0	0	6	4	1	0	226	95	12	188	65	8
40149201	Docker_(software)	201505	25	1	0	0	16	8	1	0	251	109	13	205	71	9
40149201	Docker_(software)	201506	12	2	0	0	4	3	2	0	263	112	15	216	73	10
40149201	Docker_(software)	201507	20	0	0	0	8	5	0	0	283	119	15	228	77	10
40149201	Docker_(software)	201508	2	1	0	0	2	1	1	0	285	121	16	229	78	10
40149201	Docker_(software)	201509	22	6	3	2	11	10	3	2	307	130	22	249	85	15
40149201	Docker_(software)	201510	4	0	0	0	4	4	0	0	311	131	22	253	86	15
40149201	Docker_(software)	201511	13	0	0	0	6	4	0	0	324	135	22	263	87	15
40149201	Docker_(software)	201512	1	0	0	0	1	0	0	0	325	136	22	263	87	15
40149201	Docker_(software)	201601	7	0	0	0	5	3	0	0	332	140	22	267	89	15
40149201	Docker_(software)	201602	6	0	0	0	5	2	0	0	338	145	22	270	91	15
40149201	Docker_(software)	201603	11	0	0	0	9	7	0	0	349	153	22	278	97	15
40149201	Docker_(software)	201604	1	0	0	0	1	1	0	0	350	154	22	279	98	15
40149201	Docker_(software)	201605	5	0	0	0	5	3	0	0	355	159	22	282	101	15
40149201	Docker_(software)	201606	11	1	0	0	7	4	1	0	366	165	23	290	103	15
40149201	Docker_(software)	201607	5	0	0	0	5	2	0	0	371	170	23	292	105	15
40149201	Docker_(software)	201608	3	0	0	0	3	2	0	0	374	173	23	294	107	15
40149201	Docker_(software)	201609	21	2	0	0	15	9	1	0	395	185	25	308	113	15
40149201	Docker_(software)	201610	4	1	0	0	4	4	1	0	399	187	26	312	115	16
40149201	Docker_(software)	201611	7	1	0	0	6	6	1	0	406	192	27	319	120	17
40149201	Docker_(software)	201612	6	0	0	0	5	4	0	0	412	196	27	324	123	17
40149201	Docker_(software)	201701	11	0	0	0	9	7	0	0	423	205	27	331	130	17
40149201	Docker_(software)	201702	10	1	0	0	8	4	1	0	433	212	28	337	133	17
40149201	Docker_(software)	201703	4	0	0	0	4	2	0	0	437	215	28	339	134	17
40149201	Docker_(software)	201704	11	2	0	0	8	4	2	0	448	223	30	344	138	18
40149201	Docker_(software)	201705	11	0	0	0	7	4	0	0	459	229	30	350	141	18
40149201	Docker_(software)	201706	3	0	0	0	3	1	0	0	462	232	30	351	142	18
40149201	Docker_(software)	201707	19	0	0	0	12	10	0	0	481	241	30	367	149	18
40149201	Docker_(software)	201708	8	0	0	0	5	4	0	0	489	244	30	374	152	18
40149201	Docker_(software)	201709	12	1	0	0	9	7	1	0	501	252	31	384	158	18
40149201	Docker_(software)	201710	3	0	0	0	3	3	0	0	504	253	31	387	159	18
40149201	Docker_(software)	201711	3	0	0	0	3	3	0	0	507	255	31	390	161	18
40149201	Docker_(software)	201712	6	1	0	0	5	4	1	0	513	260	32	395	165	19
40149201	Docker_(software)	201801	5	1	0	0	5	3	1	0	518	265	33	398	167	19
40149201	Docker_(software)	201802	14	0	0	0	7	4	0	0	532	272	33	404	171	19
40149201	Docker_(software)	201803	10	1	0	0	5	4	1	0	542	276	34	413	174	20
40149201	Docker_(software)	201804	29	2	0	0	14	9	1	0	571	286	36	429	179	20
40149201	Docker_(software)	201805	2	0	0	0	2	2	0	0	573	288	36	431	181	20
40149201	Docker_(software)	201806	8	0	0	0	7	4	0	0	581	294	36	435	184	20
40149201	Docker_(software)	201807	13	2	0	0	6	6	1	0	594	299	38	448	188	22
8339	Domain_Name_System	200112	1	0	0	0	1	1	0	0	1	1	0	1	1	0
8339	Domain_Name_System	200202	4	0	0	0	2	2	0	0	5	3	0	5	3	0
8339	Domain_Name_System	200204	8	0	0	0	2	2	0	0	13	5	0	13	4	0
8339	Domain_Name_System	200209	2	0	0	0	2	1	0	0	15	7	0	14	5	0
8339	Domain_Name_System	200210	5	0	0	0	4	3	0	0	20	11	0	18	8	0
8339	Domain_Name_System	200211	5	0	0	0	3	3	0	0	25	14	0	23	11	0
8339	Domain_Name_System	200212	2	0	0	0	1	1	0	0	27	15	0	25	12	0
8339	Domain_Name_System	200301	1	0	0	0	1	1	0	0	28	16	0	26	13	0
8339	Domain_Name_System	200302	3	0	0	0	3	3	0	0	31	19	0	29	16	0
8339	Domain_Name_System	200303	4	0	0	0	4	4	0	0	35	23	0	33	20	0
8339	Domain_Name_System	200304	1	0	0	0	1	0	0	0	36	24	0	33	20	0
8339	Domain_Name_System	200305	1	0	0	0	1	0	0	0	37	25	0	33	20	0
8339	Domain_Name_System	200308	4	0	0	0	3	3	0	0	41	27	0	37	22	0
8339	Domain_Name_System	200309	7	0	0	0	5	4	0	0	48	31	0	41	25	0
8339	Domain_Name_System	200310	4	0	0	0	4	4	0	0	52	35	0	45	29	0
8339	Domain_Name_System	200311	4	1	0	0	3	1	1	0	56	36	1	46	29	0
8339	Domain_Name_System	200312	3	0	0	0	2	1	0	0	59	38	1	47	30	0
8339	Domain_Name_System	200401	9	1	0	0	7	3	1	0	68	45	2	52	33	0
8339	Domain_Name_System	200402	5	0	0	0	5	4	0	0	73	49	2	56	36	0
8339	Domain_Name_System	200403	15	0	0	0	4	3	0	0	88	51	2	67	37	0
8339	Domain_Name_System	200404	9	0	0	0	6	6	0	0	97	55	2	76	41	0
8339	Domain_Name_System	200405	18	1	0	0	15	7	1	0	115	69	3	85	47	0
8339	Domain_Name_System	200406	12	0	0	0	6	3	0	0	127	74	3	94	49	0
8339	Domain_Name_System	200407	19	0	0	0	11	8	0	0	146	82	3	105	54	0
8339	Domain_Name_System	200408	10	1	0	0	9	6	1	0	156	89	4	111	58	0
8339	Domain_Name_System	200409	8	0	0	0	6	4	0	0	164	94	4	116	61	0
8339	Domain_Name_System	200410	6	0	0	0	4	1	0	0	170	98	4	118	62	0
8339	Domain_Name_System	200411	18	2	0	0	13	9	2	0	188	110	6	130	70	1
8339	Domain_Name_System	200412	33	1	0	0	13	9	1	0	221	120	7	158	77	1
8339	Domain_Name_System	200501	24	1	0	0	19	11	1	0	245	134	8	172	83	1
8339	Domain_Name_System	200502	10	1	0	0	6	2	1	0	255	138	9	175	83	1
8339	Domain_Name_System	200503	10	3	0	0	9	3	2	0	265	146	12	179	85	2
8339	Domain_Name_System	200504	16	2	0	0	13	8	2	0	281	155	14	188	90	2
8339	Domain_Name_System	200505	26	0	0	0	18	10	0	0	307	173	14	202	100	2
8339	Domain_Name_System	200506	36	5	0	0	22	11	4	0	343	191	19	218	108	2
8339	Domain_Name_System	200507	26	5	0	0	21	9	5	0	369	210	24	231	116	3
8339	Domain_Name_System	200508	27	2	0	0	20	6	2	0	396	228	26	240	122	4
8339	Domain_Name_System	200509	28	6	0	0	22	10	5	0	424	244	32	254	127	5
8339	Domain_Name_System	200510	20	3	0	0	18	10	2	0	444	260	35	265	135	5
8339	Domain_Name_System	200511	48	11	0	0	30	13	8	0	492	284	46	291	142	5
8339	Domain_Name_System	200512	46	12	0	0	30	14	10	0	538	310	58	314	152	7
8339	Domain_Name_System	200601	37	6	0	0	29	19	5	0	575	337	64	336	169	9
8339	Domain_Name_System	200602	39	5	2	1	32	10	4	2	614	367	69	347	177	9
8339	Domain_Name_System	200603	43	9	0	0	33	15	8	0	657	396	78	365	188	9
8339	Domain_Name_System	200604	49	7	0	0	35	14	6	0	706	427	85	382	198	10
8339	Domain_Name_System	200605	29	4	0	0	22	11	3	0	735	447	89	394	207	10
8339	Domain_Name_System	200606	57	11	0	0	43	14	9	0	792	489	100	411	220	11
8339	Domain_Name_System	200607	59	9	0	0	43	23	9	0	851	528	109	442	239	12
8339	Domain_Name_System	200608	69	10	0	0	48	24	10	0	920	573	119	478	260	14
8339	Domain_Name_System	200609	30	9	0	0	23	9	3	0	950	593	128	494	266	15
8339	Domain_Name_System	200610	74	21	0	0	49	22	16	0	1024	636	149	526	282	15
8339	Domain_Name_System	200611	47	14	0	0	35	15	9	0	1071	665	163	548	291	17
8339	Domain_Name_System	200612	36	5	0	0	25	15	4	0	1107	682	168	573	298	18
8339	Domain_Name_System	200701	62	17	1	0	40	18	10	1	1169	716	185	603	310	20
8339	Domain_Name_System	200702	69	23	1	0	44	17	11	1	1238	753	208	635	321	23
8339	Domain_Name_System	200703	41	10	0	0	30	16	7	0	1279	778	218	656	332	24
8339	Domain_Name_System	200704	49	10	0	0	34	16	5	0	1328	808	228	684	344	24
8339	Domain_Name_System	200705	108	28	0	0	55	23	17	0	1436	854	256	721	358	25
8339	Domain_Name_System	200706	42	8	0	0	31	16	8	0	1478	879	264	738	368	25
8339	Domain_Name_System	200707	41	10	0	0	30	16	9	0	1519	907	274	759	382	26
8339	Domain_Name_System	200708	53	9	0	0	36	12	7	0	1572	937	283	783	388	27
8339	Domain_Name_System	200709	40	11	2	1	29	17	10	2	1612	961	294	804	400	30
8339	Domain_Name_System	200710	36	6	0	0	30	16	6	0	1648	986	300	823	411	30
8339	Domain_Name_System	200711	69	20	0	0	38	16	9	0	1717	1017	320	860	420	34
8339	Domain_Name_System	200712	55	18	0	0	37	19	14	0	1772	1049	338	889	434	37
8339	Domain_Name_System	200801	38	8	0	0	18	7	5	0	1810	1064	346	914	438	38
8339	Domain_Name_System	200802	69	19	0	0	41	19	15	0	1879	1096	365	939	448	39
8339	Domain_Name_System	200803	93	28	3	2	42	22	15	2	1972	1129	393	995	462	46
8339	Domain_Name_System	200804	71	23	0	0	48	20	12	0	2043	1167	416	1035	472	50
8339	Domain_Name_System	200805	70	24	0	0	44	16	12	0	2113	1202	440	1069	479	51
8339	Domain_Name_System	200806	54	9	0	0	26	14	6	0	2167	1223	449	1109	488	53
8339	Domain_Name_System	200807	48	15	0	0	29	12	9	0	2215	1246	464	1133	494	54
8339	Domain_Name_System	200808	68	18	0	0	42	22	13	0	2283	1281	482	1169	510	57
8339	Domain_Name_System	200809	45	18	2	1	31	17	10	2	2328	1306	500	1194	521	62
8339	Domain_Name_System	200810	61	15	0	0	35	20	13	0	2389	1333	515	1233	533	65
8339	Domain_Name_System	200811	40	16	0	0	31	16	13	0	2429	1358	531	1252	543	66
8339	Domain_Name_System	200812	32	8	1	0	22	12	7	1	2461	1375	539	1269	550	67
8339	Domain_Name_System	200901	24	6	0	0	13	6	5	0	2485	1384	545	1285	552	68
8339	Domain_Name_System	200902	50	15	0	0	37	17	11	0	2535	1413	560	1310	561	68
8339	Domain_Name_System	200903	26	8	0	0	18	8	4	0	2561	1427	568	1322	565	69
8339	Domain_Name_System	200904	36	13	0	0	23	13	8	0	2597	1445	581	1342	573	72
8339	Domain_Name_System	200905	33	9	0	0	19	8	6	0	2630	1460	590	1357	577	72
8339	Domain_Name_System	200906	8	2	0	0	7	4	2	0	2638	1466	592	1362	580	72
8339	Domain_Name_System	200907	9	4	0	0	9	5	4	0	2647	1473	596	1367	583	72
8339	Domain_Name_System	200908	46	10	0	0	25	12	9	0	2693	1492	606	1389	589	74
8339	Domain_Name_System	200909	20	2	0	0	12	7	2	0	2713	1501	608	1398	593	75
8339	Domain_Name_System	200910	29	5	0	0	21	9	5	0	2742	1517	613	1411	598	75
8339	Domain_Name_System	200911	18	6	0	0	12	8	5	0	2760	1526	619	1424	603	78
8339	Domain_Name_System	200912	22	5	0	0	19	10	5	0	2782	1543	624	1437	611	79
8339	Domain_Name_System	201001	29	12	0	0	19	7	9	0	2811	1558	636	1447	614	80
8339	Domain_Name_System	201002	53	12	2	1	28	14	9	2	2864	1579	648	1483	621	84
8339	Domain_Name_System	201003	36	12	0	0	22	9	7	0	2900	1598	660	1500	627	85
8339	Domain_Name_System	201004	38	15	1	0	25	12	9	1	2938	1618	675	1519	634	89
8339	Domain_Name_System	201005	34	10	0	0	25	12	7	0	2972	1637	685	1537	640	89
8339	Domain_Name_System	201006	18	4	0	0	15	6	3	0	2990	1650	689	1544	644	89
8339	Domain_Name_System	201007	21	5	0	0	17	9	5	0	3011	1662	694	1553	648	90
8339	Domain_Name_System	201008	30	8	1	0	22	13	8	1	3041	1679	702	1570	656	91
8339	Domain_Name_System	201009	27	6	0	0	19	11	4	0	3068	1693	708	1583	662	92
8339	Domain_Name_System	201010	37	7	0	0	23	12	6	0	3105	1711	715	1602	669	92
8339	Domain_Name_System	201011	40	13	0	0	31	14	11	0	3145	1735	728	1620	676	93
8339	Domain_Name_System	201012	31	9	0	0	21	9	6	0	3176	1751	737	1635	680	93
8339	Domain_Name_System	201101	18	3	0	0	14	9	3	0	3194	1760	740	1647	684	94
8339	Domain_Name_System	201102	35	6	0	0	22	11	5	0	3229	1776	746	1659	690	94
8339	Domain_Name_System	201103	15	5	0	0	14	5	5	0	3244	1786	751	1664	691	94
8339	Domain_Name_System	201104	26	9	0	0	18	7	6	0	3270	1799	760	1674	693	94
8339	Domain_Name_System	201105	15	3	0	0	12	9	3	0	3285	1809	763	1685	700	95
8339	Domain_Name_System	201106	32	8	0	0	22	8	6	0	3317	1825	771	1699	702	95
8339	Domain_Name_System	201107	19	5	0	0	16	7	5	0	3336	1838	776	1707	706	96
8339	Domain_Name_System	201108	18	7	0	0	16	9	6	0	3354	1849	783	1717	710	96
8339	Domain_Name_System	201109	26	10	0	0	24	10	9	0	3380	1868	793	1728	715	97
8339	Domain_Name_System	201110	48	18	0	0	28	14	9	0	3428	1891	811	1753	724	100
8339	Domain_Name_System	201111	31	7	0	0	19	10	5	0	3459	1904	818	1772	728	102
8339	Domain_Name_System	201112	14	3	0	0	10	4	3	0	3473	1913	821	1778	731	102
8339	Domain_Name_System	201201	11	5	0	0	9	4	3	0	3484	1919	826	1784	732	103
8339	Domain_Name_System	201202	17	4	0	0	15	5	4	0	3501	1931	830	1789	734	104
8339	Domain_Name_System	201203	14	5	0	0	10	4	3	0	3515	1939	835	1796	736	104
8339	Domain_Name_System	201204	14	4	0	0	12	7	3	0	3529	1947	839	1805	740	104
8339	Domain_Name_System	201205	28	9	0	0	17	7	4	0	3557	1961	848	1818	744	104
8339	Domain_Name_System	201206	12	1	0	0	9	4	1	0	3569	1969	849	1823	747	104
8339	Domain_Name_System	201207	20	7	0	0	16	10	4	0	3589	1981	856	1837	754	106
8339	Domain_Name_System	201208	22	7	0	0	16	7	4	0	3611	1992	863	1847	756	107
8339	Domain_Name_System	201209	16	3	0	0	12	5	2	0	3627	2002	866	1855	759	109
8339	Domain_Name_System	201210	14	6	0	0	12	7	5	0	3641	2010	872	1863	762	109
8339	Domain_Name_System	201211	8	3	0	0	6	3	3	0	3649	2013	875	1866	762	109
8339	Domain_Name_System	201212	17	4	0	0	8	4	3	0	3666	2020	879	1874	765	109
8339	Domain_Name_System	201301	13	3	0	0	12	8	2	0	3679	2030	882	1883	770	109
8339	Domain_Name_System	201302	30	17	9	7	14	7	7	3	3709	2039	899	1899	772	114
8339	Domain_Name_System	201303	34	8	0	0	25	15	8	0	3743	2060	907	1921	783	119
8339	Domain_Name_System	201304	29	5	0	0	10	4	3	0	3772	2070	912	1943	787	120
8339	Domain_Name_System	201305	34	7	0	0	17	11	5	0	3806	2081	919	1967	792	123
8339	Domain_Name_System	201306	32	12	0	0	24	13	7	0	3838	2098	931	1987	798	126
8339	Domain_Name_System	201307	22	6	0	0	17	8	3	0	3860	2112	937	1999	803	127
8339	Domain_Name_System	201308	17	2	0	0	10	8	2	0	3877	2121	939	2014	810	127
8339	Domain_Name_System	201309	9	2	0	0	9	4	2	0	3886	2127	941	2018	811	127
8339	Domain_Name_System	201310	7	1	0	0	5	2	1	0	3893	2131	942	2022	812	127
8339	Domain_Name_System	201311	17	10	4	3	11	5	7	2	3910	2139	952	2029	813	130
8339	Domain_Name_System	201312	22	7	0	0	17	9	5	0	3932	2151	959	2040	817	131
8339	Domain_Name_System	201401	12	3	0	0	10	3	3	0	3944	2159	962	2043	818	131
8339	Domain_Name_System	201402	10	2	0	0	7	2	2	0	3954	2165	964	2046	819	131
8339	Domain_Name_System	201403	12	2	0	0	8	6	2	0	3966	2171	966	2056	823	132
8339	Domain_Name_System	201404	12	2	0	0	8	3	2	0	3978	2177	968	2059	824	132
8339	Domain_Name_System	201405	12	2	0	0	10	7	2	0	3990	2186	970	2067	829	132
8339	Domain_Name_System	201406	16	3	0	0	14	9	3	0	4006	2198	973	2078	836	132
8339	Domain_Name_System	201407	8	1	0	0	5	1	1	0	4014	2202	974	2079	836	132
8339	Domain_Name_System	201408	11	1	0	0	5	2	1	0	4025	2205	975	2085	836	132
8339	Domain_Name_System	201409	10	3	0	0	9	5	3	0	4035	2212	978	2090	839	132
8339	Domain_Name_System	201410	18	6	0	0	13	9	4	0	4053	2221	984	2104	844	134
8339	Domain_Name_System	201411	26	7	1	0	16	8	7	1	4079	2232	991	2118	847	135
8339	Domain_Name_System	201412	43	16	3	0	19	8	8	2	4122	2245	1007	2134	849	137
8339	Domain_Name_System	201501	11	3	0	0	6	3	2	0	4133	2249	1010	2138	850	137
8339	Domain_Name_System	201502	11	3	0	0	9	5	2	0	4144	2254	1013	2144	851	137
8339	Domain_Name_System	201503	12	3	0	0	10	3	2	0	4156	2262	1016	2148	852	138
8339	Domain_Name_System	201504	15	5	0	0	12	9	4	0	4171	2271	1021	2160	858	141
8339	Domain_Name_System	201505	11	3	0	0	6	2	1	0	4182	2276	1024	2164	859	141
8339	Domain_Name_System	201506	11	3	0	0	10	6	3	0	4193	2285	1027	2170	864	142
8339	Domain_Name_System	201507	10	3	0	0	9	5	3	0	4203	2292	1030	2175	867	143
8339	Domain_Name_System	201508	27	9	0	0	10	6	4	0	4230	2301	1039	2198	872	149
8339	Domain_Name_System	201509	19	7	0	0	12	8	5	0	4249	2309	1046	2209	876	152
8339	Domain_Name_System	201510	14	6	0	0	10	3	3	0	4263	2317	1052	2215	877	152
8339	Domain_Name_System	201511	18	5	0	0	9	4	3	0	4281	2323	1057	2221	878	152
8339	Domain_Name_System	201512	27	5	0	0	16	8	4	0	4308	2335	1062	2231	881	153
8339	Domain_Name_System	201601	24	2	0	0	11	6	2	0	4332	2344	1064	2250	883	155
8339	Domain_Name_System	201602	11	4	0	0	9	5	3	0	4343	2350	1068	2257	885	156
8339	Domain_Name_System	201603	28	7	0	0	19	12	6	0	4371	2366	1075	2272	893	157
8339	Domain_Name_System	201604	4	1	0	0	4	3	1	0	4375	2368	1076	2275	894	157
8339	Domain_Name_System	201605	14	7	0	0	10	6	3	0	4389	2375	1083	2285	896	160
8339	Domain_Name_System	201606	17	6	0	0	13	7	6	0	4406	2384	1089	2293	899	161
8339	Domain_Name_System	201607	14	4	0	0	11	5	4	0	4420	2392	1093	2299	901	161
8339	Domain_Name_System	201608	7	3	0	0	5	3	2	0	4427	2395	1096	2304	902	162
8339	Domain_Name_System	201609	26	6	0	0	15	8	5	0	4453	2405	1102	2318	904	163
8339	Domain_Name_System	201610	4	2	0	0	4	3	2	0	4457	2407	1104	2321	904	164
8339	Domain_Name_System	201611	36	9	0	0	20	13	4	0	4493	2421	1113	2347	909	167
8339	Domain_Name_System	201612	38	16	2	1	23	14	10	2	4531	2439	1129	2368	915	173
8339	Domain_Name_System	201701	23	5	0	0	15	11	4	0	4554	2452	1134	2386	922	175
8339	Domain_Name_System	201702	17	7	0	0	13	5	5	0	4571	2462	1141	2393	924	175
8339	Domain_Name_System	201703	27	7	0	0	20	14	6	0	4598	2476	1148	2412	930	177
8339	Domain_Name_System	201704	25	11	1	0	20	13	9	1	4623	2492	1159	2430	938	184
8339	Domain_Name_System	201705	24	13	3	2	12	9	8	2	4647	2498	1172	2450	940	194
8339	Domain_Name_System	201706	3	0	0	0	2	0	0	0	4650	2500	1172	2450	940	194
8339	Domain_Name_System	201707	23	9	0	0	16	7	3	0	4673	2514	1181	2463	944	196
8339	Domain_Name_System	201708	19	8	0	0	13	8	4	0	4692	2523	1189	2476	945	199
8339	Domain_Name_System	201709	20	3	0	0	8	6	2	0	4712	2528	1192	2494	947	200
8339	Domain_Name_System	201710	16	5	0	0	13	5	4	0	4728	2539	1197	2500	950	200
8339	Domain_Name_System	201711	14	6	0	0	14	9	6	0	4742	2552	1203	2509	958	202
8339	Domain_Name_System	201712	21	4	0	0	13	7	4	0	4763	2560	1207	2517	959	203
8339	Domain_Name_System	201801	9	3	0	0	8	5	3	0	4772	2563	1210	2523	959	203
8339	Domain_Name_System	201802	18	7	0	0	16	11	6	0	4790	2572	1217	2535	963	205
8339	Domain_Name_System	201803	14	5	0	0	10	7	4	0	4804	2579	1222	2546	967	207
8339	Domain_Name_System	201804	24	5	0	0	12	8	3	0	4828	2586	1227	2565	970	210
8339	Domain_Name_System	201805	28	10	0	0	20	15	7	0	4856	2601	1237	2588	977	216
8339	Domain_Name_System	201806	18	6	0	0	17	10	6	0	4874	2614	1243	2599	981	218
8339	Domain_Name_System	201807	19	3	0	0	15	6	3	0	4893	2627	1246	2606	985	218
337389	Domain_Name_System_Security_Extensions	200311	16	0	0	0	2	1	0	0	16	2	0	1	1	0
337389	Domain_Name_System_Security_Extensions	200402	1	0	0	0	1	0	0	0	17	2	0	1	1	0
337389	Domain_Name_System_Security_Extensions	200403	1	0	0	0	1	1	0	0	18	3	0	2	2	0
337389	Domain_Name_System_Security_Extensions	200407	1	0	0	0	1	1	0	0	19	4	0	3	3	0
337389	Domain_Name_System_Security_Extensions	200410	1	0	0	0	1	1	0	0	20	5	0	4	4	0
337389	Domain_Name_System_Security_Extensions	200503	9	0	0	0	3	2	0	0	29	7	0	6	6	0
337389	Domain_Name_System_Security_Extensions	200504	5	0	0	0	3	0	0	0	34	10	0	6	6	0
337389	Domain_Name_System_Security_Extensions	200507	2	0	0	0	2	2	0	0	36	12	0	8	8	0
337389	Domain_Name_System_Security_Extensions	200509	1	0	0	0	1	1	0	0	37	13	0	9	9	0
337389	Domain_Name_System_Security_Extensions	200511	2	0	0	0	1	0	0	0	39	14	0	9	9	0
337389	Domain_Name_System_Security_Extensions	200512	1	0	0	0	1	0	0	0	40	15	0	9	9	0
337389	Domain_Name_System_Security_Extensions	200601	1	0	0	0	1	1	0	0	41	16	0	10	10	0
337389	Domain_Name_System_Security_Extensions	200602	5	0	0	0	4	3	0	0	46	20	0	14	13	0
337389	Domain_Name_System_Security_Extensions	200603	3	1	0	0	3	1	1	0	49	22	1	15	13	0
337389	Domain_Name_System_Security_Extensions	200604	1	0	0	0	1	1	0	0	50	23	1	16	14	0
337389	Domain_Name_System_Security_Extensions	200606	1	0	0	0	1	1	0	0	51	24	1	17	15	0
337389	Domain_Name_System_Security_Extensions	200607	83	0	0	0	3	2	0	0	134	27	1	98	17	0
337389	Domain_Name_System_Security_Extensions	200608	6	0	0	0	2	1	0	0	140	29	1	103	18	0
337389	Domain_Name_System_Security_Extensions	200609	8	1	0	0	5	2	1	0	148	34	2	107	20	0
337389	Domain_Name_System_Security_Extensions	200610	2	0	0	0	2	1	0	0	150	35	2	108	20	0
337389	Domain_Name_System_Security_Extensions	200611	3	0	0	0	1	1	0	0	153	36	2	111	21	0
337389	Domain_Name_System_Security_Extensions	200612	2	0	0	0	2	1	0	0	155	38	2	112	22	0
337389	Domain_Name_System_Security_Extensions	200701	4	0	0	0	4	2	0	0	159	42	2	114	24	0
337389	Domain_Name_System_Security_Extensions	200702	2	0	0	0	2	2	0	0	161	42	2	116	24	0
337389	Domain_Name_System_Security_Extensions	200703	4	0	0	0	2	1	0	0	165	44	2	117	25	0
337389	Domain_Name_System_Security_Extensions	200704	7	0	0	0	5	3	0	0	172	49	2	120	28	0
337389	Domain_Name_System_Security_Extensions	200705	10	0	0	0	5	2	0	0	182	52	2	126	29	0
337389	Domain_Name_System_Security_Extensions	200706	2	0	0	0	2	1	0	0	184	54	2	127	30	0
337389	Domain_Name_System_Security_Extensions	200707	7	1	0	0	5	3	1	0	191	59	3	132	33	0
337389	Domain_Name_System_Security_Extensions	200708	1	0	0	0	1	0	0	0	192	60	3	132	33	0
337389	Domain_Name_System_Security_Extensions	200709	1	0	0	0	1	0	0	0	193	61	3	132	33	0
337389	Domain_Name_System_Security_Extensions	200710	1	0	0	0	1	0	0	0	194	62	3	132	33	0
337389	Domain_Name_System_Security_Extensions	200712	1	0	0	0	1	1	0	0	195	62	3	133	33	0
337389	Domain_Name_System_Security_Extensions	200802	1	0	0	0	1	1	0	0	196	63	3	134	34	0
337389	Domain_Name_System_Security_Extensions	200803	3	0	0	0	3	1	0	0	199	66	3	135	35	0
337389	Domain_Name_System_Security_Extensions	200804	4	0	0	0	2	1	0	0	203	67	3	138	35	0
337389	Domain_Name_System_Security_Extensions	200805	2	0	0	0	1	1	0	0	205	67	3	140	35	0
337389	Domain_Name_System_Security_Extensions	200806	8	0	0	0	3	2	0	0	213	69	3	147	36	0
337389	Domain_Name_System_Security_Extensions	200807	5	0	0	0	4	2	0	0	218	73	3	150	38	0
337389	Domain_Name_System_Security_Extensions	200808	19	0	0	0	11	3	0	0	237	83	3	154	41	0
337389	Domain_Name_System_Security_Extensions	200809	3	0	0	0	3	2	0	0	240	85	3	156	42	0
337389	Domain_Name_System_Security_Extensions	200810	14	1	0	0	10	5	1	0	254	92	4	162	44	0
337389	Domain_Name_System_Security_Extensions	200811	7	0	0	0	6	4	0	0	261	97	4	167	47	0
337389	Domain_Name_System_Security_Extensions	200812	5	0	0	0	4	3	0	0	266	101	4	171	50	0
337389	Domain_Name_System_Security_Extensions	200902	9	0	0	0	7	6	0	0	275	107	4	179	55	0
337389	Domain_Name_System_Security_Extensions	200903	3	0	0	0	2	1	0	0	278	108	4	181	55	0
337389	Domain_Name_System_Security_Extensions	200904	19	0	0	0	7	4	0	0	297	114	4	197	58	0
337389	Domain_Name_System_Security_Extensions	200905	2	1	0	0	2	1	1	0	299	115	5	198	58	0
337389	Domain_Name_System_Security_Extensions	200906	8	0	0	0	5	5	0	0	307	120	5	206	63	0
337389	Domain_Name_System_Security_Extensions	200907	23	1	0	0	11	9	1	0	330	130	6	227	71	0
337389	Domain_Name_System_Security_Extensions	200908	7	1	0	0	7	5	1	0	337	136	7	232	75	0
337389	Domain_Name_System_Security_Extensions	200909	4	0	0	0	4	2	0	0	341	139	7	234	76	0
337389	Domain_Name_System_Security_Extensions	200910	2	0	0	0	1	0	0	0	343	140	7	234	76	0
337389	Domain_Name_System_Security_Extensions	200911	3	0	0	0	3	1	0	0	346	143	7	235	77	0
337389	Domain_Name_System_Security_Extensions	200912	13	0	0	0	6	4	0	0	359	148	7	246	80	0
337389	Domain_Name_System_Security_Extensions	201001	5	0	0	0	5	4	0	0	364	152	7	250	83	0
337389	Domain_Name_System_Security_Extensions	201002	7	1	0	0	6	6	1	0	371	156	8	257	87	1
337389	Domain_Name_System_Security_Extensions	201003	4	1	0	0	4	1	1	0	375	160	9	258	88	2
337389	Domain_Name_System_Security_Extensions	201004	18	1	0	0	7	6	1	0	393	166	10	275	93	3
337389	Domain_Name_System_Security_Extensions	201005	7	0	0	0	4	2	0	0	400	168	10	280	93	3
337389	Domain_Name_System_Security_Extensions	201006	7	0	0	0	5	5	0	0	407	172	10	287	97	3
337389	Domain_Name_System_Security_Extensions	201007	9	0	0	0	3	1	0	0	416	174	10	288	98	3
337389	Domain_Name_System_Security_Extensions	201008	19	0	0	0	12	5	0	0	435	184	10	299	101	3
337389	Domain_Name_System_Security_Extensions	201009	7	0	0	0	7	4	0	0	442	188	10	303	102	3
337389	Domain_Name_System_Security_Extensions	201010	4	1	0	0	4	3	1	0	446	191	11	306	104	4
337389	Domain_Name_System_Security_Extensions	201011	1	0	0	0	1	1	0	0	447	192	11	307	105	4
337389	Domain_Name_System_Security_Extensions	201012	1	0	0	0	1	0	0	0	448	193	11	307	105	4
337389	Domain_Name_System_Security_Extensions	201101	15	0	0	0	9	7	0	0	463	200	11	320	110	4
337389	Domain_Name_System_Security_Extensions	201102	8	1	0	0	6	3	1	0	471	206	12	323	113	4
337389	Domain_Name_System_Security_Extensions	201103	3	1	0	0	3	2	1	0	474	208	13	325	114	4
337389	Domain_Name_System_Security_Extensions	201104	7	0	0	0	6	2	0	0	481	214	13	328	116	4
337389	Domain_Name_System_Security_Extensions	201105	3	0	0	0	3	2	0	0	484	216	13	330	117	4
337389	Domain_Name_System_Security_Extensions	201106	14	1	0	0	8	4	1	0	498	222	14	339	119	4
337389	Domain_Name_System_Security_Extensions	201107	8	0	0	0	4	3	0	0	506	226	14	346	122	4
337389	Domain_Name_System_Security_Extensions	201108	1	0	0	0	1	1	0	0	507	227	14	347	123	4
337389	Domain_Name_System_Security_Extensions	201109	1	0	0	0	1	1	0	0	508	227	14	348	123	4
337389	Domain_Name_System_Security_Extensions	201111	8	0	0	0	6	3	0	0	516	233	14	351	126	4
337389	Domain_Name_System_Security_Extensions	201112	10	0	0	0	4	4	0	0	526	237	14	361	130	4
337389	Domain_Name_System_Security_Extensions	201201	19	0	0	0	6	6	0	0	545	241	14	380	134	4
337389	Domain_Name_System_Security_Extensions	201202	4	0	0	0	3	2	0	0	549	244	14	383	136	4
337389	Domain_Name_System_Security_Extensions	201205	2	0	0	0	2	1	0	0	551	246	14	384	137	4
337389	Domain_Name_System_Security_Extensions	201206	2	0	0	0	2	2	0	0	553	248	14	386	139	4
337389	Domain_Name_System_Security_Extensions	201208	3	0	0	0	3	2	0	0	556	251	14	388	141	4
337389	Domain_Name_System_Security_Extensions	201209	7	2	0	0	5	3	2	0	563	255	16	391	143	4
337389	Domain_Name_System_Security_Extensions	201210	3	0	0	0	2	2	0	0	566	257	16	394	145	4
337389	Domain_Name_System_Security_Extensions	201212	2	0	0	0	2	1	0	0	568	259	16	395	146	4
337389	Domain_Name_System_Security_Extensions	201301	2	0	0	0	2	2	0	0	570	261	16	397	148	4
337389	Domain_Name_System_Security_Extensions	201302	4	0	0	0	3	3	0	0	574	263	16	401	150	4
337389	Domain_Name_System_Security_Extensions	201303	9	0	0	0	8	7	0	0	583	270	16	408	156	4
337389	Domain_Name_System_Security_Extensions	201304	6	1	0	0	3	2	1	0	589	272	17	413	157	4
337389	Domain_Name_System_Security_Extensions	201305	2	0	0	0	2	2	0	0	591	274	17	415	159	4
337389	Domain_Name_System_Security_Extensions	201306	5	0	0	0	5	5	0	0	596	278	17	420	163	4
337389	Domain_Name_System_Security_Extensions	201307	10	0	0	0	3	2	0	0	606	279	17	429	163	4
337389	Domain_Name_System_Security_Extensions	201308	5	1	0	0	4	3	1	0	611	282	18	433	165	4
337389	Domain_Name_System_Security_Extensions	201309	1	0	0	0	1	0	0	0	612	283	18	433	165	4
337389	Domain_Name_System_Security_Extensions	201310	2	0	0	0	2	2	0	0	614	285	18	435	167	4
337389	Domain_Name_System_Security_Extensions	201312	7	0	0	0	5	5	0	0	621	289	18	442	169	4
337389	Domain_Name_System_Security_Extensions	201401	5	1	0	0	4	3	1	0	626	292	19	446	170	4
337389	Domain_Name_System_Security_Extensions	201402	4	0	0	0	3	1	0	0	630	295	19	447	171	4
337389	Domain_Name_System_Security_Extensions	201403	2	1	0	0	2	1	1	0	632	296	20	448	171	4
337389	Domain_Name_System_Security_Extensions	201404	3	0	0	0	3	2	0	0	635	298	20	450	172	4
337389	Domain_Name_System_Security_Extensions	201405	1	0	0	0	1	1	0	0	636	299	20	451	173	4
337389	Domain_Name_System_Security_Extensions	201407	4	0	0	0	4	2	0	0	640	303	20	453	175	4
337389	Domain_Name_System_Security_Extensions	201408	1	0	0	0	1	1	0	0	641	303	20	454	175	4
337389	Domain_Name_System_Security_Extensions	201409	1	0	0	0	1	0	0	0	642	304	20	454	175	4
337389	Domain_Name_System_Security_Extensions	201410	2	0	0	0	2	2	0	0	644	305	20	456	176	4
337389	Domain_Name_System_Security_Extensions	201412	20	12	7	4	7	6	4	2	664	311	32	475	181	15
337389	Domain_Name_System_Security_Extensions	201501	2	0	0	0	1	1	0	0	666	312	32	477	182	15
337389	Domain_Name_System_Security_Extensions	201502	2	0	0	0	2	2	0	0	668	314	32	479	184	15
337389	Domain_Name_System_Security_Extensions	201503	1	0	0	0	1	0	0	0	669	315	32	479	184	15
337389	Domain_Name_System_Security_Extensions	201504	1	0	0	0	1	0	0	0	670	316	32	479	184	15
337389	Domain_Name_System_Security_Extensions	201505	3	1	0	0	3	1	1	0	673	319	33	480	185	15
337389	Domain_Name_System_Security_Extensions	201506	6	0	0	0	6	5	0	0	679	324	33	485	189	15
337389	Domain_Name_System_Security_Extensions	201507	6	0	0	0	2	1	0	0	685	326	33	486	190	15
337389	Domain_Name_System_Security_Extensions	201509	5	0	0	0	2	1	0	0	690	327	33	490	190	15
337389	Domain_Name_System_Security_Extensions	201511	6	0	0	0	5	4	0	0	696	331	33	494	192	15
337389	Domain_Name_System_Security_Extensions	201512	5	0	0	0	2	2	0	0	701	332	33	499	193	15
337389	Domain_Name_System_Security_Extensions	201601	1	0	0	0	1	1	0	0	702	333	33	500	194	15
337389	Domain_Name_System_Security_Extensions	201602	6	0	0	0	4	3	0	0	708	336	33	504	195	15
337389	Domain_Name_System_Security_Extensions	201603	1	0	0	0	1	1	0	0	709	337	33	505	195	15
337389	Domain_Name_System_Security_Extensions	201604	6	0	0	0	4	1	0	0	715	341	33	506	196	15
337389	Domain_Name_System_Security_Extensions	201605	6	0	0	0	1	0	0	0	721	342	33	506	196	15
337389	Domain_Name_System_Security_Extensions	201607	2	0	0	0	1	1	0	0	723	343	33	508	197	15
337389	Domain_Name_System_Security_Extensions	201609	2	0	0	0	2	1	0	0	725	345	33	509	198	15
337389	Domain_Name_System_Security_Extensions	201610	1	0	0	0	1	1	0	0	726	346	33	510	199	15
337389	Domain_Name_System_Security_Extensions	201611	2	0	0	0	2	1	0	0	728	348	33	511	199	15
337389	Domain_Name_System_Security_Extensions	201612	4	0	0	0	4	4	0	0	732	351	33	515	202	15
337389	Domain_Name_System_Security_Extensions	201701	1	0	0	0	1	1	0	0	733	352	33	516	203	15
337389	Domain_Name_System_Security_Extensions	201702	3	0	0	0	3	2	0	0	736	355	33	518	205	15
337389	Domain_Name_System_Security_Extensions	201703	4	0	0	0	4	1	0	0	740	358	33	519	205	15
337389	Domain_Name_System_Security_Extensions	201704	2	0	0	0	2	2	0	0	742	360	33	521	207	15
337389	Domain_Name_System_Security_Extensions	201706	1	0	0	0	1	0	0	0	743	361	33	521	207	15
337389	Domain_Name_System_Security_Extensions	201707	2	0	0	0	2	1	0	0	745	362	33	522	207	15
337389	Domain_Name_System_Security_Extensions	201708	3	1	0	0	3	3	1	0	748	364	34	525	209	15
337389	Domain_Name_System_Security_Extensions	201709	1	0	0	0	1	1	0	0	749	365	34	526	210	15
337389	Domain_Name_System_Security_Extensions	201710	3	1	0	0	3	2	1	0	752	367	35	528	211	15
337389	Domain_Name_System_Security_Extensions	201711	2	0	0	0	2	2	0	0	754	369	35	530	212	15
337389	Domain_Name_System_Security_Extensions	201801	4	2	0	0	4	2	2	0	758	373	37	532	214	15
337389	Domain_Name_System_Security_Extensions	201802	2	0	0	0	2	1	0	0	760	374	37	533	214	15
337389	Domain_Name_System_Security_Extensions	201803	8	0	0	0	5	5	0	0	768	377	37	541	216	15
337389	Domain_Name_System_Security_Extensions	201804	4	0	0	0	3	2	0	0	772	378	37	543	216	15
337389	Domain_Name_System_Security_Extensions	201805	9	1	0	0	4	3	1	0	781	381	38	548	217	16
337389	Domain_Name_System_Security_Extensions	201806	4	1	0	0	4	3	1	0	785	385	39	551	219	17
337389	Domain_Name_System_Security_Extensions	201807	7	0	0	0	4	2	0	0	792	389	39	553	220	17
158284	Domain_name_registry	200302	3	0	0	0	1	0	0	0	3	1	0	0	0	0
158284	Domain_name_registry	200310	1	0	0	0	1	0	0	0	4	2	0	0	0	0
158284	Domain_name_registry	200312	1	0	0	0	1	1	0	0	5	3	0	1	1	0
158284	Domain_name_registry	200401	1	0	0	0	1	1	0	0	6	4	0	2	2	0
158284	Domain_name_registry	200405	1	0	0	0	1	1	0	0	7	5	0	3	3	0
158284	Domain_name_registry	200406	1	0	0	0	1	1	0	0	8	6	0	4	4	0
158284	Domain_name_registry	200407	1	0	0	0	1	0	0	0	9	7	0	4	4	0
158284	Domain_name_registry	200408	1	0	0	0	1	1	0	0	10	8	0	5	5	0
158284	Domain_name_registry	200409	1	0	0	0	1	1	0	0	11	9	0	6	6	0
158284	Domain_name_registry	200410	1	0	0	0	1	1	0	0	12	10	0	7	7	0
158284	Domain_name_registry	200501	2	0	0	0	2	2	0	0	14	12	0	9	9	0
158284	Domain_name_registry	200503	6	0	0	0	5	2	0	0	20	17	0	11	11	0
158284	Domain_name_registry	200504	1	0	0	0	1	1	0	0	21	18	0	12	12	0
158284	Domain_name_registry	200506	3	0	0	0	3	1	0	0	24	20	0	13	12	0
158284	Domain_name_registry	200507	2	0	0	0	2	2	0	0	26	22	0	15	14	0
158284	Domain_name_registry	200511	1	0	0	0	1	0	0	0	27	23	0	15	14	0
158284	Domain_name_registry	200512	1	0	0	0	1	1	0	0	28	24	0	16	15	0
158284	Domain_name_registry	200601	6	0	0	0	3	2	0	0	34	27	0	20	17	0
158284	Domain_name_registry	200602	3	0	0	0	3	2	0	0	37	30	0	22	19	0
158284	Domain_name_registry	200603	5	1	0	0	4	2	1	0	42	34	1	24	21	0
158284	Domain_name_registry	200604	1	0	0	0	1	1	0	0	43	34	1	25	21	0
158284	Domain_name_registry	200605	8	2	0	0	8	7	2	0	51	41	3	32	27	2
158284	Domain_name_registry	200606	15	1	0	0	11	6	1	0	66	52	4	39	33	2
158284	Domain_name_registry	200607	4	1	0	0	3	1	1	0	70	54	5	40	33	2
158284	Domain_name_registry	200608	15	6	2	1	6	5	4	2	85	59	11	51	37	6
158284	Domain_name_registry	200609	2	1	0	0	2	1	1	0	87	61	12	52	38	6
158284	Domain_name_registry	200611	6	2	0	0	4	3	2	0	93	65	14	55	41	7
158284	Domain_name_registry	200612	13	1	0	0	7	5	1	0	106	71	15	63	45	8
158284	Domain_name_registry	200701	5	0	0	0	4	2	0	0	111	75	15	66	47	8
158284	Domain_name_registry	200702	14	4	0	0	7	3	3	0	125	82	19	74	50	8
158284	Domain_name_registry	200703	4	2	0	0	4	2	2	0	129	85	21	76	51	8
158284	Domain_name_registry	200704	8	1	0	0	5	3	1	0	137	89	22	81	53	8
158284	Domain_name_registry	200705	1	0	0	0	1	1	0	0	138	90	22	82	54	8
158284	Domain_name_registry	200706	2	0	0	0	2	1	0	0	140	92	22	83	55	8
158284	Domain_name_registry	200707	2	1	0	0	2	1	1	0	142	94	23	84	56	8
158284	Domain_name_registry	200708	7	3	0	0	6	3	3	0	149	100	26	87	59	8
158284	Domain_name_registry	200709	5	1	0	0	5	3	1	0	154	105	27	90	62	9
158284	Domain_name_registry	200710	5	1	0	0	3	2	1	0	159	107	28	93	63	9
158284	Domain_name_registry	200712	12	4	0	0	7	5	3	0	171	112	32	100	66	9
158284	Domain_name_registry	200801	9	3	0	0	8	4	3	0	180	118	35	105	68	10
158284	Domain_name_registry	200802	5	0	0	0	2	1	0	0	185	120	35	106	69	10
158284	Domain_name_registry	200805	7	0	0	0	4	2	0	0	192	124	35	108	71	10
158284	Domain_name_registry	200807	3	1	0	0	2	2	1	0	195	126	36	111	73	11
158284	Domain_name_registry	200808	6	2	0	0	4	2	2	0	201	129	38	113	74	11
158284	Domain_name_registry	200809	2	1	0	0	2	1	1	0	203	131	39	114	75	11
158284	Domain_name_registry	200811	1	0	0	0	1	1	0	0	204	132	39	115	76	11
158284	Domain_name_registry	200812	6	2	0	0	6	4	2	0	210	136	41	119	78	11
158284	Domain_name_registry	200901	5	1	0	0	3	2	1	0	215	139	42	122	80	11
158284	Domain_name_registry	200902	1	0	0	0	1	1	0	0	216	140	42	123	81	11
158284	Domain_name_registry	200904	1	0	0	0	1	1	0	0	217	141	42	124	82	11
158284	Domain_name_registry	200906	9	2	0	0	5	4	1	0	226	145	44	132	85	12
158284	Domain_name_registry	200912	2	1	0	0	2	2	1	0	228	147	45	134	87	13
158284	Domain_name_registry	201003	3	0	0	0	2	1	0	0	231	149	45	135	88	13
158284	Domain_name_registry	201005	2	0	0	0	1	1	0	0	233	150	45	137	89	13
158284	Domain_name_registry	201007	2	0	0	0	1	1	0	0	235	151	45	139	90	13
158284	Domain_name_registry	201009	5	1	0	0	5	3	1	0	240	155	46	142	92	13
158284	Domain_name_registry	201012	2	1	0	0	2	0	1	0	242	157	47	142	92	13
158284	Domain_name_registry	201101	8	0	0	0	4	2	0	0	250	161	47	145	94	13
158284	Domain_name_registry	201102	2	1	0	0	2	1	1	0	252	162	48	146	94	13
158284	Domain_name_registry	201103	3	1	0	0	3	2	1	0	255	165	49	148	96	13
158284	Domain_name_registry	201107	3	0	0	0	2	1	0	0	258	167	49	150	97	13
158284	Domain_name_registry	201108	4	1	0	0	3	2	1	0	262	170	50	152	99	13
158284	Domain_name_registry	201111	1	0	0	0	1	0	0	0	263	171	50	152	99	13
158284	Domain_name_registry	201112	1	0	0	0	1	0	0	0	264	172	50	152	99	13
158284	Domain_name_registry	201201	2	0	0	0	2	2	0	0	266	174	50	154	101	13
158284	Domain_name_registry	201202	2	1	0	0	2	1	1	0	268	176	51	155	102	13
158284	Domain_name_registry	201203	5	0	0	0	4	4	0	0	273	180	51	160	106	13
158284	Domain_name_registry	201205	4	1	0	0	3	2	1	0	277	182	52	163	107	13
158284	Domain_name_registry	201206	1	0	0	0	1	0	0	0	278	183	52	163	107	13
158284	Domain_name_registry	201209	1	0	0	0	1	1	0	0	279	184	52	164	108	13
158284	Domain_name_registry	201211	2	0	0	0	2	0	0	0	281	186	52	164	108	13
158284	Domain_name_registry	201302	1	0	0	0	1	1	0	0	282	187	52	165	109	13
158284	Domain_name_registry	201303	3	1	0	0	3	2	1	0	285	190	53	167	111	13
158284	Domain_name_registry	201304	1	0	0	0	1	1	0	0	286	190	53	168	111	13
158284	Domain_name_registry	201305	3	0	0	0	1	1	0	0	289	191	53	171	112	13
158284	Domain_name_registry	201309	3	1	0	0	3	1	1	0	292	194	54	172	113	13
158284	Domain_name_registry	201310	2	0	0	0	2	2	0	0	294	196	54	174	115	13
158284	Domain_name_registry	201406	2	0	0	0	2	2	0	0	296	197	54	176	116	13
158284	Domain_name_registry	201409	3	1	0	0	3	2	1	0	299	199	55	178	117	13
158284	Domain_name_registry	201410	3	0	0	0	2	1	0	0	302	201	55	179	118	13
158284	Domain_name_registry	201411	1	0	0	0	1	1	0	0	303	201	55	180	118	13
158284	Domain_name_registry	201412	2	0	0	0	2	2	0	0	305	203	55	182	120	13
158284	Domain_name_registry	201501	3	1	0	0	3	3	1	0	308	206	56	185	123	14
158284	Domain_name_registry	201503	1	0	0	0	1	1	0	0	309	207	56	186	124	14
158284	Domain_name_registry	201506	1	0	0	0	1	0	0	0	310	208	56	186	124	14
158284	Domain_name_registry	201507	2	1	0	0	2	1	1	0	312	210	57	187	125	14
158284	Domain_name_registry	201510	1	0	0	0	1	0	0	0	313	211	57	187	125	14
158284	Domain_name_registry	201605	3	1	0	0	3	3	1	0	316	214	58	190	128	15
158284	Domain_name_registry	201606	2	1	0	0	2	1	1	0	318	216	59	191	129	15
158284	Domain_name_registry	201607	1	0	0	0	1	1	0	0	319	217	59	192	130	15
158284	Domain_name_registry	201608	2	0	0	0	1	0	0	0	321	218	59	192	130	15
158284	Domain_name_registry	201609	9	4	0	0	3	2	2	0	330	220	63	196	131	15
158284	Domain_name_registry	201612	2	1	0	0	2	1	1	0	332	221	64	197	131	15
158284	Domain_name_registry	201701	3	1	0	0	3	3	1	0	335	224	65	200	133	16
158284	Domain_name_registry	201702	4	1	0	0	2	1	1	0	339	226	66	201	134	16
158284	Domain_name_registry	201704	8	5	1	0	6	4	4	1	347	231	71	207	137	19
158284	Domain_name_registry	201708	1	0	0	0	1	1	0	0	348	232	71	208	138	19
158284	Domain_name_registry	201801	2	1	0	0	2	2	1	0	350	234	72	210	140	20
158284	Domain_name_registry	201802	2	1	0	0	2	1	1	0	352	235	73	211	140	20
158284	Domain_name_registry	201803	3	1	0	0	2	2	1	0	355	236	74	214	140	21
158284	Domain_name_registry	201804	4	2	0	0	4	2	2	0	359	238	76	216	140	21
158284	Domain_name_registry	201807	2	1	0	0	2	1	1	0	361	239	77	217	140	21
8622	Dynamic_Host_Configuration_Protocol	200202	2	0	0	0	2	2	0	0	2	2	0	2	2	0
8622	Dynamic_Host_Configuration_Protocol	200208	1	0	0	0	1	1	0	0	3	3	0	3	3	0
8622	Dynamic_Host_Configuration_Protocol	200301	1	0	0	0	1	1	0	0	4	4	0	4	4	0
8622	Dynamic_Host_Configuration_Protocol	200305	1	0	0	0	1	1	0	0	5	5	0	5	5	0
8622	Dynamic_Host_Configuration_Protocol	200306	1	0	0	0	1	1	0	0	6	6	0	6	6	0
8622	Dynamic_Host_Configuration_Protocol	200307	1	0	0	0	1	1	0	0	7	7	0	7	7	0
8622	Dynamic_Host_Configuration_Protocol	200308	1	0	0	0	1	0	0	0	8	8	0	7	7	0
8622	Dynamic_Host_Configuration_Protocol	200309	3	0	0	0	3	2	0	0	11	10	0	9	8	0
8622	Dynamic_Host_Configuration_Protocol	200310	4	0	0	0	4	3	0	0	15	14	0	12	11	0
8622	Dynamic_Host_Configuration_Protocol	200312	2	0	0	0	2	0	0	0	17	16	0	12	11	0
8622	Dynamic_Host_Configuration_Protocol	200402	2	0	0	0	1	1	0	0	19	17	0	14	12	0
8622	Dynamic_Host_Configuration_Protocol	200403	2	0	0	0	2	2	0	0	21	19	0	16	14	0
8622	Dynamic_Host_Configuration_Protocol	200404	1	0	0	0	1	1	0	0	22	20	0	17	15	0
8622	Dynamic_Host_Configuration_Protocol	200405	2	0	0	0	2	2	0	0	24	21	0	19	16	0
8622	Dynamic_Host_Configuration_Protocol	200406	1	0	0	0	1	1	0	0	25	22	0	20	17	0
8622	Dynamic_Host_Configuration_Protocol	200407	2	0	0	0	2	2	0	0	27	24	0	22	18	0
8622	Dynamic_Host_Configuration_Protocol	200408	3	0	0	0	2	1	0	0	30	26	0	23	19	0
8622	Dynamic_Host_Configuration_Protocol	200409	4	0	0	0	3	2	0	0	34	29	0	26	21	0
8622	Dynamic_Host_Configuration_Protocol	200410	6	1	0	0	6	2	1	0	40	35	1	28	23	0
8622	Dynamic_Host_Configuration_Protocol	200411	9	0	0	0	5	3	0	0	49	39	1	33	25	0
8622	Dynamic_Host_Configuration_Protocol	200412	6	0	0	0	6	4	0	0	55	44	1	37	28	0
8622	Dynamic_Host_Configuration_Protocol	200501	7	2	0	0	6	2	2	0	62	50	3	39	30	0
8622	Dynamic_Host_Configuration_Protocol	200502	8	1	0	0	5	2	1	0	70	55	4	41	32	0
8622	Dynamic_Host_Configuration_Protocol	200503	3	1	0	0	3	1	1	0	73	58	5	42	33	0
8622	Dynamic_Host_Configuration_Protocol	200504	1	0	0	0	1	1	0	0	74	59	5	43	34	0
8622	Dynamic_Host_Configuration_Protocol	200505	6	1	0	0	5	2	1	0	80	64	6	45	36	0
8622	Dynamic_Host_Configuration_Protocol	200506	6	1	0	0	6	3	1	0	86	69	7	48	39	0
8622	Dynamic_Host_Configuration_Protocol	200507	4	0	0	0	4	3	0	0	90	73	7	51	42	0
8622	Dynamic_Host_Configuration_Protocol	200508	6	0	0	0	2	1	0	0	96	75	7	52	43	0
8622	Dynamic_Host_Configuration_Protocol	200509	5	1	0	0	5	2	1	0	101	79	8	54	44	0
8622	Dynamic_Host_Configuration_Protocol	200510	7	0	0	0	6	4	0	0	108	84	8	58	47	0
8622	Dynamic_Host_Configuration_Protocol	200511	6	0	0	0	4	2	0	0	114	88	8	60	49	0
8622	Dynamic_Host_Configuration_Protocol	200512	15	1	0	0	10	4	1	0	129	96	9	64	51	0
8622	Dynamic_Host_Configuration_Protocol	200601	14	1	0	0	8	4	1	0	143	103	10	68	54	0
8622	Dynamic_Host_Configuration_Protocol	200602	44	4	0	0	30	8	4	0	187	131	14	79	60	0
8622	Dynamic_Host_Configuration_Protocol	200603	23	1	0	0	14	3	1	0	210	143	15	85	62	0
8622	Dynamic_Host_Configuration_Protocol	200604	14	1	0	0	12	8	1	0	224	151	16	95	66	0
8622	Dynamic_Host_Configuration_Protocol	200605	4	1	0	0	4	2	1	0	228	154	17	97	67	0
8622	Dynamic_Host_Configuration_Protocol	200606	8	0	0	0	6	4	0	0	236	159	17	103	70	0
8622	Dynamic_Host_Configuration_Protocol	200607	26	8	2	1	19	10	4	2	262	177	25	117	79	1
8622	Dynamic_Host_Configuration_Protocol	200608	16	2	0	0	14	7	2	0	278	191	27	124	86	2
8622	Dynamic_Host_Configuration_Protocol	200609	29	3	0	0	18	8	2	0	307	208	30	139	93	2
8622	Dynamic_Host_Configuration_Protocol	200610	22	3	0	0	17	5	3	0	329	225	33	146	98	2
8622	Dynamic_Host_Configuration_Protocol	200611	24	3	0	0	16	9	3	0	353	241	36	155	107	3
8622	Dynamic_Host_Configuration_Protocol	200612	27	6	0	0	18	10	6	0	380	256	42	168	115	3
8622	Dynamic_Host_Configuration_Protocol	200701	25	5	0	0	17	9	4	0	405	271	47	182	122	3
8622	Dynamic_Host_Configuration_Protocol	200702	38	5	0	0	26	13	5	0	443	294	52	199	132	3
8622	Dynamic_Host_Configuration_Protocol	200703	30	4	0	0	26	7	4	0	473	320	56	208	139	3
8622	Dynamic_Host_Configuration_Protocol	200704	31	2	0	0	18	7	2	0	504	337	58	221	145	4
8622	Dynamic_Host_Configuration_Protocol	200705	15	3	0	0	13	6	3	0	519	349	61	227	150	4
8622	Dynamic_Host_Configuration_Protocol	200706	15	4	0	0	12	7	3	0	534	361	65	235	157	6
8622	Dynamic_Host_Configuration_Protocol	200707	26	5	0	0	17	5	2	0	560	377	70	247	161	6
8622	Dynamic_Host_Configuration_Protocol	200708	19	1	0	0	9	5	1	0	579	385	71	261	165	6
8622	Dynamic_Host_Configuration_Protocol	200709	14	1	0	0	11	6	1	0	593	396	72	269	171	6
8622	Dynamic_Host_Configuration_Protocol	200710	13	1	0	0	13	4	1	0	606	407	73	273	173	6
8622	Dynamic_Host_Configuration_Protocol	200711	17	1	0	0	15	8	1	0	623	420	74	282	179	6
8622	Dynamic_Host_Configuration_Protocol	200712	59	10	0	0	32	11	5	0	682	447	84	314	186	8
8622	Dynamic_Host_Configuration_Protocol	200801	27	7	0	0	24	11	6	0	709	469	91	326	195	9
8622	Dynamic_Host_Configuration_Protocol	200802	32	5	0	0	25	10	4	0	741	492	96	341	203	11
8622	Dynamic_Host_Configuration_Protocol	200803	37	10	0	0	26	10	8	0	778	518	106	353	213	11
8622	Dynamic_Host_Configuration_Protocol	200804	26	1	0	0	14	2	1	0	804	532	107	355	215	11
8622	Dynamic_Host_Configuration_Protocol	200805	30	6	0	0	19	9	5	0	834	550	113	365	223	12
8622	Dynamic_Host_Configuration_Protocol	200806	33	4	0	0	22	7	3	0	867	569	117	374	228	12
8622	Dynamic_Host_Configuration_Protocol	200807	20	3	0	0	18	7	3	0	887	587	120	382	235	12
8622	Dynamic_Host_Configuration_Protocol	200808	22	7	0	0	16	4	5	0	909	599	127	389	236	14
8622	Dynamic_Host_Configuration_Protocol	200809	19	3	0	0	16	7	3	0	928	613	130	397	242	14
8622	Dynamic_Host_Configuration_Protocol	200810	14	4	0	0	14	5	4	0	942	626	134	402	246	15
8622	Dynamic_Host_Configuration_Protocol	200811	17	4	0	0	10	4	2	0	959	636	138	411	250	16
8622	Dynamic_Host_Configuration_Protocol	200812	17	1	0	0	12	5	1	0	976	648	139	416	255	16
8622	Dynamic_Host_Configuration_Protocol	200901	26	3	0	0	20	7	2	0	1002	666	142	425	260	16
8622	Dynamic_Host_Configuration_Protocol	200902	19	2	0	0	13	5	1	0	1021	679	144	433	265	16
8622	Dynamic_Host_Configuration_Protocol	200903	12	0	0	0	8	4	0	0	1033	686	144	439	268	16
8622	Dynamic_Host_Configuration_Protocol	200904	24	5	0	0	10	6	2	0	1057	693	149	458	272	17
8622	Dynamic_Host_Configuration_Protocol	200905	19	7	1	0	13	7	6	1	1076	704	156	467	277	19
8622	Dynamic_Host_Configuration_Protocol	200906	12	4	0	0	9	4	3	0	1088	711	160	472	279	19
8622	Dynamic_Host_Configuration_Protocol	200907	15	2	0	0	11	7	2	0	1103	719	162	483	283	20
8622	Dynamic_Host_Configuration_Protocol	200908	10	3	0	0	9	3	3	0	1113	726	165	486	284	20
8622	Dynamic_Host_Configuration_Protocol	200909	19	5	0	0	15	7	5	0	1132	738	170	496	288	21
8622	Dynamic_Host_Configuration_Protocol	200910	23	4	0	0	12	6	2	0	1155	748	174	506	292	21
8622	Dynamic_Host_Configuration_Protocol	200911	19	7	0	0	14	8	6	0	1174	758	181	517	296	21
8622	Dynamic_Host_Configuration_Protocol	200912	11	2	0	0	9	5	1	0	1185	767	183	523	301	21
8622	Dynamic_Host_Configuration_Protocol	201001	14	6	0	0	12	4	4	0	1199	777	189	529	303	21
8622	Dynamic_Host_Configuration_Protocol	201002	22	4	0	0	16	6	4	0	1221	790	193	535	306	21
8622	Dynamic_Host_Configuration_Protocol	201003	14	1	0	0	11	4	1	0	1235	800	194	539	309	21
8622	Dynamic_Host_Configuration_Protocol	201004	26	6	0	0	17	6	3	0	1261	814	200	548	312	22
8622	Dynamic_Host_Configuration_Protocol	201005	23	7	0	0	14	7	4	0	1284	824	207	560	315	23
8622	Dynamic_Host_Configuration_Protocol	201006	40	3	0	0	22	11	2	0	1324	842	210	584	322	23
8622	Dynamic_Host_Configuration_Protocol	201007	8	1	0	0	7	4	1	0	1332	847	211	588	324	23
8622	Dynamic_Host_Configuration_Protocol	201008	20	5	0	0	14	7	5	0	1352	859	216	600	329	23
8622	Dynamic_Host_Configuration_Protocol	201009	16	3	0	0	9	7	3	0	1368	864	219	613	332	26
8622	Dynamic_Host_Configuration_Protocol	201010	29	8	0	0	16	10	7	0	1397	875	227	632	337	27
8622	Dynamic_Host_Configuration_Protocol	201011	8	2	0	0	7	4	2	0	1405	878	229	637	337	27
8622	Dynamic_Host_Configuration_Protocol	201012	16	3	0	0	11	6	3	0	1421	887	232	644	341	27
8622	Dynamic_Host_Configuration_Protocol	201101	7	2	0	0	6	2	2	0	1428	892	234	646	342	27
8622	Dynamic_Host_Configuration_Protocol	201102	19	4	0	0	12	8	4	0	1447	900	238	657	346	28
8622	Dynamic_Host_Configuration_Protocol	201103	11	5	0	0	11	4	5	0	1458	909	243	661	348	28
8622	Dynamic_Host_Configuration_Protocol	201104	6	2	0	0	5	1	1	0	1464	913	245	663	348	28
8622	Dynamic_Host_Configuration_Protocol	201105	9	4	0	0	8	3	4	0	1473	920	249	666	350	28
8622	Dynamic_Host_Configuration_Protocol	201106	17	4	0	0	15	8	4	0	1490	934	253	675	357	29
8622	Dynamic_Host_Configuration_Protocol	201107	6	1	0	0	5	4	1	0	1496	938	254	680	360	30
8622	Dynamic_Host_Configuration_Protocol	201108	10	2	0	0	10	3	2	0	1506	946	256	683	361	30
8622	Dynamic_Host_Configuration_Protocol	201109	10	2	0	0	9	5	2	0	1516	955	258	688	366	30
8622	Dynamic_Host_Configuration_Protocol	201110	20	3	0	0	14	4	2	0	1536	967	261	693	368	30
8622	Dynamic_Host_Configuration_Protocol	201111	12	3	0	0	10	6	3	0	1548	976	264	699	373	31
8622	Dynamic_Host_Configuration_Protocol	201112	11	2	0	0	7	4	2	0	1559	981	266	703	375	32
8622	Dynamic_Host_Configuration_Protocol	201201	12	5	0	0	9	5	4	0	1571	988	271	709	378	34
8622	Dynamic_Host_Configuration_Protocol	201202	6	2	0	0	6	1	2	0	1577	994	273	710	379	34
8622	Dynamic_Host_Configuration_Protocol	201203	11	3	0	0	10	4	3	0	1588	1000	276	714	379	34
8622	Dynamic_Host_Configuration_Protocol	201204	6	1	0	0	6	3	1	0	1594	1004	277	717	380	34
8622	Dynamic_Host_Configuration_Protocol	201205	16	3	0	0	13	6	3	0	1610	1015	280	723	384	34
8622	Dynamic_Host_Configuration_Protocol	201206	13	4	0	0	8	4	3	0	1623	1021	284	732	386	34
8622	Dynamic_Host_Configuration_Protocol	201207	12	3	0	0	8	3	2	0	1635	1027	287	739	387	34
8622	Dynamic_Host_Configuration_Protocol	201208	24	5	0	0	15	6	3	0	1659	1039	292	750	390	34
8622	Dynamic_Host_Configuration_Protocol	201209	16	6	0	0	12	8	5	0	1675	1047	298	760	394	35
8622	Dynamic_Host_Configuration_Protocol	201210	9	2	0	0	8	2	2	0	1684	1053	300	762	394	35
8622	Dynamic_Host_Configuration_Protocol	201211	11	3	0	0	8	4	3	0	1695	1058	303	767	395	36
8622	Dynamic_Host_Configuration_Protocol	201212	2	1	0	0	2	1	1	0	1697	1059	304	768	395	36
8622	Dynamic_Host_Configuration_Protocol	201301	12	4	0	0	11	7	3	0	1709	1066	308	776	398	37
8622	Dynamic_Host_Configuration_Protocol	201302	22	6	0	0	13	8	4	0	1731	1075	314	792	402	39
8622	Dynamic_Host_Configuration_Protocol	201303	28	5	0	0	18	9	5	0	1759	1091	319	807	409	39
8622	Dynamic_Host_Configuration_Protocol	201304	12	5	0	0	9	5	5	0	1771	1096	324	813	410	40
8622	Dynamic_Host_Configuration_Protocol	201305	11	1	0	0	8	4	1	0	1782	1102	325	820	412	40
8622	Dynamic_Host_Configuration_Protocol	201306	25	2	0	0	20	9	2	0	1807	1117	327	831	416	40
8622	Dynamic_Host_Configuration_Protocol	201307	15	3	0	0	13	5	3	0	1822	1129	330	836	420	40
8622	Dynamic_Host_Configuration_Protocol	201308	20	6	1	0	14	11	5	1	1842	1139	336	852	427	44
8622	Dynamic_Host_Configuration_Protocol	201309	10	1	0	0	7	3	1	0	1852	1145	337	855	429	44
8622	Dynamic_Host_Configuration_Protocol	201310	8	3	0	0	7	5	3	0	1860	1151	340	860	432	45
8622	Dynamic_Host_Configuration_Protocol	201311	28	6	0	0	21	10	6	0	1888	1166	346	875	437	45
8622	Dynamic_Host_Configuration_Protocol	201312	18	6	0	0	16	9	5	0	1906	1179	352	886	443	45
8622	Dynamic_Host_Configuration_Protocol	201401	35	5	0	0	16	7	4	0	1941	1190	357	908	444	47
8622	Dynamic_Host_Configuration_Protocol	201402	20	4	0	0	14	9	4	0	1961	1201	361	919	449	48
8622	Dynamic_Host_Configuration_Protocol	201403	17	4	0	0	11	7	4	0	1978	1207	365	930	451	48
8622	Dynamic_Host_Configuration_Protocol	201404	25	6	0	0	12	7	4	0	2003	1215	371	950	454	50
8622	Dynamic_Host_Configuration_Protocol	201405	15	5	0	0	12	4	3	0	2018	1225	376	956	456	51
8622	Dynamic_Host_Configuration_Protocol	201406	18	5	0	0	12	6	4	0	2036	1232	381	967	457	51
8622	Dynamic_Host_Configuration_Protocol	201407	8	2	0	0	6	4	2	0	2044	1236	383	972	459	51
8622	Dynamic_Host_Configuration_Protocol	201408	6	2	0	0	6	3	2	0	2050	1241	385	975	461	51
8622	Dynamic_Host_Configuration_Protocol	201409	4	1	0	0	4	3	1	0	2054	1243	386	978	462	51
8622	Dynamic_Host_Configuration_Protocol	201410	18	5	0	0	10	5	4	0	2072	1250	391	987	464	51
8622	Dynamic_Host_Configuration_Protocol	201411	12	4	0	0	11	5	4	0	2084	1259	395	992	467	51
8622	Dynamic_Host_Configuration_Protocol	201412	9	2	0	0	6	2	2	0	2093	1263	397	996	467	51
8622	Dynamic_Host_Configuration_Protocol	201501	8	2	0	0	8	5	2	0	2101	1267	399	1001	468	51
8622	Dynamic_Host_Configuration_Protocol	201502	11	5	1	0	7	5	4	1	2112	1271	404	1010	470	55
8622	Dynamic_Host_Configuration_Protocol	201503	10	3	0	0	7	4	2	0	2122	1276	407	1017	472	56
8622	Dynamic_Host_Configuration_Protocol	201504	26	11	2	0	17	10	9	2	2148	1288	418	1030	477	58
8622	Dynamic_Host_Configuration_Protocol	201505	7	2	0	0	5	3	2	0	2155	1291	420	1033	478	59
8622	Dynamic_Host_Configuration_Protocol	201506	5	0	0	0	3	1	0	0	2160	1294	420	1034	479	59
8622	Dynamic_Host_Configuration_Protocol	201507	1	0	0	0	1	1	0	0	2161	1294	420	1035	479	59
8622	Dynamic_Host_Configuration_Protocol	201508	11	2	0	0	7	4	2	0	2172	1297	422	1039	479	59
8622	Dynamic_Host_Configuration_Protocol	201509	6	1	0	0	5	2	1	0	2178	1301	423	1042	480	59
8622	Dynamic_Host_Configuration_Protocol	201510	2	1	0	0	2	1	1	0	2180	1302	424	1043	480	59
8622	Dynamic_Host_Configuration_Protocol	201511	8	2	0	0	7	4	2	0	2188	1308	426	1047	483	59
8622	Dynamic_Host_Configuration_Protocol	201512	3	0	0	0	3	2	0	0	2191	1310	426	1049	484	59
8622	Dynamic_Host_Configuration_Protocol	201601	9	3	0	0	7	4	3	0	2200	1316	429	1053	487	59
8622	Dynamic_Host_Configuration_Protocol	201602	17	3	0	0	12	5	3	0	2217	1326	432	1059	489	59
8622	Dynamic_Host_Configuration_Protocol	201603	6	1	0	0	4	2	1	0	2223	1329	433	1061	490	59
8622	Dynamic_Host_Configuration_Protocol	201604	7	2	0	0	6	2	2	0	2230	1334	435	1063	491	59
8622	Dynamic_Host_Configuration_Protocol	201605	6	2	0	0	5	4	2	0	2236	1337	437	1068	492	60
8622	Dynamic_Host_Configuration_Protocol	201606	8	3	0	0	6	3	3	0	2244	1341	440	1071	493	60
8622	Dynamic_Host_Configuration_Protocol	201607	7	2	0	0	5	2	1	0	2251	1345	442	1074	494	60
8622	Dynamic_Host_Configuration_Protocol	201608	6	1	0	0	5	4	1	0	2257	1349	443	1079	496	60
8622	Dynamic_Host_Configuration_Protocol	201609	24	2	0	0	6	2	2	0	2281	1354	445	1081	497	60
8622	Dynamic_Host_Configuration_Protocol	201610	5	2	0	0	5	2	2	0	2286	1359	447	1083	499	60
8622	Dynamic_Host_Configuration_Protocol	201611	31	11	0	0	15	11	8	0	2317	1371	458	1105	506	65
8622	Dynamic_Host_Configuration_Protocol	201612	5	2	0	0	5	1	2	0	2322	1375	460	1106	506	65
8622	Dynamic_Host_Configuration_Protocol	201701	3	0	0	0	3	1	0	0	2325	1378	460	1107	506	65
8622	Dynamic_Host_Configuration_Protocol	201702	4	0	0	0	2	2	0	0	2329	1380	460	1111	508	65
8622	Dynamic_Host_Configuration_Protocol	201703	10	2	0	0	8	3	2	0	2339	1387	462	1114	510	65
8622	Dynamic_Host_Configuration_Protocol	201704	9	2	0	0	4	3	2	0	2348	1390	464	1117	512	65
8622	Dynamic_Host_Configuration_Protocol	201705	4	1	0	0	4	3	1	0	2352	1391	465	1120	512	65
8622	Dynamic_Host_Configuration_Protocol	201707	8	0	0	0	4	1	0	0	2360	1395	465	1121	513	65
8622	Dynamic_Host_Configuration_Protocol	201708	21	1	0	0	9	6	1	0	2381	1403	466	1128	518	65
8622	Dynamic_Host_Configuration_Protocol	201709	3	0	0	0	3	1	0	0	2384	1405	466	1129	518	65
8622	Dynamic_Host_Configuration_Protocol	201710	4	0	0	0	3	0	0	0	2388	1408	466	1129	518	65
8622	Dynamic_Host_Configuration_Protocol	201711	3	0	0	0	3	1	0	0	2391	1410	466	1130	518	65
8622	Dynamic_Host_Configuration_Protocol	201712	2	0	0	0	1	0	0	0	2393	1411	466	1130	518	65
8622	Dynamic_Host_Configuration_Protocol	201801	24	2	0	0	10	7	2	0	2417	1419	468	1149	523	66
8622	Dynamic_Host_Configuration_Protocol	201802	11	2	0	0	7	5	2	0	2428	1426	470	1158	528	66
8622	Dynamic_Host_Configuration_Protocol	201803	6	1	0	0	5	4	1	0	2434	1429	471	1162	530	66
8622	Dynamic_Host_Configuration_Protocol	201804	5	1	0	0	4	2	1	0	2439	1431	472	1164	530	66
8622	Dynamic_Host_Configuration_Protocol	201805	10	0	0	0	5	5	0	0	2449	1435	472	1174	534	66
8622	Dynamic_Host_Configuration_Protocol	201806	7	2	0	0	5	3	2	0	2456	1438	474	1179	534	66
8622	Dynamic_Host_Configuration_Protocol	201807	10	0	0	0	6	4	0	0	2466	1443	474	1187	536	66
7391821	Dynamic_spectrum_management	200611	10	0	0	0	7	2	0	0	10	7	0	2	2	0
7391821	Dynamic_spectrum_management	200705	1	0	0	0	1	0	0	0	11	8	0	2	2	0
7391821	Dynamic_spectrum_management	200707	3	0	0	0	1	1	0	0	14	9	0	5	3	0
7391821	Dynamic_spectrum_management	200708	1	0	0	0	1	1	0	0	15	10	0	6	4	0
7391821	Dynamic_spectrum_management	200806	1	0	0	0	1	1	0	0	16	11	0	7	5	0
7391821	Dynamic_spectrum_management	200904	1	0	0	0	1	1	0	0	17	12	0	8	6	0
7391821	Dynamic_spectrum_management	200907	35	0	0	0	6	4	0	0	52	17	0	32	9	0
7391821	Dynamic_spectrum_management	200909	1	0	0	0	1	1	0	0	53	18	0	33	10	0
7391821	Dynamic_spectrum_management	200912	1	0	0	0	1	1	0	0	54	19	0	34	11	0
7391821	Dynamic_spectrum_management	201003	1	0	0	0	1	0	0	0	55	20	0	34	11	0
7391821	Dynamic_spectrum_management	201005	1	0	0	0	1	1	0	0	56	21	0	35	12	0
7391821	Dynamic_spectrum_management	201009	2	0	0	0	2	2	0	0	58	23	0	37	14	0
7391821	Dynamic_spectrum_management	201107	4	1	0	0	4	2	1	0	62	27	1	39	16	0
7391821	Dynamic_spectrum_management	201201	2	0	0	0	2	2	0	0	64	29	1	41	18	0
7391821	Dynamic_spectrum_management	201212	1	0	0	0	1	1	0	0	65	30	1	42	19	0
7391821	Dynamic_spectrum_management	201303	1	0	0	0	1	1	0	0	66	31	1	43	20	0
7391821	Dynamic_spectrum_management	201501	1	0	0	0	1	1	0	0	67	32	1	44	21	0
7391821	Dynamic_spectrum_management	201512	1	0	0	0	1	1	0	0	68	33	1	45	22	0
7391821	Dynamic_spectrum_management	201703	3	0	0	0	2	2	0	0	71	35	1	48	24	0
7391821	Dynamic_spectrum_management	201708	2	0	0	0	1	1	0	0	73	36	1	50	25	0
7391821	Dynamic_spectrum_management	201709	1	0	0	0	1	1	0	0	74	37	1	51	26	0
7391821	Dynamic_spectrum_management	201711	1	0	0	0	1	1	0	0	75	38	1	52	27	0
202311	E-services	200412	2	0	0	0	2	1	0	0	2	2	0	1	1	0
202311	E-services	200502	1	0	0	0	1	1	0	0	3	3	0	2	2	0
202311	E-services	200506	1	0	0	0	1	1	0	0	4	4	0	3	3	0
202311	E-services	200611	1	0	0	0	1	0	0	0	5	5	0	3	3	0
202311	E-services	200705	1	0	0	0	1	1	0	0	6	6	0	4	4	0
202311	E-services	200706	1	0	0	0	1	0	0	0	7	7	0	4	4	0
202311	E-services	200708	4	1	0	0	2	2	1	0	11	9	1	8	6	1
202311	E-services	200709	2	1	0	0	2	1	1	0	13	10	2	9	6	1
202311	E-services	200809	2	1	0	0	2	2	1	0	15	10	3	11	6	2
202311	E-services	200811	1	0	0	0	1	1	0	0	16	11	3	12	7	2
202311	E-services	200812	1	0	0	0	1	1	0	0	17	12	3	13	8	2
202311	E-services	200906	5	0	0	0	4	3	0	0	22	16	3	16	11	2
202311	E-services	200907	1	0	0	0	1	1	0	0	23	17	3	17	12	2
202311	E-services	200912	2	1	0	0	2	1	1	0	25	18	4	18	12	2
202311	E-services	201004	1	0	0	0	1	1	0	0	26	18	4	19	12	2
202311	E-services	201005	3	1	0	0	2	1	1	0	29	19	5	20	12	2
202311	E-services	201006	59	1	0	0	7	5	1	0	88	25	6	58	16	3
202311	E-services	201007	4	0	0	0	2	2	0	0	92	27	6	62	18	3
202311	E-services	201008	6	0	0	0	4	3	0	0	98	30	6	67	20	3
202311	E-services	201009	2	1	0	0	2	1	1	0	100	32	7	68	21	3
202311	E-services	201010	2	0	0	0	2	2	0	0	102	34	7	70	23	3
202311	E-services	201011	1	0	0	0	1	1	0	0	103	35	7	71	24	3
202311	E-services	201012	2	1	0	0	2	2	1	0	105	36	8	73	25	4
202311	E-services	201101	3	1	0	0	3	2	1	0	108	38	9	75	26	4
202311	E-services	201104	2	0	0	0	1	0	0	0	110	39	9	75	26	4
202311	E-services	201105	2	0	0	0	2	2	0	0	112	41	9	77	28	4
202311	E-services	201106	5	1	0	0	3	2	1	0	117	44	10	81	30	4
202311	E-services	201108	2	0	0	0	2	2	0	0	119	46	10	83	32	4
202311	E-services	201109	4	0	0	0	2	0	0	0	123	48	10	83	32	4
202311	E-services	201110	5	0	0	0	4	4	0	0	128	52	10	88	36	4
202311	E-services	201111	3	0	0	0	3	2	0	0	131	55	10	90	38	4
202311	E-services	201112	3	1	0	0	3	1	1	0	134	58	11	91	39	4
202311	E-services	201201	2	1	0	0	2	1	1	0	136	60	12	92	40	4
202311	E-services	201202	2	0	0	0	1	0	0	0	138	61	12	92	40	4
202311	E-services	201203	3	1	0	0	2	1	1	0	141	62	13	93	40	4
202311	E-services	201210	1	0	0	0	1	1	0	0	142	63	13	94	41	4
202311	E-services	201301	2	0	0	0	2	1	0	0	144	65	13	95	42	4
202311	E-services	201302	4	1	0	0	4	3	1	0	148	68	14	98	44	4
202311	E-services	201303	4	0	0	0	3	2	0	0	152	70	14	100	45	4
202311	E-services	201304	1	0	0	0	1	1	0	0	153	70	14	101	45	4
202311	E-services	201306	2	1	0	0	2	1	1	0	155	71	15	102	45	4
202311	E-services	201307	3	0	0	0	1	0	0	0	158	72	15	102	45	4
202311	E-services	201311	1	0	0	0	1	0	0	0	159	73	15	102	45	4
202311	E-services	201401	1	0	0	0	1	1	0	0	160	74	15	103	46	4
202311	E-services	201402	1	0	0	0	1	0	0	0	161	75	15	103	46	4
202311	E-services	201404	2	0	0	0	1	1	0	0	163	76	15	105	47	4
202311	E-services	201405	3	1	0	0	2	2	1	0	166	77	16	108	48	5
202311	E-services	201408	2	1	0	0	2	1	1	0	168	78	17	109	48	5
202311	E-services	201409	1	0	0	0	1	1	0	0	169	78	17	110	48	5
202311	E-services	201412	1	0	0	0	1	0	0	0	170	79	17	110	48	5
202311	E-services	201501	1	0	0	0	1	0	0	0	171	80	17	110	48	5
202311	E-services	201502	2	0	0	0	1	0	0	0	173	81	17	110	48	5
202311	E-services	201503	2	0	0	0	1	0	0	0	175	82	17	110	48	5
202311	E-services	201509	2	0	0	0	1	0	0	0	177	83	17	110	48	5
202311	E-services	201511	1	0	0	0	1	0	0	0	178	84	17	110	48	5
202311	E-services	201605	1	0	0	0	1	0	0	0	179	85	17	110	48	5
202311	E-services	201606	1	0	0	0	1	1	0	0	180	86	17	111	49	5
202311	E-services	201608	1	0	0	0	1	1	0	0	181	87	17	112	50	5
202311	E-services	201609	2	1	0	0	2	1	1	0	183	88	18	113	50	5
202311	E-services	201701	4	0	0	0	2	0	0	0	187	90	18	113	50	5
202311	E-services	201705	3	1	0	0	3	2	1	0	190	93	19	115	52	5
202311	E-services	201706	1	0	0	0	1	1	0	0	191	94	19	116	53	5
202311	E-services	201707	8	0	0	0	4	4	0	0	199	97	19	124	56	5
202311	E-services	201709	1	0	0	0	1	1	0	0	200	98	19	125	57	5
202311	E-services	201712	1	0	0	0	1	1	0	0	201	99	19	126	58	5
202311	E-services	201801	3	0	0	0	3	2	0	0	204	102	19	128	60	5
202311	E-services	201802	8	1	0	0	3	3	1	0	212	105	20	136	63	6
202311	E-services	201804	2	0	0	0	2	2	0	0	214	106	20	138	64	6
490458	EAP	200404	3	0	0	0	2	1	0	0	3	2	0	2	1	0
490458	EAP	200406	1	0	0	0	1	0	0	0	4	3	0	2	1	0
490458	EAP	200407	1	0	0	0	1	1	0	0	5	4	0	3	2	0
490458	EAP	200409	1	0	0	0	1	1	0	0	6	5	0	4	3	0
490458	EAP	200411	1	0	0	0	1	0	0	0	7	6	0	4	3	0
490458	EAP	200412	1	0	0	0	1	0	0	0	8	7	0	4	3	0
490458	EAP	200501	2	0	0	0	2	1	0	0	10	9	0	5	4	0
490458	EAP	200502	1	0	0	0	1	1	0	0	11	10	0	6	5	0
490458	EAP	200504	3	0	0	0	3	2	0	0	14	13	0	8	7	0
490458	EAP	200505	2	1	0	0	2	1	1	0	16	15	1	9	8	0
490458	EAP	200506	1	0	0	0	1	0	0	0	17	16	1	9	8	0
490458	EAP	200507	3	0	0	0	2	1	0	0	20	17	1	10	8	0
490458	EAP	200511	1	0	0	0	1	1	0	0	21	18	1	11	9	0
490458	EAP	200512	1	0	0	0	1	0	0	0	22	19	1	11	9	0
490458	EAP	200601	1	0	0	0	1	1	0	0	23	20	1	12	10	0
490458	EAP	200602	2	0	0	0	2	2	0	0	25	22	1	14	12	0
490458	EAP	200603	4	0	0	0	3	2	0	0	29	25	1	16	14	0
490458	EAP	200605	2	0	0	0	1	1	0	0	31	26	1	18	15	0
490458	EAP	200608	1	0	0	0	1	1	0	0	32	27	1	19	16	0
490458	EAP	200609	5	0	0	0	5	4	0	0	37	31	1	23	19	0
490458	EAP	200610	2	1	0	0	2	2	1	0	39	33	2	25	21	0
490458	EAP	200611	2	0	0	0	2	0	0	0	41	35	2	25	21	0
490458	EAP	200612	3	0	0	0	3	2	0	0	44	38	2	27	23	0
490458	EAP	200701	2	0	0	0	2	2	0	0	46	40	2	29	25	0
490458	EAP	200703	1	0	0	0	1	1	0	0	47	41	2	30	26	0
490458	EAP	200704	1	0	0	0	1	1	0	0	48	42	2	31	27	0
490458	EAP	200705	2	0	0	0	2	2	0	0	50	44	2	33	29	0
490458	EAP	200706	1	0	0	0	1	1	0	0	51	45	2	34	30	0
490458	EAP	200707	1	0	0	0	1	0	0	0	52	46	2	34	30	0
490458	EAP	200709	2	0	0	0	2	1	0	0	54	48	2	35	31	0
490458	EAP	200710	2	0	0	0	2	0	0	0	56	50	2	35	31	0
490458	EAP	200711	1	0	0	0	1	1	0	0	57	51	2	36	32	0
490458	EAP	200801	1	0	0	0	1	0	0	0	58	52	2	36	32	0
490458	EAP	200802	3	1	0	0	3	2	1	0	61	55	3	38	34	0
490458	EAP	200805	2	1	0	0	2	1	1	0	63	56	4	39	34	0
490458	EAP	200810	1	0	0	0	1	1	0	0	64	57	4	40	35	0
490458	EAP	200812	1	0	0	0	1	1	0	0	65	58	4	41	36	0
490458	EAP	200902	1	0	0	0	1	1	0	0	66	59	4	42	37	0
490458	EAP	200903	2	0	0	0	1	1	0	0	68	60	4	44	38	0
490458	EAP	200904	4	0	0	0	2	1	0	0	72	61	4	45	38	0
490458	EAP	200906	1	0	0	0	1	1	0	0	73	62	4	46	39	0
490458	EAP	200907	1	0	0	0	1	1	0	0	74	63	4	47	40	0
490458	EAP	200911	1	0	0	0	1	0	0	0	75	64	4	47	40	0
490458	EAP	201003	1	0	0	0	1	0	0	0	76	65	4	47	40	0
490458	EAP	201005	1	0	0	0	1	0	0	0	77	66	4	47	40	0
490458	EAP	201010	1	0	0	0	1	1	0	0	78	67	4	48	41	0
490458	EAP	201011	1	0	0	0	1	1	0	0	79	68	4	49	42	0
490458	EAP	201101	1	0	0	0	1	1	0	0	80	69	4	50	43	0
490458	EAP	201105	3	0	0	0	2	2	0	0	83	71	4	53	45	0
490458	EAP	201106	1	0	0	0	1	1	0	0	84	72	4	54	46	0
490458	EAP	201108	1	0	0	0	1	1	0	0	85	73	4	55	47	0
490458	EAP	201204	2	0	0	0	2	2	0	0	87	74	4	57	48	0
490458	EAP	201209	2	0	0	0	2	1	0	0	89	76	4	58	49	0
490458	EAP	201301	1	0	0	0	1	1	0	0	90	77	4	59	50	0
490458	EAP	201302	1	0	0	0	1	0	0	0	91	78	4	59	50	0
490458	EAP	201401	1	0	0	0	1	1	0	0	92	79	4	60	51	0
490458	EAP	201403	1	0	0	0	1	1	0	0	93	80	4	61	52	0
490458	EAP	201405	1	0	0	0	1	1	0	0	94	81	4	62	53	0
490458	EAP	201412	5	2	0	0	4	3	2	0	99	85	6	65	56	0
490458	EAP	201508	2	1	0	0	2	2	1	0	101	87	7	67	58	1
490458	EAP	201509	1	0	0	0	1	1	0	0	102	88	7	68	59	1
490458	EAP	201512	1	0	0	0	1	0	0	0	103	89	7	68	59	1
490458	EAP	201602	1	0	0	0	1	1	0	0	104	90	7	69	60	1
490458	EAP	201604	2	0	0	0	1	1	0	0	106	91	7	71	61	1
490458	EAP	201608	1	0	0	0	1	1	0	0	107	92	7	72	62	1
490458	EAP	201610	2	2	0	0	2	1	2	0	109	94	9	73	63	2
490458	EAP	201703	3	1	0	0	3	3	1	0	112	97	10	76	66	3
490458	EAP	201711	2	0	0	0	2	2	0	0	114	99	10	78	68	3
490458	EAP	201806	3	0	0	0	2	0	0	0	117	101	10	78	68	3
5276122	Edge_computing	200606	5	0	0	0	1	1	0	0	5	1	0	5	1	0
5276122	Edge_computing	200607	3	0	0	0	2	1	0	0	8	3	0	6	2	0
5276122	Edge_computing	200609	3	0	0	0	3	3	0	0	11	6	0	9	5	0
5276122	Edge_computing	200610	2	0	0	0	2	2	0	0	13	7	0	11	6	0
5276122	Edge_computing	200611	2	0	0	0	2	2	0	0	15	9	0	13	8	0
5276122	Edge_computing	200701	2	0	0	0	2	1	0	0	17	11	0	14	9	0
5276122	Edge_computing	200704	1	0	0	0	1	1	0	0	18	11	0	15	9	0
5276122	Edge_computing	200705	5	0	0	0	3	1	0	0	23	13	0	16	9	0
5276122	Edge_computing	200707	1	0	0	0	1	1	0	0	24	14	0	17	10	0
5276122	Edge_computing	200709	1	0	0	0	1	1	0	0	25	15	0	18	11	0
5276122	Edge_computing	200711	4	0	0	0	2	2	0	0	29	17	0	22	13	0
5276122	Edge_computing	200712	3	0	0	0	1	1	0	0	32	18	0	25	14	0
5276122	Edge_computing	200801	1	0	0	0	1	0	0	0	33	19	0	25	14	0
5276122	Edge_computing	200802	1	0	0	0	1	1	0	0	34	20	0	26	15	0
5276122	Edge_computing	200803	2	0	0	0	1	1	0	0	36	21	0	28	16	0
5276122	Edge_computing	200807	3	0	0	0	2	1	0	0	39	23	0	29	17	0
5276122	Edge_computing	200809	1	0	0	0	1	1	0	0	40	24	0	30	18	0
5276122	Edge_computing	200812	1	0	0	0	1	1	0	0	41	25	0	31	19	0
5276122	Edge_computing	200902	2	1	0	0	2	1	1	0	43	27	1	32	20	0
5276122	Edge_computing	200908	2	0	0	0	2	2	0	0	45	28	1	34	21	0
5276122	Edge_computing	200910	1	0	0	0	1	1	0	0	46	29	1	35	22	0
5276122	Edge_computing	201006	1	0	0	0	1	1	0	0	47	29	1	36	22	0
5276122	Edge_computing	201009	1	0	0	0	1	1	0	0	48	30	1	37	23	0
5276122	Edge_computing	201104	2	0	0	0	2	1	0	0	50	32	1	38	24	0
5276122	Edge_computing	201105	2	1	0	0	2	1	1	0	52	34	2	39	25	0
5276122	Edge_computing	201107	2	1	0	0	2	1	1	0	54	36	3	40	26	0
5276122	Edge_computing	201108	2	1	0	0	2	2	1	0	56	38	4	42	28	1
5276122	Edge_computing	201203	2	0	0	0	1	0	0	0	58	39	4	42	28	1
5276122	Edge_computing	201208	1	0	0	0	1	1	0	0	59	40	4	43	29	1
5276122	Edge_computing	201305	1	0	0	0	1	1	0	0	60	41	4	44	30	1
5276122	Edge_computing	201308	2	0	0	0	1	0	0	0	62	42	4	44	30	1
5276122	Edge_computing	201310	4	0	0	0	3	3	0	0	66	45	4	48	33	1
5276122	Edge_computing	201312	1	0	0	0	1	1	0	0	67	46	4	49	34	1
5276122	Edge_computing	201402	1	0	0	0	1	0	0	0	68	47	4	49	34	1
5276122	Edge_computing	201407	1	0	0	0	1	1	0	0	69	48	4	50	35	1
5276122	Edge_computing	201408	3	0	0	0	2	1	0	0	72	50	4	51	36	1
5276122	Edge_computing	201412	1	0	0	0	1	1	0	0	73	51	4	52	37	1
5276122	Edge_computing	201501	1	0	0	0	1	1	0	0	74	52	4	53	38	1
5276122	Edge_computing	201506	1	0	0	0	1	1	0	0	75	52	4	54	38	1
5276122	Edge_computing	201507	1	0	0	0	1	1	0	0	76	53	4	55	39	1
5276122	Edge_computing	201509	2	0	0	0	2	1	0	0	78	55	4	56	40	1
5276122	Edge_computing	201511	4	0	0	0	3	2	0	0	82	57	4	58	41	1
5276122	Edge_computing	201601	3	0	0	0	2	2	0	0	85	59	4	61	43	1
5276122	Edge_computing	201602	2	0	0	0	2	2	0	0	87	60	4	63	44	1
5276122	Edge_computing	201603	1	0	0	0	1	1	0	0	88	61	4	64	45	1
5276122	Edge_computing	201605	4	0	0	0	3	3	0	0	92	63	4	68	47	1
5276122	Edge_computing	201609	2	0	0	0	1	0	0	0	94	64	4	68	47	1
5276122	Edge_computing	201610	4	1	0	0	3	1	1	0	98	67	5	69	48	1
5276122	Edge_computing	201611	2	0	0	0	2	2	0	0	100	69	5	71	50	1
5276122	Edge_computing	201612	4	2	0	0	4	3	2	0	104	73	7	74	53	2
5276122	Edge_computing	201703	6	1	0	0	4	3	1	0	110	77	8	78	56	2
5276122	Edge_computing	201704	1	0	0	0	1	0	0	0	111	78	8	78	56	2
5276122	Edge_computing	201705	2	0	0	0	1	0	0	0	113	79	8	78	56	2
5276122	Edge_computing	201706	4	0	0	0	1	0	0	0	117	80	8	78	56	2
5276122	Edge_computing	201707	2	0	0	0	2	2	0	0	119	82	8	80	58	2
5276122	Edge_computing	201708	3	0	0	0	2	0	0	0	122	84	8	80	58	2
5276122	Edge_computing	201709	1	0	0	0	1	0	0	0	123	85	8	80	58	2
5276122	Edge_computing	201710	8	1	0	0	6	4	1	0	131	91	9	86	62	2
5276122	Edge_computing	201711	5	0	0	0	2	1	0	0	136	93	9	89	63	2
5276122	Edge_computing	201712	1	0	0	0	1	1	0	0	137	94	9	90	64	2
5276122	Edge_computing	201802	2	0	0	0	1	0	0	0	139	95	9	90	64	2
5276122	Edge_computing	201803	2	0	0	0	2	1	0	0	141	97	9	91	65	2
5276122	Edge_computing	201804	6	2	0	0	6	4	2	0	147	102	11	95	68	3
5276122	Edge_computing	201805	1	0	0	0	1	1	0	0	148	103	11	96	69	3
5276122	Edge_computing	201806	14	0	0	0	4	3	0	0	162	107	11	109	72	3
5276122	Edge_computing	201807	5	0	0	0	3	2	0	0	167	110	11	113	74	3
550485	Electronic_Product_Code	200407	5	0	0	0	1	1	0	0	5	1	0	5	1	0
550485	Electronic_Product_Code	200410	8	0	0	0	4	1	0	0	13	5	0	6	2	0
550485	Electronic_Product_Code	200505	1	0	0	0	1	1	0	0	14	6	0	7	3	0
550485	Electronic_Product_Code	200506	1	0	0	0	1	0	0	0	15	7	0	7	3	0
550485	Electronic_Product_Code	200509	4	0	0	0	4	1	0	0	19	10	0	8	4	0
550485	Electronic_Product_Code	200510	2	1	0	0	2	1	1	0	21	12	1	9	5	0
550485	Electronic_Product_Code	200511	2	0	0	0	1	1	0	0	23	13	1	11	6	0
550485	Electronic_Product_Code	200512	1	0	0	0	1	0	0	0	24	14	1	11	6	0
550485	Electronic_Product_Code	200601	1	0	0	0	1	0	0	0	25	15	1	11	6	0
550485	Electronic_Product_Code	200602	4	0	0	0	3	2	0	0	29	18	1	13	8	0
550485	Electronic_Product_Code	200604	3	0	0	0	2	2	0	0	32	19	1	16	9	0
550485	Electronic_Product_Code	200605	1	0	0	0	1	1	0	0	33	20	1	17	10	0
550485	Electronic_Product_Code	200606	6	2	1	0	3	3	2	1	39	22	3	23	12	2
550485	Electronic_Product_Code	200608	1	0	0	0	1	1	0	0	40	23	3	24	13	2
550485	Electronic_Product_Code	200610	2	0	0	0	2	1	0	0	42	25	3	25	14	2
550485	Electronic_Product_Code	200612	2	1	0	0	2	1	1	0	44	27	4	26	15	2
550485	Electronic_Product_Code	200701	2	0	0	0	2	1	0	0	46	29	4	27	16	2
550485	Electronic_Product_Code	200704	7	1	0	0	4	3	1	0	53	33	5	33	19	3
550485	Electronic_Product_Code	200705	1	0	0	0	1	1	0	0	54	34	5	34	20	3
550485	Electronic_Product_Code	200706	2	0	0	0	2	2	0	0	56	36	5	36	22	3
550485	Electronic_Product_Code	200708	1	0	0	0	1	0	0	0	57	37	5	36	22	3
550485	Electronic_Product_Code	200710	1	0	0	0	1	1	0	0	58	38	5	37	23	3
550485	Electronic_Product_Code	200711	2	0	0	0	2	1	0	0	60	39	5	38	23	3
550485	Electronic_Product_Code	200803	2	0	0	0	2	0	0	0	62	41	5	38	23	3
550485	Electronic_Product_Code	200804	5	0	0	0	4	1	0	0	67	45	5	39	24	3
550485	Electronic_Product_Code	200806	1	0	0	0	1	1	0	0	68	46	5	40	25	3
550485	Electronic_Product_Code	200808	2	0	0	0	2	1	0	0	70	48	5	41	26	3
550485	Electronic_Product_Code	200810	1	0	0	0	1	0	0	0	71	49	5	41	26	3
550485	Electronic_Product_Code	200905	2	1	0	0	2	2	1	0	73	50	6	43	27	4
550485	Electronic_Product_Code	200907	1	0	0	0	1	0	0	0	74	51	6	43	27	4
550485	Electronic_Product_Code	200910	1	0	0	0	1	1	0	0	75	52	6	44	28	4
550485	Electronic_Product_Code	200912	1	0	0	0	1	1	0	0	76	53	6	45	29	4
550485	Electronic_Product_Code	201002	2	0	0	0	2	1	0	0	78	55	6	46	30	4
550485	Electronic_Product_Code	201005	2	1	0	0	2	1	1	0	80	57	7	47	31	4
550485	Electronic_Product_Code	201006	3	0	0	0	1	1	0	0	83	58	7	50	32	4
550485	Electronic_Product_Code	201007	2	0	0	0	1	1	0	0	85	59	7	52	33	4
550485	Electronic_Product_Code	201008	2	0	0	0	2	2	0	0	87	61	7	54	35	4
550485	Electronic_Product_Code	201009	1	0	0	0	1	1	0	0	88	62	7	55	36	4
550485	Electronic_Product_Code	201104	6	0	0	0	2	2	0	0	94	64	7	61	38	4
550485	Electronic_Product_Code	201202	1	0	0	0	1	0	0	0	95	65	7	61	38	4
550485	Electronic_Product_Code	201204	1	0	0	0	1	1	0	0	96	66	7	62	39	4
550485	Electronic_Product_Code	201207	1	0	0	0	1	1	0	0	97	67	7	63	40	4
550485	Electronic_Product_Code	201209	1	0	0	0	1	1	0	0	98	68	7	64	41	4
550485	Electronic_Product_Code	201301	1	0	0	0	1	1	0	0	99	69	7	65	42	4
550485	Electronic_Product_Code	201302	1	0	0	0	1	1	0	0	100	69	7	66	42	4
550485	Electronic_Product_Code	201401	1	0	0	0	1	1	0	0	101	70	7	67	43	4
550485	Electronic_Product_Code	201402	1	0	0	0	1	1	0	0	102	71	7	68	44	4
550485	Electronic_Product_Code	201405	3	0	0	0	2	2	0	0	105	72	7	71	45	4
550485	Electronic_Product_Code	201411	1	0	0	0	1	1	0	0	106	73	7	72	46	4
550485	Electronic_Product_Code	201504	1	0	0	0	1	1	0	0	107	74	7	73	47	4
550485	Electronic_Product_Code	201603	1	0	0	0	1	1	0	0	108	75	7	74	48	4
550485	Electronic_Product_Code	201612	2	0	0	0	1	1	0	0	110	76	7	76	49	4
550485	Electronic_Product_Code	201703	1	0	0	0	1	1	0	0	111	77	7	77	50	4
550485	Electronic_Product_Code	201707	1	0	0	0	1	1	0	0	112	78	7	78	51	4
550485	Electronic_Product_Code	201708	2	0	0	0	2	2	0	0	114	80	7	80	53	4
550485	Electronic_Product_Code	201709	1	0	0	0	1	1	0	0	115	81	7	81	54	4
550485	Electronic_Product_Code	201710	1	0	0	0	1	1	0	0	116	82	7	82	55	4
550485	Electronic_Product_Code	201802	1	0	0	0	1	1	0	0	117	83	7	83	56	4
550485	Electronic_Product_Code	201803	1	0	0	0	1	0	0	0	118	84	7	83	56	4
1262466	Electronic_identification	200511	2	0	0	0	1	1	0	0	2	1	0	2	1	0
1262466	Electronic_identification	200601	2	0	0	0	1	1	0	0	4	2	0	4	2	0
1262466	Electronic_identification	200605	1	0	0	0	1	0	0	0	5	3	0	4	2	0
1262466	Electronic_identification	200607	2	0	0	0	2	1	0	0	7	5	0	5	3	0
1262466	Electronic_identification	200609	1	0	0	0	1	0	0	0	8	6	0	5	3	0
1262466	Electronic_identification	200610	1	0	0	0	1	0	0	0	9	7	0	5	3	0
1262466	Electronic_identification	200611	1	1	0	0	1	1	1	0	10	8	1	6	4	0
1262466	Electronic_identification	200701	2	0	0	0	2	2	0	0	12	10	1	8	6	0
1262466	Electronic_identification	200702	2	1	0	0	2	1	1	0	14	12	2	9	7	0
1262466	Electronic_identification	200705	4	0	0	0	2	1	0	0	18	14	2	12	8	0
1262466	Electronic_identification	200711	1	0	0	0	1	1	0	0	19	15	2	13	9	0
1262466	Electronic_identification	200807	1	0	0	0	1	1	0	0	20	16	2	14	10	0
1262466	Electronic_identification	200810	1	0	0	0	1	1	0	0	21	17	2	15	11	0
1262466	Electronic_identification	200901	1	0	0	0	1	1	0	0	22	18	2	16	12	0
1262466	Electronic_identification	200903	2	0	0	0	2	1	0	0	24	20	2	17	13	0
1262466	Electronic_identification	200906	3	0	0	0	1	1	0	0	27	21	2	20	14	0
1262466	Electronic_identification	200907	2	0	0	0	2	2	0	0	29	23	2	22	16	0
1262466	Electronic_identification	200909	4	0	0	0	1	1	0	0	33	24	2	26	17	0
1262466	Electronic_identification	200910	1	0	0	0	1	1	0	0	34	25	2	27	18	0
1262466	Electronic_identification	200911	1	0	0	0	1	1	0	0	35	26	2	28	19	0
1262466	Electronic_identification	201001	1	0	0	0	1	1	0	0	36	26	2	29	19	0
1262466	Electronic_identification	201002	1	0	0	0	1	1	0	0	37	27	2	30	20	0
1262466	Electronic_identification	201007	6	0	0	0	2	1	0	0	43	28	2	31	20	0
1262466	Electronic_identification	201009	3	1	0	0	3	2	1	0	46	31	3	33	22	0
1262466	Electronic_identification	201010	1	0	0	0	1	1	0	0	47	32	3	34	23	0
1262466	Electronic_identification	201012	1	0	0	0	1	1	0	0	48	32	3	35	23	0
1262466	Electronic_identification	201102	1	0	0	0	1	0	0	0	49	33	3	35	23	0
1262466	Electronic_identification	201103	4	0	0	0	2	2	0	0	53	35	3	39	25	0
1262466	Electronic_identification	201105	1	0	0	0	1	1	0	0	54	36	3	40	26	0
1262466	Electronic_identification	201107	1	0	0	0	1	0	0	0	55	37	3	40	26	0
1262466	Electronic_identification	201109	1	0	0	0	1	0	0	0	56	38	3	40	26	0
1262466	Electronic_identification	201110	1	0	0	0	1	1	0	0	57	39	3	41	27	0
1262466	Electronic_identification	201204	1	0	0	0	1	1	0	0	58	40	3	42	28	0
1262466	Electronic_identification	201205	1	0	0	0	1	1	0	0	59	41	3	43	29	0
1262466	Electronic_identification	201206	2	0	0	0	2	1	0	0	61	43	3	44	30	0
1262466	Electronic_identification	201207	2	0	0	0	2	0	0	0	63	45	3	44	30	0
1262466	Electronic_identification	201208	1	0	0	0	1	1	0	0	64	46	3	45	31	0
1262466	Electronic_identification	201210	1	0	0	0	1	1	0	0	65	47	3	46	32	0
1262466	Electronic_identification	201211	1	0	0	0	1	1	0	0	66	48	3	47	33	0
1262466	Electronic_identification	201212	24	0	0	0	4	4	0	0	90	52	3	71	37	0
1262466	Electronic_identification	201301	4	1	0	0	4	4	1	0	94	56	4	75	41	1
1262466	Electronic_identification	201302	1	0	0	0	1	1	0	0	95	57	4	76	42	1
1262466	Electronic_identification	201303	5	0	0	0	5	4	0	0	100	60	4	80	44	1
1262466	Electronic_identification	201304	1	0	0	0	1	1	0	0	101	61	4	81	45	1
1262466	Electronic_identification	201305	1	0	0	0	1	0	0	0	102	62	4	81	45	1
1262466	Electronic_identification	201306	1	0	0	0	1	1	0	0	103	62	4	82	45	1
1262466	Electronic_identification	201309	4	0	0	0	2	0	0	0	107	64	4	82	45	1
1262466	Electronic_identification	201311	10	0	0	0	1	0	0	0	117	65	4	82	45	1
1262466	Electronic_identification	201401	1	0	0	0	1	0	0	0	118	66	4	82	45	1
1262466	Electronic_identification	201402	5	0	0	0	4	2	0	0	123	70	4	84	47	1
1262466	Electronic_identification	201404	2	0	0	0	1	1	0	0	125	71	4	86	48	1
1262466	Electronic_identification	201405	1	0	0	0	1	0	0	0	126	72	4	86	48	1
1262466	Electronic_identification	201406	5	0	0	0	3	1	0	0	131	75	4	87	49	1
1262466	Electronic_identification	201407	9	0	0	0	7	2	0	0	140	80	4	89	50	1
1262466	Electronic_identification	201409	1	0	0	0	1	1	0	0	141	81	4	90	51	1
1262466	Electronic_identification	201411	1	0	0	0	1	1	0	0	142	82	4	91	52	1
1262466	Electronic_identification	201412	1	0	0	0	1	1	0	0	143	83	4	92	53	1
1262466	Electronic_identification	201501	1	0	0	0	1	1	0	0	144	84	4	93	54	1
1262466	Electronic_identification	201502	3	0	0	0	3	1	0	0	147	87	4	94	55	1
1262466	Electronic_identification	201503	3	0	0	0	3	2	0	0	150	89	4	96	56	1
1262466	Electronic_identification	201505	1	0	0	0	1	1	0	0	151	89	4	97	56	1
1262466	Electronic_identification	201506	1	0	0	0	1	1	0	0	152	90	4	98	57	1
1262466	Electronic_identification	201507	3	0	0	0	3	2	0	0	155	93	4	100	59	1
1262466	Electronic_identification	201508	5	0	0	0	3	2	0	0	160	94	4	102	59	1
1262466	Electronic_identification	201509	8	0	0	0	1	1	0	0	168	95	4	110	60	1
1262466	Electronic_identification	201510	6	0	0	0	2	2	0	0	174	96	4	116	61	1
1262466	Electronic_identification	201601	8	0	0	0	4	2	0	0	182	99	4	120	62	1
1262466	Electronic_identification	201602	2	0	0	0	2	1	0	0	184	101	4	121	63	1
1262466	Electronic_identification	201604	1	0	0	0	1	0	0	0	185	102	4	121	63	1
1262466	Electronic_identification	201605	3	0	0	0	3	3	0	0	188	105	4	124	66	1
1262466	Electronic_identification	201606	7	0	0	0	4	4	0	0	195	109	4	131	70	1
1262466	Electronic_identification	201607	1	0	0	0	1	1	0	0	196	110	4	132	71	1
1262466	Electronic_identification	201609	6	0	0	0	3	2	0	0	202	113	4	137	73	1
1262466	Electronic_identification	201612	3	0	0	0	1	1	0	0	205	114	4	140	74	1
1262466	Electronic_identification	201703	1	0	0	0	1	1	0	0	206	115	4	141	75	1
1262466	Electronic_identification	201704	2	0	0	0	2	2	0	0	208	117	4	143	77	1
1262466	Electronic_identification	201706	2	0	0	0	2	2	0	0	210	119	4	145	79	1
1262466	Electronic_identification	201707	1	0	0	0	1	1	0	0	211	120	4	146	80	1
1262466	Electronic_identification	201708	2	0	0	0	2	1	0	0	213	122	4	147	81	1
1262466	Electronic_identification	201709	4	1	0	0	3	3	1	0	217	124	5	151	82	1
1262466	Electronic_identification	201712	3	0	0	0	2	1	0	0	220	125	5	152	82	1
1262466	Electronic_identification	201801	1	0	0	0	1	1	0	0	221	126	5	153	83	1
1262466	Electronic_identification	201802	3	0	0	0	1	1	0	0	224	127	5	156	84	1
1262466	Electronic_identification	201803	2	0	0	0	2	2	0	0	226	129	5	158	86	1
1262466	Electronic_identification	201805	1	0	0	0	1	0	0	0	227	130	5	158	86	1
1262466	Electronic_identification	201806	3	0	0	0	1	1	0	0	230	131	5	161	87	1
1262466	Electronic_identification	201807	18	0	0	0	3	1	0	0	248	133	5	176	87	1
10294	Encryption	200202	1	0	0	0	1	1	0	0	1	1	0	1	1	0
10294	Encryption	200401	1	0	0	0	1	1	0	0	2	2	0	2	1	0
10294	Encryption	200402	3	0	0	0	3	2	0	0	5	5	0	4	3	0
10294	Encryption	200403	2	0	0	0	2	2	0	0	7	7	0	6	5	0
10294	Encryption	200406	2	0	0	0	2	1	0	0	9	9	0	7	6	0
10294	Encryption	200407	4	0	0	0	3	3	0	0	13	12	0	11	9	0
10294	Encryption	200408	10	0	0	0	2	2	0	0	23	13	0	21	10	0
10294	Encryption	200409	6	2	0	0	6	4	2	0	29	18	2	25	13	0
10294	Encryption	200410	5	0	0	0	5	4	0	0	34	21	2	29	15	0
10294	Encryption	200411	8	0	0	0	4	4	0	0	42	24	2	37	18	0
10294	Encryption	200412	1	0	0	0	1	1	0	0	43	25	2	38	19	0
10294	Encryption	200501	13	4	0	0	7	5	2	0	56	31	6	46	23	0
10294	Encryption	200502	11	1	0	0	7	5	1	0	67	37	7	55	27	1
10294	Encryption	200503	7	1	0	0	6	3	1	0	74	41	8	58	28	2
10294	Encryption	200504	30	7	0	0	16	8	4	0	104	56	15	73	35	2
10294	Encryption	200505	9	1	0	0	9	5	1	0	113	63	16	78	38	2
10294	Encryption	200506	8	3	0	0	8	5	3	0	121	69	19	83	41	2
10294	Encryption	200507	7	2	0	0	6	3	2	0	128	74	21	86	43	2
10294	Encryption	200508	5	0	0	0	5	4	0	0	133	78	21	90	46	2
10294	Encryption	200509	10	0	0	0	9	5	0	0	143	85	21	95	49	2
10294	Encryption	200510	3	0	0	0	3	2	0	0	146	86	21	97	49	2
10294	Encryption	200511	13	3	0	0	9	6	3	0	159	93	24	107	53	3
10294	Encryption	200512	16	4	0	0	11	3	3	0	175	104	28	110	56	3
10294	Encryption	200601	10	2	0	0	7	3	1	0	185	110	30	114	58	3
10294	Encryption	200602	19	5	0	0	13	7	4	0	204	121	35	124	63	3
10294	Encryption	200603	18	3	0	0	11	6	3	0	222	130	38	133	67	4
10294	Encryption	200604	18	3	0	0	12	7	2	0	240	140	41	143	72	5
10294	Encryption	200605	11	1	0	0	9	7	1	0	251	149	42	150	79	6
10294	Encryption	200606	22	7	0	0	14	7	3	0	273	160	49	161	83	6
10294	Encryption	200607	15	2	0	0	10	6	2	0	288	169	51	170	88	7
10294	Encryption	200608	8	0	0	0	7	3	0	0	296	176	51	174	91	7
10294	Encryption	200609	5	1	0	0	5	3	1	0	301	179	52	177	92	7
10294	Encryption	200610	24	6	0	0	16	9	4	0	325	194	58	192	100	8
10294	Encryption	200611	30	4	0	0	16	9	4	0	355	207	62	206	106	10
10294	Encryption	200612	43	7	0	0	23	13	5	0	398	224	69	235	113	12
10294	Encryption	200701	18	1	0	0	15	12	1	0	416	234	70	249	120	13
10294	Encryption	200702	23	5	0	0	12	7	5	0	439	243	75	263	124	14
10294	Encryption	200703	29	8	0	0	23	10	8	0	468	265	83	275	133	14
10294	Encryption	200704	14	3	0	0	9	5	2	0	482	273	86	282	137	14
10294	Encryption	200705	22	3	0	0	16	8	3	0	504	286	89	292	142	15
10294	Encryption	200706	34	6	0	0	26	10	6	0	538	310	95	305	150	15
10294	Encryption	200707	11	1	0	0	7	5	1	0	549	315	96	314	153	15
10294	Encryption	200708	11	1	0	0	6	4	1	0	560	320	97	323	156	15
10294	Encryption	200709	8	0	0	0	8	5	0	0	568	326	97	328	159	15
10294	Encryption	200710	11	3	0	0	8	6	3	0	579	334	100	334	165	16
10294	Encryption	200711	19	5	0	0	15	5	5	0	598	349	105	341	170	18
10294	Encryption	200712	14	2	0	0	9	6	2	0	612	357	107	349	175	18
10294	Encryption	200801	4	1	0	0	4	2	1	0	616	360	108	351	176	18
10294	Encryption	200802	13	1	0	0	10	6	1	0	629	369	109	360	181	18
10294	Encryption	200803	8	2	0	0	8	6	2	0	637	377	111	366	187	19
10294	Encryption	200804	2	1	0	0	2	1	1	0	639	378	112	367	187	19
10294	Encryption	200805	15	5	0	0	11	5	4	0	654	386	117	373	189	20
10294	Encryption	200806	6	3	0	0	6	3	3	0	660	390	120	376	190	20
10294	Encryption	200807	2	0	0	0	1	0	0	0	662	391	120	376	190	20
10294	Encryption	200808	16	5	0	0	13	9	5	0	678	403	125	388	198	23
10294	Encryption	200809	3	0	0	0	2	1	0	0	681	405	125	390	199	23
10294	Encryption	200810	15	2	0	0	10	6	2	0	696	415	127	396	205	23
10294	Encryption	200811	18	8	3	2	12	8	6	2	714	426	135	406	212	25
10294	Encryption	200812	8	1	0	0	5	2	1	0	722	430	136	408	213	26
10294	Encryption	200901	16	4	0	0	11	6	3	0	738	440	140	416	218	26
10294	Encryption	200902	8	1	0	0	7	3	1	0	746	446	141	419	220	26
10294	Encryption	200903	10	3	0	0	7	5	2	0	756	451	144	426	223	26
10294	Encryption	200904	6	3	0	0	6	3	3	0	762	455	147	429	224	27
10294	Encryption	200905	8	4	2	1	6	3	3	2	770	460	151	434	226	30
10294	Encryption	200906	8	3	1	0	3	2	2	1	778	460	154	441	226	32
10294	Encryption	200907	17	2	0	0	11	10	2	0	795	467	156	456	233	33
10294	Encryption	200908	6	0	0	0	3	3	0	0	801	470	156	462	236	33
10294	Encryption	200909	3	1	0	0	3	2	1	0	804	472	157	464	237	33
10294	Encryption	200910	11	4	0	0	7	4	2	0	815	477	161	472	239	34
10294	Encryption	200911	9	4	0	0	6	2	1	0	824	482	165	477	240	34
10294	Encryption	200912	15	4	0	0	11	7	4	0	839	489	169	487	243	34
10294	Encryption	201001	17	4	0	0	13	10	3	0	856	499	173	501	250	35
10294	Encryption	201002	2	1	0	0	2	1	1	0	858	501	174	502	251	35
10294	Encryption	201003	4	0	0	0	4	4	0	0	862	504	174	506	254	35
10294	Encryption	201004	3	1	0	0	3	2	1	0	865	506	175	508	255	35
10294	Encryption	201005	4	1	0	0	3	1	1	0	869	508	176	509	255	35
10294	Encryption	201006	7	4	0	0	6	2	3	0	876	512	180	512	255	36
10294	Encryption	201007	10	4	0	0	8	5	3	0	886	516	184	518	256	36
10294	Encryption	201008	3	0	0	0	3	3	0	0	889	519	184	521	259	36
10294	Encryption	201009	3	0	0	0	3	2	0	0	892	522	184	523	261	36
10294	Encryption	201010	18	8	0	0	8	5	5	0	910	529	192	531	265	36
10294	Encryption	201011	6	2	0	0	5	4	2	0	916	533	194	536	268	37
10294	Encryption	201012	8	4	0	0	7	4	3	0	924	539	198	541	271	38
10294	Encryption	201102	1	0	0	0	1	1	0	0	925	540	198	542	272	38
10294	Encryption	201103	8	0	0	0	6	4	0	0	933	545	198	546	275	38
10294	Encryption	201104	7	2	0	0	6	3	2	0	940	549	200	549	276	38
10294	Encryption	201105	6	2	0	0	6	3	2	0	946	552	202	552	276	38
10294	Encryption	201106	12	3	0	0	10	7	3	0	958	558	205	561	279	38
10294	Encryption	201107	4	1	0	0	3	2	1	0	962	560	206	563	280	38
10294	Encryption	201108	7	1	0	0	5	3	1	0	969	563	207	566	281	38
10294	Encryption	201109	4	0	0	0	3	2	0	0	973	566	207	569	283	38
10294	Encryption	201110	1	0	0	0	1	1	0	0	974	567	207	570	284	38
10294	Encryption	201111	3	1	0	0	3	1	1	0	977	569	208	571	284	38
10294	Encryption	201112	11	2	0	0	5	3	2	0	988	571	210	574	285	39
10294	Encryption	201201	6	2	0	0	6	5	2	0	994	576	212	579	289	40
10294	Encryption	201203	9	3	0	0	7	3	3	0	1003	581	215	582	290	40
10294	Encryption	201204	10	2	0	0	7	3	1	0	1013	587	217	587	292	40
10294	Encryption	201205	5	1	0	0	4	3	1	0	1018	589	218	591	293	40
10294	Encryption	201206	6	2	0	0	4	2	2	0	1024	591	220	593	293	40
10294	Encryption	201207	1	0	0	0	1	0	0	0	1025	592	220	593	293	40
10294	Encryption	201208	5	0	0	0	3	1	0	0	1030	595	220	594	294	40
10294	Encryption	201209	4	2	0	0	4	2	2	0	1034	598	222	596	295	40
10294	Encryption	201210	4	1	0	0	4	1	1	0	1038	601	223	597	295	40
10294	Encryption	201211	13	7	0	0	11	6	7	0	1051	610	230	605	299	43
10294	Encryption	201212	8	4	0	0	6	3	3	0	1059	614	234	609	300	43
10294	Encryption	201301	6	0	0	0	4	2	0	0	1065	618	234	612	302	43
10294	Encryption	201302	4	1	0	0	3	2	1	0	1069	620	235	615	303	43
10294	Encryption	201303	10	1	0	0	4	3	1	0	1079	624	236	624	305	43
10294	Encryption	201304	10	4	0	0	6	4	4	0	1089	628	240	629	307	44
10294	Encryption	201305	18	4	0	0	7	7	3	0	1107	633	244	647	312	48
10294	Encryption	201306	5	2	0	0	4	2	2	0	1112	636	246	649	313	48
10294	Encryption	201307	8	3	0	0	4	3	2	0	1120	640	249	653	316	48
10294	Encryption	201308	10	3	0	0	7	4	3	0	1130	646	252	657	319	48
10294	Encryption	201309	6	3	0	0	6	4	3	0	1136	651	255	661	322	49
10294	Encryption	201310	7	3	0	0	6	3	3	0	1143	656	258	664	324	49
10294	Encryption	201311	10	1	0	0	8	5	1	0	1153	663	259	671	328	49
10294	Encryption	201312	41	5	1	0	15	8	5	1	1194	675	264	688	333	51
10294	Encryption	201401	19	4	0	0	12	6	4	0	1213	687	268	696	339	51
10294	Encryption	201402	28	10	0	0	16	8	6	0	1241	699	278	709	343	52
10294	Encryption	201403	18	5	0	0	13	8	3	0	1259	709	283	720	348	52
10294	Encryption	201404	7	3	0	0	7	4	3	0	1266	715	286	724	351	52
10294	Encryption	201405	8	4	1	0	5	3	3	1	1274	719	290	728	353	53
10294	Encryption	201406	6	2	0	0	6	2	2	0	1280	724	292	730	354	53
10294	Encryption	201407	22	6	0	0	14	10	5	0	1302	735	298	744	361	54
10294	Encryption	201408	12	4	0	0	7	4	4	0	1314	741	302	748	364	54
10294	Encryption	201409	2	0	0	0	1	0	0	0	1316	742	302	748	364	54
10294	Encryption	201410	7	2	0	0	6	3	2	0	1323	748	304	752	367	54
10294	Encryption	201411	3	1	0	0	3	2	1	0	1326	750	305	754	368	54
10294	Encryption	201412	4	0	0	0	3	2	0	0	1330	751	305	756	368	54
10294	Encryption	201501	3	0	0	0	2	1	0	0	1333	753	305	757	369	54
10294	Encryption	201502	9	2	0	0	4	2	2	0	1342	756	307	759	370	54
10294	Encryption	201503	9	2	0	0	7	5	2	0	1351	762	309	764	374	54
10294	Encryption	201504	4	1	0	0	3	1	1	0	1355	765	310	765	375	54
10294	Encryption	201505	25	9	0	0	14	7	7	0	1380	778	319	774	381	54
10294	Encryption	201506	5	0	0	0	3	2	0	0	1385	781	319	778	383	54
10294	Encryption	201507	2	1	0	0	2	1	1	0	1387	783	320	779	384	54
10294	Encryption	201508	6	3	0	0	6	5	3	0	1393	786	323	784	385	56
10294	Encryption	201509	12	3	0	0	8	6	3	0	1405	791	326	794	388	58
10294	Encryption	201510	15	6	0	0	13	7	5	0	1420	799	332	802	390	58
10294	Encryption	201511	6	2	0	0	5	3	2	0	1426	803	334	805	392	58
10294	Encryption	201512	7	2	0	0	5	2	2	0	1433	806	336	807	392	58
10294	Encryption	201601	9	3	0	0	8	5	3	0	1442	812	339	812	395	59
10294	Encryption	201602	9	5	0	0	9	7	5	0	1451	820	344	819	399	62
10294	Encryption	201603	23	4	0	0	16	9	3	0	1474	834	348	832	405	63
10294	Encryption	201604	13	4	0	0	9	4	3	0	1487	841	352	838	407	65
10294	Encryption	201605	9	4	0	0	9	6	4	0	1496	847	356	844	409	66
10294	Encryption	201606	12	6	0	0	11	6	5	0	1508	853	362	851	409	67
10294	Encryption	201607	8	4	0	0	8	6	4	0	1516	858	366	857	411	69
10294	Encryption	201608	13	6	0	0	12	7	5	0	1529	865	372	865	413	70
10294	Encryption	201609	13	6	0	0	12	10	5	0	1542	873	378	876	415	74
10294	Encryption	201610	20	7	0	0	14	6	6	0	1562	884	385	884	416	76
10294	Encryption	201611	5	3	0	0	5	3	3	0	1567	887	388	887	417	76
10294	Encryption	201612	29	13	0	0	22	14	9	0	1596	903	401	906	422	82
10294	Encryption	201701	13	3	0	0	12	7	3	0	1609	912	404	914	425	82
10294	Encryption	201702	15	5	0	0	12	7	4	0	1624	921	409	922	428	82
10294	Encryption	201703	14	7	0	0	13	10	7	0	1638	930	416	933	433	86
10294	Encryption	201704	11	3	0	0	9	7	2	0	1649	937	419	941	436	88
10294	Encryption	201705	14	7	0	0	14	8	7	0	1663	947	426	949	440	89
10294	Encryption	201706	6	2	0	0	6	4	2	0	1669	952	428	953	443	89
10294	Encryption	201707	5	1	0	0	5	4	1	0	1674	957	429	957	447	89
10294	Encryption	201708	6	1	0	0	5	3	1	0	1680	962	430	960	450	89
10294	Encryption	201709	4	1	0	0	4	3	1	0	1684	965	431	963	452	89
10294	Encryption	201710	2	0	0	0	1	0	0	0	1686	966	431	963	452	89
10294	Encryption	201711	5	1	0	0	3	2	1	0	1691	969	432	965	454	89
10294	Encryption	201712	9	3	0	0	5	3	2	0	1700	973	435	969	456	89
10294	Encryption	201801	12	2	0	0	11	7	2	0	1712	982	437	976	461	89
10294	Encryption	201802	6	2	0	0	6	3	2	0	1718	986	439	979	462	89
10294	Encryption	201803	14	5	0	0	12	10	5	0	1732	996	444	989	470	90
10294	Encryption	201804	6	2	0	0	5	4	2	0	1738	1000	446	993	472	91
10294	Encryption	201805	7	3	0	0	5	4	2	0	1745	1003	449	999	473	93
10294	Encryption	201806	3	1	0	0	3	3	1	0	1748	1005	450	1002	475	94
10294	Encryption	201807	14	4	0	0	12	6	4	0	1762	1012	454	1008	476	94
6011495	Equal-cost_multi-path_routing	200608	16	0	0	0	1	1	0	0	16	1	0	16	1	0
6011495	Equal-cost_multi-path_routing	200609	1	0	0	0	1	1	0	0	17	2	0	17	2	0
6011495	Equal-cost_multi-path_routing	200612	1	0	0	0	1	0	0	0	18	3	0	17	2	0
6011495	Equal-cost_multi-path_routing	200702	1	0	0	0	1	1	0	0	19	4	0	18	3	0
6011495	Equal-cost_multi-path_routing	200703	2	0	0	0	2	2	0	0	21	6	0	20	5	0
6011495	Equal-cost_multi-path_routing	200709	1	0	0	0	1	0	0	0	22	7	0	20	5	0
6011495	Equal-cost_multi-path_routing	200811	1	0	0	0	1	1	0	0	23	8	0	21	6	0
6011495	Equal-cost_multi-path_routing	200906	1	0	0	0	1	1	0	0	24	9	0	22	7	0
6011495	Equal-cost_multi-path_routing	200909	1	0	0	0	1	1	0	0	25	9	0	23	7	0
6011495	Equal-cost_multi-path_routing	200910	1	0	0	0	1	1	0	0	26	10	0	24	8	0
6011495	Equal-cost_multi-path_routing	200911	1	0	0	0	1	1	0	0	27	11	0	25	9	0
6011495	Equal-cost_multi-path_routing	200912	1	0	0	0	1	0	0	0	28	12	0	25	9	0
6011495	Equal-cost_multi-path_routing	201004	1	0	0	0	1	1	0	0	29	12	0	26	9	0
6011495	Equal-cost_multi-path_routing	201008	2	0	0	0	1	0	0	0	31	13	0	26	9	0
6011495	Equal-cost_multi-path_routing	201012	1	1	0	0	1	1	1	0	32	14	1	27	10	0
6011495	Equal-cost_multi-path_routing	201108	1	0	0	0	1	1	0	0	33	15	1	28	11	0
6011495	Equal-cost_multi-path_routing	201112	1	0	0	0	1	0	0	0	34	16	1	28	11	0
6011495	Equal-cost_multi-path_routing	201205	1	0	0	0	1	1	0	0	35	17	1	29	12	0
6011495	Equal-cost_multi-path_routing	201303	3	1	0	0	3	1	1	0	38	20	2	30	13	0
6011495	Equal-cost_multi-path_routing	201309	1	0	0	0	1	1	0	0	39	21	2	31	14	0
6011495	Equal-cost_multi-path_routing	201311	2	0	0	0	2	1	0	0	41	23	2	32	15	0
6011495	Equal-cost_multi-path_routing	201312	1	0	0	0	1	1	0	0	42	24	2	33	16	0
6011495	Equal-cost_multi-path_routing	201403	1	0	0	0	1	1	0	0	43	25	2	34	17	0
6011495	Equal-cost_multi-path_routing	201405	1	0	0	0	1	1	0	0	44	26	2	35	18	0
6011495	Equal-cost_multi-path_routing	201408	1	0	0	0	1	0	0	0	45	27	2	35	18	0
6011495	Equal-cost_multi-path_routing	201410	1	0	0	0	1	1	0	0	46	28	2	36	19	0
6011495	Equal-cost_multi-path_routing	201503	2	0	0	0	2	0	0	0	48	30	2	36	19	0
6011495	Equal-cost_multi-path_routing	201504	1	0	0	0	1	1	0	0	49	31	2	37	20	0
6011495	Equal-cost_multi-path_routing	201511	1	0	0	0	1	0	0	0	50	32	2	37	20	0
6011495	Equal-cost_multi-path_routing	201603	2	0	0	0	2	2	0	0	52	34	2	39	22	0
6011495	Equal-cost_multi-path_routing	201605	2	0	0	0	2	2	0	0	54	36	2	41	24	0
6011495	Equal-cost_multi-path_routing	201608	1	0	0	0	1	0	0	0	55	37	2	41	24	0
6011495	Equal-cost_multi-path_routing	201609	1	0	0	0	1	1	0	0	56	38	2	42	25	0
6011495	Equal-cost_multi-path_routing	201701	1	0	0	0	1	0	0	0	57	39	2	42	25	0
6011495	Equal-cost_multi-path_routing	201711	1	0	0	0	1	1	0	0	58	40	2	43	26	0
6011495	Equal-cost_multi-path_routing	201806	2	0	0	0	2	2	0	0	60	42	2	45	28	0
41754003	Ethereum	201402	1	0	0	0	1	1	0	0	1	1	0	1	1	0
41754003	Ethereum	201404	1	0	0	0	1	1	0	0	2	2	0	2	2	0
41754003	Ethereum	201406	64	1	0	0	8	7	1	0	66	9	1	65	8	0
41754003	Ethereum	201407	3	0	0	0	3	3	0	0	69	11	1	68	10	0
41754003	Ethereum	201408	10	1	0	0	4	2	1	0	79	14	2	74	11	0
41754003	Ethereum	201409	16	0	0	0	13	5	0	0	95	27	2	79	16	0
41754003	Ethereum	201410	15	0	0	0	6	2	0	0	110	33	2	81	18	0
41754003	Ethereum	201411	8	0	0	0	4	3	0	0	118	37	2	87	21	0
41754003	Ethereum	201412	2	0	0	0	2	1	0	0	120	39	2	88	22	0
41754003	Ethereum	201501	19	0	0	0	7	4	0	0	139	45	2	93	25	0
41754003	Ethereum	201502	10	0	0	0	5	1	0	0	149	50	2	94	26	0
41754003	Ethereum	201503	13	0	0	0	8	5	0	0	162	54	2	101	28	0
41754003	Ethereum	201504	7	0	0	0	4	4	0	0	169	58	2	108	32	0
41754003	Ethereum	201505	4	0	0	0	4	1	0	0	173	62	2	109	33	0
41754003	Ethereum	201506	5	1	0	0	3	2	1	0	178	64	3	113	34	1
41754003	Ethereum	201507	3	0	0	0	2	1	0	0	181	66	3	115	35	1
41754003	Ethereum	201508	18	3	1	0	11	9	3	1	199	74	6	131	41	4
41754003	Ethereum	201509	30	2	0	0	14	13	2	0	229	83	8	159	49	6
41754003	Ethereum	201510	19	3	0	0	11	8	2	0	248	90	11	175	52	9
41754003	Ethereum	201511	8	1	0	0	4	4	1	0	256	92	12	183	54	10
41754003	Ethereum	201512	33	1	0	0	9	6	1	0	289	100	13	209	58	11
41754003	Ethereum	201601	19	0	0	0	6	5	0	0	308	101	13	226	59	11
41754003	Ethereum	201602	8	1	0	0	4	3	1	0	316	103	14	233	60	11
41754003	Ethereum	201603	67	11	5	2	18	12	7	3	383	116	25	292	67	17
41754003	Ethereum	201604	122	7	0	0	30	21	4	0	505	141	32	402	81	22
41754003	Ethereum	201605	99	7	1	0	21	17	5	1	604	153	39	496	90	26
41754003	Ethereum	201606	140	4	0	0	26	24	4	0	744	166	43	634	100	30
41754003	Ethereum	201607	139	11	1	0	22	15	5	1	883	179	54	764	105	39
41754003	Ethereum	201608	105	13	2	0	29	18	9	2	988	202	67	849	114	45
41754003	Ethereum	201609	167	19	6	3	34	25	5	5	1155	226	86	998	128	58
41754003	Ethereum	201610	63	6	1	1	22	19	5	1	1218	237	92	1057	135	64
41754003	Ethereum	201611	40	6	1	0	11	9	3	1	1258	243	98	1092	139	66
41754003	Ethereum	201612	38	1	0	0	17	11	1	0	1296	256	99	1112	146	66
41754003	Ethereum	201701	39	1	0	0	16	11	1	0	1335	266	100	1144	152	67
41754003	Ethereum	201702	42	5	0	0	13	9	4	0	1377	274	105	1180	156	68
41754003	Ethereum	201703	36	1	0	0	15	10	1	0	1413	283	106	1204	161	68
41754003	Ethereum	201704	26	0	0	0	19	12	0	0	1439	298	106	1223	168	68
41754003	Ethereum	201705	34	3	0	0	18	12	3	0	1473	308	109	1249	172	68
41754003	Ethereum	201706	97	14	3	1	32	21	8	2	1570	325	123	1330	180	74
41754003	Ethereum	201707	76	9	0	0	37	31	8	0	1646	351	132	1400	200	80
41754003	Ethereum	201708	56	6	0	0	22	17	5	0	1702	365	138	1450	209	83
41754003	Ethereum	201709	52	8	2	1	24	18	6	2	1754	378	146	1495	216	88
41754003	Ethereum	201710	53	12	0	0	34	20	8	0	1807	406	158	1532	229	91
41754003	Ethereum	201711	18	6	0	0	15	10	4	0	1825	417	164	1544	233	94
41754003	Ethereum	201712	38	9	1	0	23	17	5	1	1863	437	173	1576	246	98
41754003	Ethereum	201801	74	17	0	0	42	32	11	0	1937	472	190	1640	268	110
41754003	Ethereum	201802	206	20	4	2	49	37	8	3	2143	512	210	1833	290	125
41754003	Ethereum	201803	98	21	1	0	43	34	13	1	2241	539	231	1918	306	143
41754003	Ethereum	201804	10	0	0	0	9	9	0	0	2251	543	231	1928	310	143
41754003	Ethereum	201805	26	4	1	0	9	9	3	1	2277	548	235	1954	315	147
41754003	Ethereum	201806	16	3	1	1	12	12	3	1	2293	555	238	1970	322	150
41754003	Ethereum	201807	9	0	0	0	4	4	0	0	2302	558	238	1979	325	150
1543423	Eye_tracking	200503	5	0	0	0	2	1	0	0	5	2	0	1	1	0
1543423	Eye_tracking	200506	3	0	0	0	3	2	0	0	8	5	0	3	3	0
1543423	Eye_tracking	200507	5	0	0	0	4	1	0	0	13	9	0	4	4	0
1543423	Eye_tracking	200509	3	0	0	0	2	0	0	0	16	11	0	4	4	0
1543423	Eye_tracking	200511	3	0	0	0	2	1	0	0	19	12	0	6	5	0
1543423	Eye_tracking	200512	6	0	0	0	5	3	0	0	25	17	0	9	8	0
1543423	Eye_tracking	200601	4	0	0	0	3	2	0	0	29	19	0	12	9	0
1543423	Eye_tracking	200602	3	0	0	0	2	0	0	0	32	21	0	12	9	0
1543423	Eye_tracking	200603	8	1	0	0	7	1	1	0	40	28	1	13	10	0
1543423	Eye_tracking	200604	6	0	0	0	3	0	0	0	46	31	1	13	10	0
1543423	Eye_tracking	200605	6	1	0	0	6	4	1	0	52	37	2	17	14	1
1543423	Eye_tracking	200606	24	2	0	0	8	1	1	0	76	43	4	25	14	1
1543423	Eye_tracking	200607	8	2	0	0	6	2	2	0	84	46	6	27	15	1
1543423	Eye_tracking	200608	10	0	0	0	4	3	0	0	94	49	6	34	17	1
1543423	Eye_tracking	200609	5	1	0	0	3	1	1	0	99	51	7	35	17	1
1543423	Eye_tracking	200610	7	2	0	0	6	2	1	0	106	55	9	38	18	1
1543423	Eye_tracking	200611	4	1	0	0	3	2	1	0	110	57	10	40	19	1
1543423	Eye_tracking	200612	33	3	0	0	4	3	2	0	143	59	13	69	21	3
1543423	Eye_tracking	200701	28	5	0	0	8	7	1	0	171	65	18	95	26	8
1543423	Eye_tracking	200702	7	2	0	0	6	3	2	0	178	70	20	98	28	9
1543423	Eye_tracking	200703	23	1	0	0	6	6	1	0	201	75	21	121	33	10
1543423	Eye_tracking	200704	2	1	0	0	2	1	1	0	203	77	22	122	34	11
1543423	Eye_tracking	200705	5	1	0	0	3	1	1	0	208	79	23	123	34	11
1543423	Eye_tracking	200706	2	0	0	0	2	2	0	0	210	80	23	125	35	11
1543423	Eye_tracking	200707	14	0	0	0	5	4	0	0	224	84	23	138	38	11
1543423	Eye_tracking	200708	16	0	0	0	5	2	0	0	240	89	23	142	40	11
1543423	Eye_tracking	200709	3	0	0	0	2	2	0	0	243	91	23	145	42	11
1543423	Eye_tracking	200710	3	1	0	0	3	2	1	0	246	93	24	147	43	11
1543423	Eye_tracking	200711	2	0	0	0	2	1	0	0	248	95	24	148	44	11
1543423	Eye_tracking	200712	4	1	0	0	3	1	1	0	252	97	25	150	44	11
1543423	Eye_tracking	200801	3	0	0	0	3	1	0	0	255	100	25	151	45	11
1543423	Eye_tracking	200802	2	0	0	0	1	0	0	0	257	101	25	151	45	11
1543423	Eye_tracking	200803	5	2	0	0	5	3	2	0	262	106	27	154	48	11
1543423	Eye_tracking	200804	5	0	0	0	5	2	0	0	267	110	27	156	49	11
1543423	Eye_tracking	200805	6	0	0	0	4	1	0	0	273	113	27	157	49	11
1543423	Eye_tracking	200806	7	1	0	0	4	3	1	0	280	117	28	163	52	11
1543423	Eye_tracking	200807	6	2	0	0	3	1	1	0	286	119	30	167	52	11
1543423	Eye_tracking	200808	3	0	0	0	1	1	0	0	289	119	30	170	52	11
1543423	Eye_tracking	200809	2	0	0	0	2	1	0	0	291	121	30	171	53	11
1543423	Eye_tracking	200811	4	0	0	0	3	3	0	0	295	123	30	175	55	11
1543423	Eye_tracking	200812	2	0	0	0	2	1	0	0	297	124	30	176	55	11
1543423	Eye_tracking	200901	5	0	0	0	3	3	0	0	302	126	30	181	57	11
1543423	Eye_tracking	200902	9	0	0	0	4	4	0	0	311	130	30	190	61	11
1543423	Eye_tracking	200903	2	0	0	0	2	2	0	0	313	132	30	192	63	11
1543423	Eye_tracking	200904	3	0	0	0	3	2	0	0	316	134	30	194	64	11
1543423	Eye_tracking	200905	4	1	0	0	4	2	1	0	320	138	31	196	66	12
1543423	Eye_tracking	200906	19	1	0	0	4	0	1	0	339	142	32	196	66	12
1543423	Eye_tracking	200907	2	0	0	0	2	1	0	0	341	144	32	197	67	12
1543423	Eye_tracking	200908	2	0	0	0	2	0	0	0	343	146	32	197	67	12
1543423	Eye_tracking	200909	8	0	0	0	5	4	0	0	351	150	32	204	70	12
1543423	Eye_tracking	200910	1	0	0	0	1	0	0	0	352	151	32	204	70	12
1543423	Eye_tracking	200911	2	0	0	0	2	0	0	0	354	152	32	204	70	12
1543423	Eye_tracking	200912	3	0	0	0	2	1	0	0	357	153	32	205	70	12
1543423	Eye_tracking	201001	4	0	0	0	3	2	0	0	361	156	32	208	72	12
1543423	Eye_tracking	201002	3	0	0	0	2	2	0	0	364	158	32	211	74	12
1543423	Eye_tracking	201003	4	0	0	0	3	1	0	0	368	161	32	212	75	12
1543423	Eye_tracking	201004	6	0	0	0	6	3	0	0	374	166	32	215	77	12
1543423	Eye_tracking	201005	16	6	2	1	4	3	2	2	390	167	38	226	78	16
1543423	Eye_tracking	201006	2	0	0	0	2	2	0	0	392	169	38	228	80	16
1543423	Eye_tracking	201007	5	1	0	0	5	4	1	0	397	174	39	232	84	17
1543423	Eye_tracking	201008	3	0	0	0	3	1	0	0	400	177	39	233	85	17
1543423	Eye_tracking	201009	5	0	0	0	4	2	0	0	405	180	39	235	86	17
1543423	Eye_tracking	201011	4	0	0	0	2	2	0	0	409	182	39	239	88	17
1543423	Eye_tracking	201012	1	0	0	0	1	0	0	0	410	183	39	239	88	17
1543423	Eye_tracking	201101	5	1	0	0	5	3	1	0	415	187	40	242	90	17
1543423	Eye_tracking	201102	5	0	0	0	3	1	0	0	420	190	40	244	91	17
1543423	Eye_tracking	201103	2	0	0	0	2	1	0	0	422	192	40	245	92	17
1543423	Eye_tracking	201104	5	1	0	0	5	4	1	0	427	194	41	249	93	17
1543423	Eye_tracking	201105	1	0	0	0	1	1	0	0	428	195	41	250	94	17
1543423	Eye_tracking	201106	1	0	0	0	1	1	0	0	429	196	41	251	95	17
1543423	Eye_tracking	201107	1	0	0	0	1	1	0	0	430	197	41	252	96	17
1543423	Eye_tracking	201108	1	0	0	0	1	1	0	0	431	198	41	253	97	17
1543423	Eye_tracking	201109	9	2	0	0	4	3	1	0	440	201	43	259	99	18
1543423	Eye_tracking	201110	3	0	0	0	2	2	0	0	443	203	43	262	101	18
1543423	Eye_tracking	201112	2	0	0	0	2	2	0	0	445	204	43	264	102	18
1543423	Eye_tracking	201201	11	2	0	0	7	6	2	0	456	210	45	274	107	19
1543423	Eye_tracking	201202	6	1	0	0	4	3	1	0	462	214	46	279	110	20
1543423	Eye_tracking	201203	1	0	0	0	1	0	0	0	463	215	46	279	110	20
1543423	Eye_tracking	201204	5	2	0	0	5	5	2	0	468	217	48	284	112	22
1543423	Eye_tracking	201205	3	0	0	0	2	1	0	0	471	219	48	286	113	22
1543423	Eye_tracking	201207	4	0	0	0	2	2	0	0	475	220	48	290	114	22
1543423	Eye_tracking	201208	1	0	0	0	1	0	0	0	476	221	48	290	114	22
1543423	Eye_tracking	201209	2	0	0	0	2	2	0	0	478	223	48	292	116	22
1543423	Eye_tracking	201210	3	1	0	0	3	1	1	0	481	225	49	293	116	22
1543423	Eye_tracking	201211	2	0	0	0	2	2	0	0	483	226	49	295	117	22
1543423	Eye_tracking	201212	4	1	0	0	2	1	1	0	487	227	50	296	117	22
1543423	Eye_tracking	201301	2	1	0	0	2	1	1	0	489	228	51	297	117	22
1543423	Eye_tracking	201302	2	1	0	0	2	1	1	0	491	229	52	298	117	22
1543423	Eye_tracking	201304	3	0	0	0	3	2	0	0	494	231	52	300	118	22
1543423	Eye_tracking	201306	1	0	0	0	1	1	0	0	495	231	52	301	118	22
1543423	Eye_tracking	201307	5	1	0	0	4	3	1	0	500	234	53	305	120	23
1543423	Eye_tracking	201308	12	3	0	0	4	2	1	0	512	237	56	311	121	23
1543423	Eye_tracking	201309	4	1	0	0	2	1	1	0	516	238	57	314	121	23
1543423	Eye_tracking	201310	10	3	0	0	6	3	2	0	526	241	60	318	122	23
1543423	Eye_tracking	201311	11	0	0	0	5	4	0	0	537	246	60	328	126	23
1543423	Eye_tracking	201312	7	1	0	0	5	5	1	0	544	249	61	335	129	24
1543423	Eye_tracking	201401	4	1	0	0	3	2	1	0	548	251	62	338	130	24
1543423	Eye_tracking	201402	3	1	0	0	3	2	1	0	551	254	63	340	132	24
1543423	Eye_tracking	201403	1	0	0	0	1	1	0	0	552	254	63	341	132	24
1543423	Eye_tracking	201404	1	0	0	0	1	1	0	0	553	255	63	342	133	24
1543423	Eye_tracking	201405	4	0	0	0	3	2	0	0	557	256	63	344	133	24
1543423	Eye_tracking	201406	6	0	0	0	4	4	0	0	563	259	63	350	136	24
1543423	Eye_tracking	201407	2	0	0	0	2	1	0	0	565	261	63	351	137	24
1543423	Eye_tracking	201408	1	0	0	0	1	1	0	0	566	262	63	352	138	24
1543423	Eye_tracking	201412	1	0	0	0	1	1	0	0	567	263	63	353	139	24
1543423	Eye_tracking	201501	7	0	0	0	2	1	0	0	574	264	63	354	139	24
1543423	Eye_tracking	201502	1	0	0	0	1	1	0	0	575	265	63	355	140	24
1543423	Eye_tracking	201503	3	0	0	0	2	1	0	0	578	267	63	356	141	24
1543423	Eye_tracking	201504	10	0	0	0	4	4	0	0	588	270	63	366	144	24
1543423	Eye_tracking	201505	1	0	0	0	1	1	0	0	589	271	63	367	145	24
1543423	Eye_tracking	201507	5	2	1	0	4	3	2	1	594	274	65	371	147	26
1543423	Eye_tracking	201509	10	1	0	0	4	3	1	0	604	277	66	380	149	27
1543423	Eye_tracking	201510	1	0	0	0	1	1	0	0	605	278	66	381	150	27
1543423	Eye_tracking	201511	25	8	0	0	7	5	5	0	630	284	74	389	154	27
1543423	Eye_tracking	201512	3	0	0	0	2	1	0	0	633	286	74	391	155	27
1543423	Eye_tracking	201601	7	0	0	0	2	2	0	0	640	287	74	398	156	27
1543423	Eye_tracking	201602	1	0	0	0	1	1	0	0	641	287	74	399	156	27
1543423	Eye_tracking	201603	1	0	0	0	1	1	0	0	642	287	74	400	156	27
1543423	Eye_tracking	201605	2	1	0	0	2	2	1	0	644	289	75	402	158	28
1543423	Eye_tracking	201606	4	0	0	0	2	1	0	0	648	291	75	403	159	28
1543423	Eye_tracking	201607	1	0	0	0	1	1	0	0	649	292	75	404	160	28
1543423	Eye_tracking	201608	1	0	0	0	1	0	0	0	650	293	75	404	160	28
1543423	Eye_tracking	201610	5	1	0	0	3	3	1	0	655	294	76	409	161	29
1543423	Eye_tracking	201611	1	0	0	0	1	1	0	0	656	295	76	410	162	29
1543423	Eye_tracking	201701	2	1	0	0	2	2	1	0	658	296	77	412	163	30
1543423	Eye_tracking	201703	2	0	0	0	1	1	0	0	660	296	77	414	163	30
1543423	Eye_tracking	201706	2	1	0	0	2	2	1	0	662	297	78	416	164	31
1543423	Eye_tracking	201707	8	1	0	0	5	5	1	0	670	300	79	424	167	32
1543423	Eye_tracking	201708	3	1	0	0	3	3	1	0	673	303	80	427	170	33
1543423	Eye_tracking	201709	3	0	0	0	3	3	0	0	676	306	80	430	173	33
1543423	Eye_tracking	201711	2	0	0	0	2	2	0	0	678	308	80	432	175	33
1543423	Eye_tracking	201802	11	0	0	0	3	3	0	0	689	310	80	443	177	33
1543423	Eye_tracking	201804	15	3	0	0	6	5	3	0	704	314	83	456	180	35
1543423	Eye_tracking	201805	3	1	0	0	3	3	1	0	707	315	84	459	181	36
1543423	Eye_tracking	201806	3	0	0	0	2	2	0	0	710	317	84	462	183	36
1543423	Eye_tracking	201807	2	0	0	0	1	1	0	0	712	318	84	464	184	36
7529378	Facebook	200405	9	0	0	0	2	1	0	0	9	2	0	8	1	0
7529378	Facebook	200406	1	0	0	0	1	1	0	0	10	2	0	9	1	0
7529378	Facebook	200407	6	0	0	0	4	1	0	0	16	6	0	10	2	0
7529378	Facebook	200408	1	0	0	0	1	1	0	0	17	7	0	11	3	0
7529378	Facebook	200409	8	0	0	0	4	3	0	0	25	11	0	17	6	0
7529378	Facebook	200410	2	0	0	0	2	0	0	0	27	13	0	17	6	0
7529378	Facebook	200411	26	0	0	0	6	4	0	0	53	18	0	35	9	0
7529378	Facebook	200412	3	0	0	0	2	2	0	0	56	18	0	38	9	0
7529378	Facebook	200501	8	0	0	0	7	5	0	0	64	22	0	44	11	0
7529378	Facebook	200502	5	0	0	0	4	3	0	0	69	25	0	48	13	0
7529378	Facebook	200503	11	1	0	0	4	3	1	0	80	27	1	58	14	0
7529378	Facebook	200504	13	3	0	0	10	7	3	0	93	36	4	65	20	1
7529378	Facebook	200505	17	1	0	0	11	6	1	0	110	45	5	75	25	1
7529378	Facebook	200506	6	0	0	0	4	1	0	0	116	48	5	77	25	1
7529378	Facebook	200507	21	1	0	0	13	7	1	0	137	59	6	84	30	1
7529378	Facebook	200508	26	1	0	0	17	9	1	0	163	72	7	101	36	2
7529378	Facebook	200509	21	4	1	0	11	8	3	1	184	83	11	119	44	5
7529378	Facebook	200510	41	5	0	0	24	7	3	0	225	104	16	132	48	6
7529378	Facebook	200511	34	3	0	0	22	13	2	0	259	124	19	155	59	6
7529378	Facebook	200512	109	12	0	0	60	23	8	0	368	178	31	211	76	7
7529378	Facebook	200601	131	8	0	0	59	25	4	0	499	231	39	295	95	8
7529378	Facebook	200602	103	12	0	0	53	25	9	0	602	277	51	359	113	9
7529378	Facebook	200603	188	19	1	0	70	33	13	1	790	336	70	496	136	16
7529378	Facebook	200604	222	29	0	0	103	37	23	0	1012	424	99	609	162	18
7529378	Facebook	200605	166	23	0	0	86	37	18	0	1178	492	122	712	186	21
7529378	Facebook	200606	107	21	0	0	74	30	15	0	1285	551	143	760	205	23
7529378	Facebook	200607	53	4	0	0	39	21	4	0	1338	583	147	788	219	23
7529378	Facebook	200608	76	17	4	3	50	22	9	2	1414	628	164	826	236	25
7529378	Facebook	200609	158	21	0	0	96	48	17	0	1572	706	185	908	268	29
7529378	Facebook	200610	306	22	0	0	149	107	11	0	1878	840	207	1160	361	41
7529378	Facebook	200611	161	52	0	0	87	41	25	0	2039	918	259	1244	393	45
7529378	Facebook	200612	89	26	1	0	63	28	19	1	2128	972	285	1284	412	49
7529378	Facebook	200701	112	32	3	1	70	37	20	3	2240	1031	317	1341	438	54
7529378	Facebook	200702	135	34	0	0	92	38	17	0	2375	1109	351	1410	462	61
7529378	Facebook	200703	184	53	1	0	90	40	24	1	2559	1189	404	1498	492	67
7529378	Facebook	200704	173	50	1	0	114	51	30	1	2732	1289	454	1589	530	79
7529378	Facebook	200705	397	85	3	0	202	98	45	2	3129	1474	539	1835	611	104
7529378	Facebook	200706	473	98	4	2	229	96	41	4	3602	1683	637	2098	689	121
7529378	Facebook	200707	354	68	2	1	213	89	39	2	3956	1876	705	2269	759	128
7529378	Facebook	200708	378	78	1	0	229	86	38	1	4334	2082	783	2460	823	135
7529378	Facebook	200709	207	35	1	0	143	82	24	1	4541	2212	818	2594	892	145
7529378	Facebook	200710	368	78	0	0	226	91	43	0	4909	2412	896	2784	960	156
7529378	Facebook	200711	327	97	1	0	206	100	48	1	5236	2583	993	2974	1028	176
7529378	Facebook	200712	347	104	2	0	203	87	40	1	5583	2762	1097	3176	1092	203
7529378	Facebook	200801	239	63	6	2	139	63	31	5	5822	2875	1160	3322	1129	221
7529378	Facebook	200802	188	51	1	0	123	68	32	1	6010	2980	1211	3441	1180	233
7529378	Facebook	200803	57	7	0	0	39	39	5	0	6067	3006	1218	3498	1206	240
7529378	Facebook	200804	530	65	0	0	132	82	29	0	6597	3116	1283	3954	1267	267
7529378	Facebook	200805	166	35	2	1	74	52	22	2	6763	3171	1318	4091	1301	279
7529378	Facebook	200806	190	11	1	0	45	45	5	1	6953	3205	1329	4281	1335	290
7529378	Facebook	200807	52	4	0	0	25	25	2	0	7005	3221	1333	4333	1351	294
7529378	Facebook	200808	36	2	0	0	24	24	2	0	7041	3236	1335	4369	1366	296
7529378	Facebook	200809	41	5	0	0	27	27	5	0	7082	3254	1340	4410	1384	301
7529378	Facebook	200810	84	15	0	0	52	52	9	0	7166	3296	1355	4494	1426	316
7529378	Facebook	200811	51	10	0	0	29	29	5	0	7217	3317	1365	4545	1447	326
7529378	Facebook	200812	34	3	0	0	27	27	2	0	7251	3337	1368	4579	1467	329
7529378	Facebook	200901	34	3	0	0	25	25	3	0	7285	3357	1371	4613	1487	332
7529378	Facebook	200902	53	2	0	0	38	38	2	0	7338	3387	1373	4666	1517	334
7529378	Facebook	200903	42	1	0	0	30	30	1	0	7380	3407	1374	4708	1537	335
7529378	Facebook	200904	77	6	2	1	46	46	4	2	7457	3439	1380	4785	1569	341
7529378	Facebook	200905	30	7	2	1	21	21	5	2	7487	3452	1387	4815	1582	348
7529378	Facebook	200906	37	4	2	1	26	26	3	2	7524	3472	1391	4852	1602	352
7529378	Facebook	200907	50	5	0	0	34	34	4	0	7574	3499	1396	4902	1629	357
7529378	Facebook	200908	56	3	0	0	27	27	2	0	7630	3518	1399	4958	1648	360
7529378	Facebook	200909	71	8	2	1	32	32	4	2	7701	3542	1407	5029	1672	368
7529378	Facebook	200910	52	2	0	0	34	34	2	0	7753	3566	1409	5081	1696	370
7529378	Facebook	200911	50	7	0	0	33	33	5	0	7803	3592	1416	5131	1722	377
7529378	Facebook	200912	36	1	0	0	24	24	1	0	7839	3611	1417	5167	1741	378
7529378	Facebook	201001	75	6	0	0	34	34	5	0	7914	3633	1423	5242	1763	384
7529378	Facebook	201002	59	2	0	0	40	40	2	0	7973	3659	1425	5301	1789	386
7529378	Facebook	201003	78	4	0	0	37	37	4	0	8051	3688	1429	5379	1818	390
7529378	Facebook	201004	34	2	0	0	25	25	2	0	8085	3706	1431	5413	1836	392
7529378	Facebook	201005	55	2	0	0	41	41	2	0	8140	3735	1433	5468	1865	394
7529378	Facebook	201006	95	14	2	1	45	45	7	2	8235	3771	1447	5563	1901	408
7529378	Facebook	201007	143	39	0	0	86	53	29	0	8378	3842	1486	5664	1939	416
7529378	Facebook	201008	106	4	0	0	27	27	4	0	8484	3862	1490	5770	1959	420
7529378	Facebook	201009	57	5	0	0	34	34	3	0	8541	3885	1495	5827	1982	425
7529378	Facebook	201010	72	9	0	0	40	40	7	0	8613	3916	1504	5899	2013	434
7529378	Facebook	201011	78	2	0	0	51	51	2	0	8691	3949	1506	5977	2046	436
7529378	Facebook	201012	86	15	1	0	55	55	12	1	8777	3984	1521	6063	2081	451
7529378	Facebook	201101	62	6	0	0	36	36	5	0	8839	4004	1527	6125	2101	457
7529378	Facebook	201102	71	8	0	0	54	54	8	0	8910	4044	1535	6196	2141	465
7529378	Facebook	201103	36	7	0	0	29	29	7	0	8946	4061	1542	6232	2158	472
7529378	Facebook	201104	45	2	0	0	22	22	2	0	8991	4076	1544	6277	2173	474
7529378	Facebook	201105	58	3	0	0	35	35	3	0	9049	4099	1547	6335	2196	477
7529378	Facebook	201106	65	7	0	0	33	33	4	0	9114	4118	1554	6400	2215	484
7529378	Facebook	201107	14	0	0	0	13	13	0	0	9128	4126	1554	6414	2223	484
7529378	Facebook	201108	36	3	0	0	25	25	3	0	9164	4143	1557	6450	2240	487
7529378	Facebook	201109	37	8	4	3	25	25	5	2	9201	4161	1565	6487	2258	495
7529378	Facebook	201110	46	4	0	0	33	33	3	0	9247	4187	1569	6533	2284	499
7529378	Facebook	201111	35	1	0	0	23	23	1	0	9282	4200	1570	6568	2297	500
7529378	Facebook	201112	47	2	0	0	32	32	2	0	9329	4225	1572	6615	2322	502
7529378	Facebook	201201	42	5	0	0	31	31	4	0	9371	4244	1577	6657	2341	507
7529378	Facebook	201202	30	3	1	0	18	18	3	1	9401	4255	1580	6687	2352	510
7529378	Facebook	201203	75	10	5	2	39	39	6	2	9476	4281	1590	6762	2378	520
7529378	Facebook	201204	34	2	0	0	19	19	2	0	9510	4290	1592	6796	2387	522
7529378	Facebook	201205	40	3	0	0	33	33	3	0	9550	4309	1595	6836	2406	525
7529378	Facebook	201206	113	9	1	0	62	62	7	1	9663	4352	1604	6949	2449	534
7529378	Facebook	201207	35	3	1	0	28	28	3	1	9698	4367	1607	6984	2464	537
7529378	Facebook	201208	45	1	0	0	31	31	1	0	9743	4384	1608	7029	2481	538
7529378	Facebook	201209	27	1	0	0	24	24	1	0	9770	4395	1609	7056	2492	539
7529378	Facebook	201210	23	0	0	0	19	19	0	0	9793	4410	1609	7079	2507	539
7529378	Facebook	201211	27	2	0	0	18	18	2	0	9820	4416	1611	7106	2513	541
7529378	Facebook	201212	37	5	0	0	28	28	5	0	9857	4435	1616	7143	2532	546
7529378	Facebook	201301	38	2	0	0	22	22	2	0	9895	4450	1618	7181	2547	548
7529378	Facebook	201302	41	3	0	0	31	31	3	0	9936	4468	1621	7222	2565	551
7529378	Facebook	201303	45	4	0	0	26	26	3	0	9981	4477	1625	7267	2574	555
7529378	Facebook	201304	20	3	0	0	15	15	2	0	10001	4485	1628	7287	2582	558
7529378	Facebook	201305	29	2	0	0	16	16	1	0	10030	4494	1630	7316	2591	560
7529378	Facebook	201306	41	3	0	0	26	26	3	0	10071	4516	1633	7357	2613	563
7529378	Facebook	201307	31	1	0	0	13	13	1	0	10102	4523	1634	7388	2620	564
7529378	Facebook	201308	50	2	0	0	26	26	2	0	10152	4539	1636	7438	2636	566
7529378	Facebook	201309	63	1	0	0	26	26	1	0	10215	4559	1637	7501	2656	567
7529378	Facebook	201310	19	2	0	0	15	15	2	0	10234	4567	1639	7520	2664	569
7529378	Facebook	201311	22	0	0	0	12	12	0	0	10256	4572	1639	7542	2669	569
7529378	Facebook	201312	22	0	0	0	14	14	0	0	10278	4576	1639	7564	2673	569
7529378	Facebook	201401	20	0	0	0	14	14	0	0	10298	4586	1639	7584	2683	569
7529378	Facebook	201402	28	0	0	0	16	16	0	0	10326	4596	1639	7612	2693	569
7529378	Facebook	201403	57	3	0	0	33	33	3	0	10383	4616	1642	7669	2713	572
7529378	Facebook	201404	44	4	0	0	28	28	4	0	10427	4635	1646	7713	2732	576
7529378	Facebook	201405	34	4	0	0	24	24	4	0	10461	4648	1650	7747	2745	580
7529378	Facebook	201406	20	1	0	0	15	15	1	0	10481	4658	1651	7767	2755	581
7529378	Facebook	201407	19	0	0	0	15	15	0	0	10500	4666	1651	7786	2763	581
7529378	Facebook	201408	33	1	0	0	19	19	1	0	10533	4680	1652	7819	2777	582
7529378	Facebook	201409	29	2	0	0	18	18	2	0	10562	4689	1654	7848	2786	584
7529378	Facebook	201410	10	0	0	0	8	8	0	0	10572	4693	1654	7858	2790	584
7529378	Facebook	201411	24	1	0	0	19	19	1	0	10596	4706	1655	7882	2803	585
7529378	Facebook	201412	49	4	0	0	29	29	3	0	10645	4723	1659	7931	2820	589
7529378	Facebook	201501	36	2	0	0	20	20	2	0	10681	4736	1661	7967	2833	591
7529378	Facebook	201502	33	0	0	0	19	19	0	0	10714	4749	1661	8000	2846	591
7529378	Facebook	201503	31	1	0	0	21	21	1	0	10745	4761	1662	8031	2858	592
7529378	Facebook	201504	59	4	0	0	18	18	3	0	10804	4770	1666	8090	2867	596
7529378	Facebook	201505	14	3	0	0	12	12	3	0	10818	4777	1669	8104	2874	599
7529378	Facebook	201506	12	1	0	0	10	10	1	0	10830	4785	1670	8116	2882	600
7529378	Facebook	201507	19	2	0	0	16	16	2	0	10849	4795	1672	8135	2892	602
7529378	Facebook	201508	26	2	0	0	17	17	2	0	10875	4807	1674	8161	2904	604
7529378	Facebook	201509	11	1	0	0	10	10	1	0	10886	4810	1675	8172	2907	605
7529378	Facebook	201510	67	2	0	0	14	14	2	0	10953	4819	1677	8239	2916	607
7529378	Facebook	201511	8	1	0	0	7	7	1	0	10961	4824	1678	8247	2921	608
7529378	Facebook	201512	19	0	0	0	14	14	0	0	10980	4835	1678	8266	2932	608
7529378	Facebook	201601	28	2	0	0	17	17	2	0	11008	4845	1680	8294	2942	610
7529378	Facebook	201602	19	0	0	0	16	16	0	0	11027	4855	1680	8313	2952	610
7529378	Facebook	201603	29	2	0	0	16	16	2	0	11056	4863	1682	8342	2960	612
7529378	Facebook	201604	9	0	0	0	8	8	0	0	11065	4869	1682	8351	2966	612
7529378	Facebook	201605	21	3	0	0	16	16	3	0	11086	4877	1685	8372	2974	615
7529378	Facebook	201606	38	3	0	0	21	21	3	0	11124	4893	1688	8410	2990	618
7529378	Facebook	201607	26	0	0	0	21	21	0	0	11150	4904	1688	8436	3001	618
7529378	Facebook	201608	40	3	0	0	24	24	3	0	11190	4921	1691	8476	3018	621
7529378	Facebook	201609	34	2	0	0	20	20	2	0	11224	4932	1693	8510	3029	623
7529378	Facebook	201610	24	1	0	0	17	17	1	0	11248	4943	1694	8534	3040	624
7529378	Facebook	201611	20	0	0	0	16	16	0	0	11268	4951	1694	8554	3048	624
7529378	Facebook	201612	30	7	0	0	22	22	7	0	11298	4966	1701	8584	3063	631
7529378	Facebook	201701	21	1	0	0	18	18	1	0	11319	4977	1702	8605	3074	632
7529378	Facebook	201702	51	2	0	0	25	25	2	0	11370	4991	1704	8656	3088	634
7529378	Facebook	201703	28	2	0	0	19	19	1	0	11398	4998	1706	8684	3095	636
7529378	Facebook	201704	30	4	0	0	18	18	3	0	11428	5009	1710	8714	3106	640
7529378	Facebook	201705	23	0	0	0	19	19	0	0	11451	5020	1710	8737	3117	640
7529378	Facebook	201706	27	0	0	0	17	17	0	0	11478	5030	1710	8764	3127	640
7529378	Facebook	201707	66	2	0	0	17	17	1	0	11544	5039	1712	8830	3136	642
7529378	Facebook	201708	35	3	0	0	21	21	2	0	11579	5055	1715	8865	3152	645
7529378	Facebook	201709	29	1	0	0	17	17	1	0	11608	5066	1716	8894	3163	646
7529378	Facebook	201710	53	3	0	0	22	22	3	0	11661	5078	1719	8947	3175	649
7529378	Facebook	201711	23	2	0	0	17	17	2	0	11684	5086	1721	8970	3183	651
7529378	Facebook	201712	23	1	0	0	13	13	1	0	11707	5092	1722	8993	3189	652
7529378	Facebook	201801	18	1	0	0	11	11	1	0	11725	5097	1723	9011	3194	653
7529378	Facebook	201802	26	4	0	0	22	22	4	0	11751	5111	1727	9037	3208	657
7529378	Facebook	201803	27	3	0	0	21	21	3	0	11778	5125	1730	9064	3222	660
7529378	Facebook	201804	78	2	0	0	41	41	2	0	11856	5149	1732	9142	3246	662
7529378	Facebook	201805	73	1	0	0	30	30	1	0	11929	5166	1733	9215	3263	663
7529378	Facebook	201806	29	1	0	0	14	14	1	0	11958	5175	1734	9244	3272	664
7529378	Facebook	201807	20	0	0	0	15	15	0	0	11978	5186	1734	9264	3283	664
44518453	Financial_technology	201412	2	0	0	0	2	2	0	0	2	2	0	2	2	0
44518453	Financial_technology	201501	18	2	0	0	6	4	2	0	20	8	2	18	6	0
44518453	Financial_technology	201502	5	0	0	0	4	2	0	0	25	10	2	21	6	0
44518453	Financial_technology	201503	2	0	0	0	2	0	0	0	27	12	2	21	6	0
44518453	Financial_technology	201504	9	0	0	0	7	5	0	0	36	19	2	27	11	0
44518453	Financial_technology	201505	9	0	0	0	8	5	0	0	45	27	2	32	16	0
44518453	Financial_technology	201506	24	3	0	0	18	8	3	0	69	44	5	42	23	1
44518453	Financial_technology	201507	10	2	0	0	10	4	2	0	79	53	7	46	26	1
44518453	Financial_technology	201508	10	0	0	0	5	3	0	0	89	58	7	50	29	1
44518453	Financial_technology	201509	2	0	0	0	2	1	0	0	91	60	7	51	30	1
44518453	Financial_technology	201510	8	0	0	0	5	4	0	0	99	65	7	58	34	1
44518453	Financial_technology	201511	6	0	0	0	3	1	0	0	105	68	7	59	35	1
44518453	Financial_technology	201512	13	0	0	0	5	3	0	0	118	73	7	63	38	1
44518453	Financial_technology	201601	8	0	0	0	5	3	0	0	126	78	7	66	41	1
44518453	Financial_technology	201602	2	0	0	0	2	2	0	0	128	80	7	68	43	1
44518453	Financial_technology	201603	4	0	0	0	3	2	0	0	132	82	7	71	44	1
44518453	Financial_technology	201604	7	0	0	0	3	1	0	0	139	85	7	72	45	1
44518453	Financial_technology	201605	5	1	0	0	4	3	1	0	144	89	8	76	48	2
44518453	Financial_technology	201606	11	1	0	0	7	5	1	0	155	96	9	85	53	2
44518453	Financial_technology	201607	7	2	0	0	6	5	2	0	162	102	11	91	58	4
44518453	Financial_technology	201608	21	1	0	0	15	9	1	0	183	116	12	104	66	5
44518453	Financial_technology	201609	5	0	0	0	3	1	0	0	188	118	12	105	66	5
44518453	Financial_technology	201610	9	0	0	0	8	5	0	0	197	125	12	111	70	5
44518453	Financial_technology	201611	24	4	0	0	14	10	4	0	221	137	16	124	77	6
44518453	Financial_technology	201612	20	2	0	0	11	8	1	0	241	147	18	141	82	8
44518453	Financial_technology	201701	12	0	0	0	8	5	0	0	253	154	18	149	86	8
44518453	Financial_technology	201702	15	0	0	0	8	7	0	0	268	161	18	163	90	8
44518453	Financial_technology	201703	9	1	0	0	9	6	1	0	277	169	19	169	93	9
44518453	Financial_technology	201704	13	2	0	0	12	8	2	0	290	179	21	177	99	10
44518453	Financial_technology	201705	30	10	5	3	11	10	3	3	320	187	31	205	106	19
44518453	Financial_technology	201706	24	2	0	0	9	8	1	0	344	194	33	228	112	21
44518453	Financial_technology	201707	15	6	0	0	14	10	5	0	359	207	39	239	119	23
44518453	Financial_technology	201708	12	4	0	0	6	4	2	0	371	210	43	247	121	24
44518453	Financial_technology	201709	13	5	0	0	12	8	4	0	384	216	48	256	125	25
44518453	Financial_technology	201710	11	3	0	0	10	9	3	0	395	224	51	266	129	27
44518453	Financial_technology	201711	10	2	0	0	8	8	2	0	405	229	53	276	132	29
44518453	Financial_technology	201712	10	2	0	0	6	5	1	0	415	232	55	285	135	30
44518453	Financial_technology	201801	2	1	0	0	2	1	1	0	417	232	56	286	135	30
44518453	Financial_technology	201802	3	0	0	0	3	1	0	0	420	235	56	287	136	30
44518453	Financial_technology	201803	10	3	0	0	8	7	2	0	430	242	59	295	139	33
44518453	Financial_technology	201804	3	1	0	0	3	3	1	0	433	245	60	298	142	34
44518453	Financial_technology	201805	3	1	0	0	3	3	1	0	436	247	61	301	143	35
44518453	Financial_technology	201806	4	1	0	0	4	4	1	0	440	250	62	305	146	36
44518453	Financial_technology	201807	6	0	0	0	5	5	0	0	446	255	62	311	150	36
43890317	Fog_computing	201410	7	0	0	0	1	1	0	0	7	1	0	7	1	0
43890317	Fog_computing	201412	45	1	0	0	7	4	1	0	52	7	1	38	4	0
43890317	Fog_computing	201504	4	0	0	0	1	1	0	0	56	8	1	42	5	0
43890317	Fog_computing	201505	1	0	0	0	1	1	0	0	57	9	1	43	6	0
43890317	Fog_computing	201506	1	0	0	0	1	1	0	0	58	10	1	44	7	0
43890317	Fog_computing	201507	8	1	0	0	5	4	1	0	66	14	2	51	10	1
43890317	Fog_computing	201511	3	0	0	0	3	3	0	0	69	16	2	54	12	1
43890317	Fog_computing	201512	1	0	0	0	1	0	0	0	70	17	2	54	12	1
43890317	Fog_computing	201601	2	0	0	0	1	1	0	0	72	18	2	56	13	1
43890317	Fog_computing	201602	2	0	0	0	2	1	0	0	74	20	2	57	14	1
43890317	Fog_computing	201604	3	0	0	0	2	1	0	0	77	22	2	59	15	1
43890317	Fog_computing	201606	1	0	0	0	1	1	0	0	78	23	2	60	16	1
43890317	Fog_computing	201609	4	2	0	0	2	1	1	0	82	25	4	62	17	1
43890317	Fog_computing	201610	6	1	0	0	5	3	1	0	88	30	5	65	20	1
43890317	Fog_computing	201611	4	0	0	0	3	2	0	0	92	33	5	68	22	1
43890317	Fog_computing	201612	3	1	0	0	3	1	1	0	95	36	6	69	23	1
43890317	Fog_computing	201701	1	0	0	0	1	1	0	0	96	37	6	70	24	1
43890317	Fog_computing	201702	4	1	0	0	4	2	1	0	100	41	7	72	26	1
43890317	Fog_computing	201703	3	0	0	0	3	2	0	0	103	43	7	74	27	1
43890317	Fog_computing	201704	1	0	0	0	1	1	0	0	104	44	7	75	28	1
43890317	Fog_computing	201705	15	1	0	0	9	5	1	0	119	51	8	86	32	2
43890317	Fog_computing	201706	12	1	0	0	4	3	1	0	131	55	9	96	35	3
43890317	Fog_computing	201707	3	0	0	0	3	2	0	0	134	57	9	98	36	3
43890317	Fog_computing	201708	3	0	0	0	2	2	0	0	137	59	9	101	38	3
43890317	Fog_computing	201709	4	0	0	0	4	4	0	0	141	62	9	105	41	3
43890317	Fog_computing	201710	2	0	0	0	1	1	0	0	143	62	9	107	41	3
43890317	Fog_computing	201711	4	0	0	0	1	0	0	0	147	63	9	107	41	3
43890317	Fog_computing	201712	11	1	0	0	5	4	1	0	158	67	10	117	44	3
43890317	Fog_computing	201802	5	1	0	0	5	3	1	0	163	72	11	120	47	3
43890317	Fog_computing	201803	5	2	0	0	5	3	2	0	168	77	13	123	50	3
43890317	Fog_computing	201804	3	0	0	0	2	1	0	0	171	79	13	124	51	3
43890317	Fog_computing	201805	2	0	0	0	2	1	0	0	173	81	13	125	52	3
43890317	Fog_computing	201806	6	0	0	0	3	1	0	0	179	84	13	129	53	3
43890317	Fog_computing	201807	4	0	0	0	4	3	0	0	183	88	13	132	56	3
2603042	GOST	200510	4	0	0	0	2	2	0	0	4	2	0	4	2	0
2603042	GOST	200511	1	0	0	0	1	1	0	0	5	3	0	5	3	0
2603042	GOST	200601	2	1	0	0	2	1	1	0	7	5	1	6	4	0
2603042	GOST	200602	5	0	0	0	5	2	0	0	12	10	1	8	6	0
2603042	GOST	200603	6	0	0	0	2	2	0	0	18	12	1	14	8	0
2603042	GOST	200604	2	0	0	0	2	1	0	0	20	13	1	15	8	0
2603042	GOST	200605	81	0	0	0	11	3	0	0	101	24	1	44	11	0
2603042	GOST	200606	8	1	0	0	5	3	1	0	109	27	2	47	12	0
2603042	GOST	200607	9	1	0	0	4	3	1	0	118	30	3	51	14	0
2603042	GOST	200608	6	1	0	0	4	3	1	0	124	34	4	54	17	0
2603042	GOST	200609	2	0	0	0	1	1	0	0	126	35	4	56	18	0
2603042	GOST	200610	1	0	0	0	1	0	0	0	127	36	4	56	18	0
2603042	GOST	200611	12	0	0	0	4	1	0	0	139	40	4	57	19	0
2603042	GOST	200701	6	0	0	0	3	1	0	0	145	43	4	58	20	0
2603042	GOST	200702	1	0	0	0	1	0	0	0	146	44	4	58	20	0
2603042	GOST	200703	3	0	0	0	1	0	0	0	149	45	4	58	20	0
2603042	GOST	200704	5	0	0	0	4	2	0	0	154	49	4	61	22	0
2603042	GOST	200706	5	1	0	0	4	3	1	0	159	52	5	65	24	0
2603042	GOST	200708	7	0	0	0	5	4	0	0	166	57	5	69	28	0
2603042	GOST	200709	1	0	0	0	1	0	0	0	167	58	5	69	28	0
2603042	GOST	200710	1	0	0	0	1	1	0	0	168	59	5	70	29	0
2603042	GOST	200711	2	0	0	0	1	0	0	0	170	60	5	70	29	0
2603042	GOST	200801	4	1	0	0	4	3	1	0	174	63	6	73	32	0
2603042	GOST	200802	3	1	0	0	3	2	1	0	177	66	7	75	34	0
2603042	GOST	200803	4	1	0	0	3	1	1	0	181	69	8	76	35	0
2603042	GOST	200804	1	0	0	0	1	0	0	0	182	70	8	76	35	0
2603042	GOST	200805	2	0	0	0	2	0	0	0	184	72	8	76	35	0
2603042	GOST	200806	2	0	0	0	1	0	0	0	186	73	8	76	35	0
2603042	GOST	200808	21	3	0	0	10	3	2	0	207	83	11	81	38	2
2603042	GOST	200809	2	0	0	0	2	1	0	0	209	85	11	82	39	2
2603042	GOST	200810	5	0	0	0	1	0	0	0	214	86	11	82	39	2
2603042	GOST	200811	2	0	0	0	2	1	0	0	216	88	11	83	40	2
2603042	GOST	200812	8	0	0	0	3	2	0	0	224	91	11	85	42	2
2603042	GOST	200901	8	0	0	0	3	2	0	0	232	93	11	91	43	2
2603042	GOST	200902	1	0	0	0	1	1	0	0	233	94	11	92	44	2
2603042	GOST	200903	46	5	0	0	10	4	3	0	279	103	16	118	48	3
2603042	GOST	200904	4	1	0	0	4	3	1	0	283	107	17	121	51	3
2603042	GOST	200905	1	0	0	0	1	1	0	0	284	107	17	122	51	3
2603042	GOST	200906	14	1	0	0	5	4	1	0	298	111	18	127	54	3
2603042	GOST	200907	4	1	0	0	4	3	1	0	302	115	19	130	57	4
2603042	GOST	200908	1	0	0	0	1	1	0	0	303	116	19	131	58	4
2603042	GOST	200909	2	1	0	0	2	1	1	0	305	117	20	132	58	4
2603042	GOST	200910	6	0	0	0	4	3	0	0	311	121	20	137	61	4
2603042	GOST	200912	3	1	0	0	3	1	1	0	314	124	21	138	62	4
2603042	GOST	201001	1	0	0	0	1	1	0	0	315	125	21	139	63	4
2603042	GOST	201003	4	1	0	0	3	2	1	0	319	128	22	142	65	4
2603042	GOST	201004	1	0	0	0	1	0	0	0	320	129	22	142	65	4
2603042	GOST	201005	2	0	0	0	2	0	0	0	322	131	22	142	65	4
2603042	GOST	201006	1	0	0	0	1	1	0	0	323	132	22	143	66	4
2603042	GOST	201007	1	0	0	0	1	1	0	0	324	132	22	144	66	4
2603042	GOST	201010	1	0	0	0	1	1	0	0	325	133	22	145	67	4
2603042	GOST	201011	4	2	0	0	4	2	2	0	329	136	24	147	68	4
2603042	GOST	201012	1	0	0	0	1	0	0	0	330	137	24	147	68	4
2603042	GOST	201101	5	1	0	0	4	3	1	0	335	140	25	151	70	4
2603042	GOST	201102	1	0	0	0	1	1	0	0	336	141	25	152	71	4
2603042	GOST	201103	2	1	0	0	2	1	1	0	338	143	26	153	72	4
2603042	GOST	201107	2	1	0	0	2	1	1	0	340	145	27	154	73	4
2603042	GOST	201110	3	1	0	0	2	1	1	0	343	147	28	155	74	4
2603042	GOST	201111	2	0	0	0	1	0	0	0	345	148	28	155	74	4
2603042	GOST	201204	1	0	0	0	1	1	0	0	346	148	28	156	74	4
2603042	GOST	201205	3	0	0	0	2	2	0	0	349	150	28	159	76	4
2603042	GOST	201207	2	0	0	0	2	2	0	0	351	152	28	161	78	4
2603042	GOST	201208	11	0	0	0	2	2	0	0	362	153	28	172	79	4
2603042	GOST	201209	6	0	0	0	3	2	0	0	368	156	28	175	81	4
2603042	GOST	201210	6	3	0	0	5	4	3	0	374	160	31	179	84	5
2603042	GOST	201301	4	0	0	0	2	1	0	0	378	162	31	181	85	5
2603042	GOST	201302	3	1	0	0	3	2	1	0	381	165	32	183	87	5
2603042	GOST	201304	2	0	0	0	2	1	0	0	383	167	32	184	88	5
2603042	GOST	201305	2	0	0	0	1	0	0	0	385	168	32	184	88	5
2603042	GOST	201306	1	0	0	0	1	0	0	0	386	168	32	184	88	5
2603042	GOST	201307	3	0	0	0	2	1	0	0	389	170	32	185	89	5
2603042	GOST	201308	2	0	0	0	2	2	0	0	391	171	32	187	90	5
2603042	GOST	201312	1	0	0	0	1	1	0	0	392	172	32	188	91	5
2603042	GOST	201405	2	0	0	0	1	0	0	0	394	173	32	188	91	5
2603042	GOST	201406	1	0	0	0	1	1	0	0	395	174	32	189	92	5
2603042	GOST	201407	2	0	0	0	2	0	0	0	397	176	32	189	92	5
2603042	GOST	201410	9	3	0	0	6	5	3	0	406	181	35	195	96	7
2603042	GOST	201411	4	1	0	0	4	1	1	0	410	184	36	196	96	7
2603042	GOST	201412	3	0	0	0	3	2	0	0	413	187	36	198	98	7
2603042	GOST	201501	3	0	0	0	2	1	0	0	416	189	36	199	99	7
2603042	GOST	201502	1	0	0	0	1	0	0	0	417	190	36	199	99	7
2603042	GOST	201503	3	0	0	0	1	1	0	0	420	190	36	202	99	7
2603042	GOST	201504	2	0	0	0	1	1	0	0	422	191	36	204	100	7
2603042	GOST	201505	2	1	0	0	2	1	1	0	424	193	37	205	101	7
2603042	GOST	201507	3	1	0	0	3	2	1	0	427	195	38	207	102	7
2603042	GOST	201508	1	0	0	0	1	0	0	0	428	196	38	207	102	7
2603042	GOST	201509	1	0	0	0	1	0	0	0	429	197	38	207	102	7
2603042	GOST	201510	1	0	0	0	1	1	0	0	430	198	38	208	103	7
2603042	GOST	201512	2	1	0	0	2	2	1	0	432	200	39	210	105	8
2603042	GOST	201602	3	0	0	0	1	1	0	0	435	201	39	213	106	8
2603042	GOST	201607	1	0	0	0	1	1	0	0	436	202	39	214	107	8
2603042	GOST	201608	1	0	0	0	1	1	0	0	437	203	39	215	108	8
2603042	GOST	201609	1	0	0	0	1	1	0	0	438	204	39	216	109	8
2603042	GOST	201610	2	0	0	0	1	1	0	0	440	205	39	218	110	8
2603042	GOST	201706	1	0	0	0	1	1	0	0	441	206	39	219	111	8
2603042	GOST	201708	1	0	0	0	1	1	0	0	442	206	39	220	111	8
2603042	GOST	201709	2	0	0	0	2	2	0	0	444	206	39	222	111	8
2603042	GOST	201710	2	0	0	0	2	1	0	0	446	208	39	223	112	8
2603042	GOST	201803	1	0	0	0	1	1	0	0	447	209	39	224	113	8
2603042	GOST	201804	7	4	1	0	5	4	4	1	454	212	43	229	115	10
2603042	GOST	201805	1	0	0	0	1	1	0	0	455	212	43	230	115	10
2603042	GOST	201806	5	1	0	0	5	4	1	0	460	217	44	234	119	10
2603042	GOST	201807	4	0	0	0	2	1	0	0	464	218	44	237	119	10
12808	GSM	200112	6	0	0	0	3	3	0	0	6	3	0	6	3	0
12808	GSM	200201	3	0	0	0	1	1	0	0	9	3	0	9	3	0
12808	GSM	200202	1	0	0	0	1	1	0	0	10	4	0	10	3	0
12808	GSM	200208	2	0	0	0	2	1	0	0	12	6	0	11	3	0
12808	GSM	200209	3	0	0	0	3	1	0	0	15	9	0	12	4	0
12808	GSM	200210	2	0	0	0	2	1	0	0	17	11	0	13	5	0
12808	GSM	200302	4	0	0	0	3	1	0	0	21	14	0	14	6	0
12808	GSM	200304	9	0	0	0	3	3	0	0	30	17	0	23	9	0
12808	GSM	200305	1	0	0	0	1	1	0	0	31	18	0	24	10	0
12808	GSM	200306	2	0	0	0	2	2	0	0	33	20	0	26	12	0
12808	GSM	200307	6	0	0	0	4	3	0	0	39	23	0	29	14	0
12808	GSM	200308	4	0	0	0	4	0	0	0	43	27	0	29	14	0
12808	GSM	200309	4	0	0	0	3	2	0	0	47	30	0	32	16	0
12808	GSM	200310	4	0	0	0	3	3	0	0	51	33	0	36	19	0
12808	GSM	200311	2	0	0	0	2	1	0	0	53	34	0	37	19	0
12808	GSM	200312	2	0	0	0	2	2	0	0	55	36	0	39	21	0
12808	GSM	200401	3	0	0	0	2	2	0	0	58	38	0	42	23	0
12808	GSM	200402	2	0	0	0	2	2	0	0	60	39	0	44	24	0
12808	GSM	200403	12	0	0	0	11	6	0	0	72	49	0	51	29	0
12808	GSM	200404	12	0	0	0	8	6	0	0	84	55	0	61	34	0
12808	GSM	200405	12	0	0	0	8	5	0	0	96	62	0	66	38	0
12808	GSM	200406	7	0	0	0	4	2	0	0	103	66	0	71	40	0
12808	GSM	200407	7	0	0	0	5	2	0	0	110	71	0	73	42	0
12808	GSM	200408	12	0	0	0	10	6	0	0	122	79	0	81	46	0
12808	GSM	200409	19	0	0	0	8	4	0	0	141	86	0	87	49	0
12808	GSM	200410	16	0	0	0	8	5	0	0	157	92	0	99	52	0
12808	GSM	200411	27	0	0	0	11	6	0	0	184	102	0	116	57	0
12808	GSM	200412	11	1	0	0	10	4	1	0	195	109	1	121	59	0
12808	GSM	200501	14	0	0	0	8	3	0	0	209	116	1	130	61	0
12808	GSM	200502	15	0	0	0	12	8	0	0	224	127	1	138	68	0
12808	GSM	200503	8	1	0	0	5	3	1	0	232	131	2	144	70	0
12808	GSM	200504	16	1	0	0	13	7	1	0	248	141	3	152	74	0
12808	GSM	200505	22	4	0	0	16	9	3	0	270	153	7	166	79	0
12808	GSM	200506	12	2	0	0	7	4	2	0	282	159	9	174	82	0
12808	GSM	200507	16	4	0	0	13	7	3	0	298	167	13	183	85	0
12808	GSM	200508	17	1	0	0	12	7	1	0	315	178	14	192	91	0
12808	GSM	200509	12	2	0	0	11	6	1	0	327	187	16	199	95	0
12808	GSM	200510	28	8	1	0	24	12	8	1	355	208	24	211	104	1
12808	GSM	200511	16	2	0	0	13	7	2	0	371	218	26	218	108	1
12808	GSM	200512	29	5	0	0	18	7	3	0	400	233	31	230	112	1
12808	GSM	200601	33	5	0	0	21	11	4	0	433	252	36	248	121	2
12808	GSM	200602	19	2	0	0	16	6	2	0	452	267	38	255	126	2
12808	GSM	200603	24	4	0	0	20	10	4	0	476	284	42	265	133	2
12808	GSM	200604	32	3	0	0	23	9	3	0	508	304	45	277	139	2
12808	GSM	200605	38	4	0	0	28	17	3	0	546	329	49	302	153	4
12808	GSM	200606	30	3	0	0	22	10	2	0	576	348	52	314	161	4
12808	GSM	200607	23	4	0	0	21	10	4	0	599	366	56	324	168	4
12808	GSM	200608	17	3	0	0	16	6	3	0	616	379	59	331	171	4
12808	GSM	200609	18	2	0	0	13	3	2	0	634	392	61	338	174	4
12808	GSM	200610	25	4	0	0	21	9	4	0	659	410	65	348	180	4
12808	GSM	200611	22	2	0	0	18	11	2	0	681	428	67	361	191	4
12808	GSM	200612	25	4	0	0	17	8	4	0	706	444	71	373	198	5
12808	GSM	200701	19	4	1	0	14	6	4	1	725	456	75	380	202	6
12808	GSM	200702	30	2	0	0	18	12	2	0	755	471	77	401	211	8
12808	GSM	200703	21	3	0	0	15	7	3	0	776	485	80	411	217	8
12808	GSM	200704	20	3	0	0	14	9	3	0	796	497	83	425	224	8
12808	GSM	200705	24	8	1	0	17	8	8	1	820	509	91	436	227	10
12808	GSM	200706	36	12	0	0	24	14	8	0	856	530	103	456	238	10
12808	GSM	200707	17	3	0	0	17	11	3	0	873	544	106	467	246	10
12808	GSM	200708	35	6	0	0	23	10	3	0	908	565	112	483	254	11
12808	GSM	200709	39	7	0	0	20	9	4	0	947	583	119	501	261	12
12808	GSM	200710	23	4	0	0	17	9	4	0	970	598	123	516	268	13
12808	GSM	200711	21	3	0	0	16	8	2	0	991	608	126	527	271	13
12808	GSM	200712	7	1	0	0	6	3	1	0	998	612	127	530	272	13
12808	GSM	200801	9	3	0	0	9	5	3	0	1007	617	130	535	273	13
12808	GSM	200802	26	4	0	0	15	9	3	0	1033	630	134	549	281	14
12808	GSM	200803	32	8	0	0	23	13	6	0	1065	650	142	566	291	14
12808	GSM	200804	25	6	0	0	21	12	5	0	1090	666	148	581	298	14
12808	GSM	200805	19	3	0	0	10	6	3	0	1109	674	151	596	302	14
12808	GSM	200806	25	2	0	0	22	12	2	0	1134	694	153	609	312	14
12808	GSM	200807	32	8	0	0	25	15	6	0	1166	716	161	630	324	16
12808	GSM	200808	16	6	0	0	12	5	3	0	1182	724	167	639	326	17
12808	GSM	200809	26	6	0	0	18	10	4	0	1208	737	173	652	331	17
12808	GSM	200810	17	7	0	0	15	10	6	0	1225	748	180	663	337	18
12808	GSM	200811	29	8	0	0	22	11	5	0	1254	765	188	679	343	18
12808	GSM	200812	15	6	0	0	12	6	6	0	1269	776	194	685	348	19
12808	GSM	200901	29	11	0	0	23	13	9	0	1298	794	205	701	356	20
12808	GSM	200902	34	8	0	0	25	14	6	0	1332	814	213	723	365	21
12808	GSM	200903	35	10	0	0	23	11	6	0	1367	832	223	741	371	21
12808	GSM	200904	22	4	0	0	15	7	4	0	1389	844	227	754	375	21
12808	GSM	200905	24	7	0	0	18	9	5	0	1413	859	234	766	381	21
12808	GSM	200906	45	17	2	0	24	10	8	2	1458	878	251	791	387	27
12808	GSM	200907	39	11	0	0	27	11	9	0	1497	900	262	804	393	27
12808	GSM	200908	25	8	0	0	17	12	6	0	1522	914	270	822	402	31
12808	GSM	200909	15	4	0	0	11	4	3	0	1537	922	274	827	403	31
12808	GSM	200910	41	8	0	0	28	16	7	0	1578	942	282	853	411	32
12808	GSM	200911	15	2	0	0	13	7	2	0	1593	953	284	861	416	32
12808	GSM	200912	9	3	0	0	9	5	3	0	1602	958	287	866	417	32
12808	GSM	201001	37	5	0	0	23	12	4	0	1639	973	292	887	421	33
12808	GSM	201002	32	3	0	0	25	13	3	0	1671	994	295	905	430	33
12808	GSM	201003	25	7	0	0	22	12	7	0	1696	1009	302	920	435	34
12808	GSM	201004	30	7	0	0	18	7	5	0	1726	1024	309	933	439	34
12808	GSM	201005	13	2	0	0	8	7	2	0	1739	1027	311	945	441	35
12808	GSM	201006	9	2	0	0	7	4	2	0	1748	1032	313	951	443	35
12808	GSM	201007	18	6	0	0	16	9	6	0	1766	1044	319	961	448	35
12808	GSM	201008	16	5	0	0	11	5	4	0	1782	1052	324	967	450	35
12808	GSM	201009	19	5	0	0	13	7	3	0	1801	1064	329	977	456	35
12808	GSM	201010	21	4	0	0	11	6	3	0	1822	1074	333	987	461	35
12808	GSM	201011	14	1	0	0	10	3	1	0	1836	1082	334	991	462	35
12808	GSM	201012	15	3	0	0	13	7	3	0	1851	1092	337	998	466	35
12808	GSM	201101	10	1	0	0	9	3	1	0	1861	1099	338	1002	467	35
12808	GSM	201102	32	8	0	0	22	9	4	0	1893	1118	346	1016	473	36
12808	GSM	201103	20	5	0	0	17	9	5	0	1913	1131	351	1028	478	37
12808	GSM	201104	30	5	0	0	19	8	5	0	1943	1147	356	1039	483	37
12808	GSM	201105	18	3	0	0	12	8	3	0	1961	1156	359	1053	488	38
12808	GSM	201106	31	6	0	0	13	10	4	0	1992	1167	365	1080	496	41
12808	GSM	201107	18	3	0	0	13	5	3	0	2010	1177	368	1087	499	41
12808	GSM	201108	19	5	0	0	13	7	2	0	2029	1189	373	1097	505	42
12808	GSM	201109	13	3	0	0	11	6	3	0	2042	1198	376	1103	509	42
12808	GSM	201110	14	2	0	0	13	7	1	0	2056	1207	378	1111	512	42
12808	GSM	201111	7	1	0	0	6	3	1	0	2063	1212	379	1115	514	43
12808	GSM	201112	9	1	0	0	7	3	1	0	2072	1218	380	1118	516	43
12808	GSM	201201	12	2	0	0	10	6	2	0	2084	1226	382	1125	520	43
12808	GSM	201202	14	3	0	0	11	6	1	0	2098	1236	385	1133	525	45
12808	GSM	201203	18	3	0	0	14	7	3	0	2116	1246	388	1141	528	45
12808	GSM	201204	6	2	0	0	6	2	2	0	2122	1252	390	1143	530	45
12808	GSM	201205	12	3	0	0	10	6	3	0	2134	1261	393	1150	535	45
12808	GSM	201206	3	1	0	0	3	2	1	0	2137	1263	394	1152	536	45
12808	GSM	201207	9	3	0	0	8	6	2	0	2146	1269	397	1159	540	46
12808	GSM	201208	4	0	0	0	3	1	0	0	2150	1272	397	1160	541	46
12808	GSM	201209	28	3	0	0	10	4	3	0	2178	1280	400	1179	543	46
12808	GSM	201210	8	2	0	0	6	4	2	0	2186	1285	402	1185	546	48
12808	GSM	201211	11	2	0	0	9	4	1	0	2197	1293	404	1190	549	48
12808	GSM	201212	2	0	0	0	2	1	0	0	2199	1295	404	1191	550	48
12808	GSM	201301	6	1	0	0	6	2	1	0	2205	1301	405	1193	552	48
12808	GSM	201302	7	2	0	0	7	3	2	0	2212	1307	407	1196	554	48
12808	GSM	201303	8	2	0	0	8	6	2	0	2220	1314	409	1202	559	48
12808	GSM	201304	4	1	0	0	4	1	1	0	2224	1318	410	1203	560	48
12808	GSM	201305	12	1	0	0	7	3	1	0	2236	1324	411	1210	562	48
12808	GSM	201306	14	6	1	0	12	6	6	1	2250	1333	417	1216	565	49
12808	GSM	201307	9	1	0	0	8	2	1	0	2259	1341	418	1218	567	49
12808	GSM	201308	7	2	0	0	6	5	2	0	2266	1346	420	1224	571	50
12808	GSM	201309	1	0	0	0	1	0	0	0	2267	1347	420	1224	571	50
12808	GSM	201310	3	0	0	0	3	2	0	0	2270	1349	420	1226	571	50
12808	GSM	201311	11	0	0	0	10	7	0	0	2281	1358	420	1234	577	50
12808	GSM	201312	5	0	0	0	4	1	0	0	2286	1362	420	1235	578	50
12808	GSM	201401	8	1	0	0	7	2	1	0	2294	1368	421	1237	579	50
12808	GSM	201402	6	1	0	0	6	3	1	0	2300	1373	422	1240	581	50
12808	GSM	201403	16	7	0	0	13	6	6	0	2316	1383	429	1247	584	50
12808	GSM	201404	6	1	0	0	5	2	1	0	2322	1388	430	1249	586	50
12808	GSM	201405	7	2	0	0	5	2	2	0	2329	1393	432	1251	588	50
12808	GSM	201406	4	1	0	0	4	2	1	0	2333	1396	433	1253	589	50
12808	GSM	201407	7	3	0	0	6	4	3	0	2340	1400	436	1258	591	52
12808	GSM	201408	7	1	0	0	6	3	1	0	2347	1405	437	1262	593	52
12808	GSM	201409	9	2	0	0	6	4	2	0	2356	1411	439	1269	597	53
12808	GSM	201410	7	1	0	0	6	3	1	0	2363	1417	440	1273	600	53
12808	GSM	201411	4	0	0	0	4	3	0	0	2367	1421	440	1276	603	53
12808	GSM	201412	2	1	0	0	2	1	1	0	2369	1422	441	1277	603	53
12808	GSM	201501	3	1	0	0	3	2	1	0	2372	1425	442	1279	605	54
12808	GSM	201502	3	0	0	0	3	2	0	0	2375	1428	442	1281	607	54
12808	GSM	201503	3	1	0	0	3	1	1	0	2378	1431	443	1282	608	54
12808	GSM	201504	19	1	0	0	9	2	1	0	2397	1439	444	1291	610	54
12808	GSM	201505	2	0	0	0	2	1	0	0	2399	1440	444	1292	610	54
12808	GSM	201506	9	3	0	0	9	7	3	0	2408	1446	447	1299	614	55
12808	GSM	201507	8	0	0	0	6	4	0	0	2416	1451	447	1305	617	55
12808	GSM	201508	5	1	0	0	5	2	1	0	2421	1455	448	1307	618	55
12808	GSM	201509	3	0	0	0	2	2	0	0	2424	1456	448	1310	619	55
12808	GSM	201510	8	3	0	0	7	4	3	0	2432	1462	451	1314	622	55
12808	GSM	201511	13	6	0	0	10	6	4	0	2445	1470	457	1322	625	56
12808	GSM	201512	1	0	0	0	1	1	0	0	2446	1471	457	1323	626	56
12808	GSM	201601	6	2	0	0	6	3	2	0	2452	1476	459	1326	628	56
12808	GSM	201602	8	3	0	0	6	5	2	0	2460	1481	462	1332	632	57
12808	GSM	201603	6	2	0	0	4	3	2	0	2466	1483	464	1337	633	58
12808	GSM	201604	8	3	0	0	6	2	2	0	2474	1488	467	1340	634	58
12808	GSM	201605	1	1	0	0	1	1	1	0	2475	1488	468	1341	634	58
12808	GSM	201607	2	0	0	0	1	0	0	0	2477	1489	468	1341	634	58
12808	GSM	201608	3	1	0	0	3	2	1	0	2480	1492	469	1343	636	59
12808	GSM	201609	6	0	0	0	6	4	0	0	2486	1495	469	1347	637	59
12808	GSM	201610	7	1	0	0	7	4	1	0	2493	1499	470	1351	639	59
12808	GSM	201611	8	2	0	0	6	3	2	0	2501	1504	472	1355	641	59
12808	GSM	201612	6	1	0	0	5	4	1	0	2507	1507	473	1360	642	59
12808	GSM	201701	4	1	0	0	4	3	1	0	2511	1510	474	1363	644	59
12808	GSM	201702	10	1	0	0	6	5	1	0	2521	1516	475	1372	648	59
12808	GSM	201703	8	2	0	0	7	5	2	0	2529	1521	477	1378	651	59
12808	GSM	201704	12	1	0	0	10	7	1	0	2541	1529	478	1387	655	60
12808	GSM	201705	4	0	0	0	4	2	0	0	2545	1532	478	1389	656	60
12808	GSM	201706	3	1	0	0	2	1	1	0	2548	1534	479	1390	657	60
12808	GSM	201707	5	1	0	0	5	2	1	0	2553	1538	480	1392	658	60
12808	GSM	201708	2	0	0	0	2	1	0	0	2555	1540	480	1393	658	60
12808	GSM	201709	13	1	0	0	11	10	1	0	2568	1550	481	1405	666	61
12808	GSM	201710	12	4	0	0	10	7	4	0	2580	1554	485	1414	667	63
12808	GSM	201711	8	3	0	0	8	3	3	0	2588	1560	488	1417	668	63
12808	GSM	201712	3	0	0	0	3	2	0	0	2591	1563	488	1419	670	63
12808	GSM	201801	6	1	0	0	6	2	1	0	2597	1568	489	1421	671	63
12808	GSM	201802	2	0	0	0	2	1	0	0	2599	1570	489	1422	671	63
12808	GSM	201803	4	2	0	0	3	3	2	0	2603	1571	491	1426	671	65
12808	GSM	201804	5	0	0	0	4	2	0	0	2608	1575	491	1428	673	65
12808	GSM	201805	1	0	0	0	1	1	0	0	2609	1576	491	1429	673	65
12808	GSM	201806	2	0	0	0	2	2	0	0	2611	1577	491	1431	674	65
12808	GSM	201807	1	0	0	0	1	1	0	0	2612	1577	491	1432	674	65
11866	Global_Positioning_System	200112	1	0	0	0	1	1	0	0	1	1	0	1	1	0
11866	Global_Positioning_System	200202	5	0	0	0	4	4	0	0	6	5	0	6	5	0
11866	Global_Positioning_System	200203	1	0	0	0	1	1	0	0	7	6	0	7	5	0
11866	Global_Positioning_System	200204	8	0	0	0	7	3	0	0	15	13	0	10	8	0
11866	Global_Positioning_System	200205	3	0	0	0	2	2	0	0	18	14	0	13	9	0
11866	Global_Positioning_System	200206	2	0	0	0	2	1	0	0	20	15	0	14	9	0
11866	Global_Positioning_System	200207	1	0	0	0	1	1	0	0	21	15	0	15	9	0
11866	Global_Positioning_System	200208	3	0	0	0	1	1	0	0	24	16	0	18	10	0
11866	Global_Positioning_System	200210	2	0	0	0	2	1	0	0	26	18	0	19	11	0
11866	Global_Positioning_System	200212	2	0	0	0	2	1	0	0	28	20	0	20	12	0
11866	Global_Positioning_System	200301	4	0	0	0	4	2	0	0	32	24	0	22	14	0
11866	Global_Positioning_System	200302	8	0	0	0	7	4	0	0	40	31	0	26	18	0
11866	Global_Positioning_System	200303	15	0	0	0	6	3	0	0	55	36	0	36	20	0
11866	Global_Positioning_System	200305	6	0	0	0	2	2	0	0	61	37	0	42	21	0
11866	Global_Positioning_System	200306	5	0	0	0	5	3	0	0	66	42	0	45	24	0
11866	Global_Positioning_System	200307	4	0	0	0	4	2	0	0	70	46	0	47	26	0
11866	Global_Positioning_System	200308	22	0	0	0	4	1	0	0	92	50	0	48	27	0
11866	Global_Positioning_System	200309	4	0	0	0	3	1	0	0	96	53	0	50	28	0
11866	Global_Positioning_System	200311	5	0	0	0	4	4	0	0	101	57	0	55	32	0
11866	Global_Positioning_System	200312	1	0	0	0	1	1	0	0	102	58	0	56	33	0
11866	Global_Positioning_System	200401	1	0	0	0	1	1	0	0	103	59	0	57	34	0
11866	Global_Positioning_System	200402	1	0	0	0	1	1	0	0	104	60	0	58	35	0
11866	Global_Positioning_System	200403	1	0	0	0	1	1	0	0	105	61	0	59	36	0
11866	Global_Positioning_System	200404	16	0	0	0	8	4	0	0	121	68	0	65	39	0
11866	Global_Positioning_System	200405	2	0	0	0	2	1	0	0	123	70	0	66	40	0
11866	Global_Positioning_System	200406	10	0	0	0	6	5	0	0	133	75	0	74	44	0
11866	Global_Positioning_System	200407	13	0	0	0	11	8	0	0	146	85	0	84	51	0
11866	Global_Positioning_System	200408	22	0	0	0	14	6	0	0	168	98	0	97	56	0
11866	Global_Positioning_System	200409	6	0	0	0	4	3	0	0	174	102	0	102	59	0
11866	Global_Positioning_System	200410	23	2	0	0	15	9	2	0	197	114	2	119	65	2
11866	Global_Positioning_System	200411	13	1	0	0	12	8	1	0	210	122	3	127	69	2
11866	Global_Positioning_System	200412	22	1	0	0	15	7	1	0	232	136	4	137	75	2
11866	Global_Positioning_System	200501	11	1	0	0	7	3	1	0	243	142	5	143	77	2
11866	Global_Positioning_System	200502	16	2	0	0	13	7	2	0	259	153	7	151	82	2
11866	Global_Positioning_System	200503	16	0	0	0	12	5	0	0	275	163	7	158	85	2
11866	Global_Positioning_System	200504	26	3	0	0	16	7	2	0	301	177	10	171	90	2
11866	Global_Positioning_System	200505	31	3	0	0	15	11	3	0	332	190	13	186	99	2
11866	Global_Positioning_System	200506	26	2	0	0	17	9	2	0	358	203	15	203	104	3
11866	Global_Positioning_System	200507	17	1	0	0	14	8	1	0	375	217	16	214	112	3
11866	Global_Positioning_System	200508	33	2	0	0	23	11	2	0	408	240	18	228	123	3
11866	Global_Positioning_System	200509	30	3	0	0	23	13	2	0	438	260	21	244	133	3
11866	Global_Positioning_System	200510	43	6	0	0	30	11	4	0	481	289	27	259	143	3
11866	Global_Positioning_System	200511	44	4	0	0	31	11	2	0	525	317	31	275	151	3
11866	Global_Positioning_System	200512	42	9	0	0	30	16	8	0	567	341	40	295	162	4
11866	Global_Positioning_System	200601	99	8	0	0	54	32	7	0	666	392	48	362	191	4
11866	Global_Positioning_System	200602	125	5	0	0	48	28	4	0	791	433	53	459	213	4
11866	Global_Positioning_System	200603	136	8	0	0	38	18	6	0	927	465	61	566	226	5
11866	Global_Positioning_System	200604	72	6	0	0	45	19	6	0	999	505	67	601	241	7
11866	Global_Positioning_System	200605	41	6	0	0	27	11	4	0	1040	527	73	624	248	9
11866	Global_Positioning_System	200606	115	9	0	0	52	19	7	0	1155	575	82	698	264	9
11866	Global_Positioning_System	200607	87	14	1	0	53	22	10	1	1242	621	96	740	279	11
11866	Global_Positioning_System	200608	69	10	0	0	47	22	8	0	1311	660	106	775	295	12
11866	Global_Positioning_System	200609	139	42	10	5	57	31	15	5	1450	709	148	837	321	20
11866	Global_Positioning_System	200610	180	45	10	6	71	38	15	4	1630	768	193	968	348	47
11866	Global_Positioning_System	200611	88	35	25	24	26	23	9	4	1718	788	228	1051	365	78
11866	Global_Positioning_System	200612	110	17	1	1	60	40	10	1	1828	834	245	1132	392	81
11866	Global_Positioning_System	200701	277	20	3	2	66	37	10	2	2105	884	265	1355	414	86
11866	Global_Positioning_System	200702	165	20	0	0	66	37	13	0	2270	938	285	1464	440	92
11866	Global_Positioning_System	200703	69	15	0	0	43	20	13	0	2339	972	300	1490	451	94
11866	Global_Positioning_System	200704	90	22	0	0	52	29	13	0	2429	1015	322	1555	471	97
11866	Global_Positioning_System	200705	107	19	1	0	67	34	15	1	2536	1069	341	1611	493	100
11866	Global_Positioning_System	200706	76	18	0	0	49	28	14	0	2612	1111	359	1657	514	104
11866	Global_Positioning_System	200707	66	13	0	0	45	19	10	0	2678	1150	372	1689	527	105
11866	Global_Positioning_System	200708	40	4	0	0	30	19	4	0	2718	1169	376	1718	535	106
11866	Global_Positioning_System	200709	57	15	0	0	39	18	9	0	2775	1200	391	1750	545	108
11866	Global_Positioning_System	200710	200	50	0	0	95	49	30	0	2975	1277	441	1846	578	110
11866	Global_Positioning_System	200711	140	39	1	0	76	41	22	1	3115	1329	480	1934	600	119
11866	Global_Positioning_System	200712	114	16	0	0	54	22	9	0	3229	1368	496	2003	608	122
11866	Global_Positioning_System	200801	132	27	1	0	61	36	17	1	3361	1414	523	2097	629	126
11866	Global_Positioning_System	200802	60	17	0	0	44	25	13	0	3421	1444	540	2134	641	131
11866	Global_Positioning_System	200803	72	14	0	0	39	18	8	0	3493	1477	554	2180	654	135
11866	Global_Positioning_System	200804	124	36	4	3	64	34	24	2	3617	1528	590	2238	676	141
11866	Global_Positioning_System	200805	71	12	0	0	37	19	9	0	3688	1553	602	2275	684	143
11866	Global_Positioning_System	200806	82	30	0	0	57	30	19	0	3770	1595	632	2318	699	145
11866	Global_Positioning_System	200807	87	22	1	0	47	26	17	1	3857	1634	654	2378	717	150
11866	Global_Positioning_System	200808	113	10	0	0	41	26	8	0	3970	1666	664	2471	734	152
11866	Global_Positioning_System	200809	134	17	0	0	48	24	13	0	4104	1701	681	2571	745	154
11866	Global_Positioning_System	200810	158	41	3	3	77	36	26	2	4262	1763	722	2655	766	159
11866	Global_Positioning_System	200811	108	23	0	0	55	30	16	0	4370	1808	745	2724	788	161
11866	Global_Positioning_System	200812	125	27	5	2	52	32	21	3	4495	1842	772	2822	803	174
11866	Global_Positioning_System	200901	113	15	0	0	47	21	12	0	4608	1878	787	2902	814	175
11866	Global_Positioning_System	200902	121	32	5	2	64	29	19	2	4729	1928	819	2976	831	179
11866	Global_Positioning_System	200903	77	20	2	1	42	27	12	2	4806	1961	839	3025	849	184
11866	Global_Positioning_System	200904	46	11	0	0	35	18	8	0	4852	1988	850	3050	860	185
11866	Global_Positioning_System	200905	98	12	0	0	49	27	10	0	4950	2024	862	3086	874	185
11866	Global_Positioning_System	200906	38	7	0	0	30	17	6	0	4988	2049	869	3107	886	186
11866	Global_Positioning_System	200907	47	10	0	0	37	26	8	0	5035	2071	879	3142	898	189
11866	Global_Positioning_System	200908	29	4	0	0	16	9	3	0	5064	2086	883	3162	906	189
11866	Global_Positioning_System	200909	125	10	0	0	30	20	6	0	5189	2108	893	3250	919	191
11866	Global_Positioning_System	200910	57	14	0	0	39	18	10	0	5246	2139	907	3284	929	191
11866	Global_Positioning_System	200911	72	13	0	0	34	20	10	0	5318	2163	920	3328	939	191
11866	Global_Positioning_System	200912	55	13	0	0	33	20	10	0	5373	2189	933	3368	952	193
11866	Global_Positioning_System	201001	75	14	0	0	42	27	12	0	5448	2222	947	3424	970	197
11866	Global_Positioning_System	201002	58	10	0	0	36	21	6	0	5506	2248	957	3466	982	201
11866	Global_Positioning_System	201003	48	9	0	0	36	25	7	0	5554	2271	966	3497	994	205
11866	Global_Positioning_System	201004	29	6	0	0	25	18	6	0	5583	2285	972	3518	1001	207
11866	Global_Positioning_System	201005	71	10	0	0	28	21	5	0	5654	2303	982	3580	1012	210
11866	Global_Positioning_System	201006	115	20	3	0	46	30	13	1	5769	2334	1002	3663	1028	216
11866	Global_Positioning_System	201007	82	6	1	0	42	26	5	1	5851	2361	1008	3728	1039	218
11866	Global_Positioning_System	201008	83	7	0	0	30	20	7	0	5934	2385	1015	3799	1053	223
11866	Global_Positioning_System	201009	45	8	0	0	30	21	5	0	5979	2406	1023	3833	1065	225
11866	Global_Positioning_System	201010	40	12	0	0	33	18	11	0	6019	2429	1035	3855	1073	226
11866	Global_Positioning_System	201011	83	18	2	0	54	26	16	2	6102	2468	1053	3898	1086	229
11866	Global_Positioning_System	201012	42	5	0	0	34	16	5	0	6144	2495	1058	3919	1095	229
11866	Global_Positioning_System	201101	31	6	0	0	21	12	5	0	6175	2511	1064	3933	1102	230
11866	Global_Positioning_System	201102	41	7	0	0	25	11	4	0	6216	2533	1071	3956	1110	233
11866	Global_Positioning_System	201103	80	13	0	0	47	30	10	0	6296	2565	1084	4016	1125	235
11866	Global_Positioning_System	201104	30	8	0	0	22	10	6	0	6326	2580	1092	4029	1128	235
11866	Global_Positioning_System	201105	62	13	0	0	36	14	7	0	6388	2610	1105	4064	1136	235
11866	Global_Positioning_System	201106	63	10	0	0	28	13	7	0	6451	2629	1115	4099	1143	238
11866	Global_Positioning_System	201107	42	9	0	0	25	16	7	0	6493	2644	1124	4129	1149	240
11866	Global_Positioning_System	201108	42	5	0	0	27	18	5	0	6535	2662	1129	4152	1158	241
11866	Global_Positioning_System	201109	24	5	0	0	20	11	4	0	6559	2678	1134	4167	1166	241
11866	Global_Positioning_System	201110	50	14	0	0	26	15	7	0	6609	2695	1148	4200	1172	243
11866	Global_Positioning_System	201111	76	9	1	0	44	25	7	1	6685	2726	1157	4248	1184	244
11866	Global_Positioning_System	201112	65	11	0	0	34	19	7	0	6750	2751	1168	4291	1194	247
11866	Global_Positioning_System	201201	39	7	0	0	26	16	5	0	6789	2767	1175	4318	1200	247
11866	Global_Positioning_System	201202	50	11	0	0	36	24	8	0	6839	2790	1186	4355	1212	250
11866	Global_Positioning_System	201203	31	11	0	0	25	14	7	0	6870	2806	1197	4374	1217	252
11866	Global_Positioning_System	201204	52	12	1	0	26	16	9	1	6922	2822	1209	4407	1223	255
11866	Global_Positioning_System	201205	37	11	0	0	26	13	7	0	6959	2838	1220	4431	1226	257
11866	Global_Positioning_System	201206	30	12	2	1	22	14	8	2	6989	2852	1232	4450	1232	259
11866	Global_Positioning_System	201207	30	9	0	0	21	13	5	0	7019	2864	1241	4472	1237	262
11866	Global_Positioning_System	201208	38	13	5	2	20	14	9	2	7057	2874	1254	4492	1242	268
11866	Global_Positioning_System	201209	25	4	0	0	19	13	4	0	7082	2887	1258	4510	1249	268
11866	Global_Positioning_System	201210	76	12	1	1	31	20	9	1	7158	2910	1270	4570	1261	272
11866	Global_Positioning_System	201211	51	17	0	0	36	17	7	0	7209	2938	1287	4600	1270	273
11866	Global_Positioning_System	201212	28	5	0	0	17	12	5	0	7237	2949	1292	4623	1276	273
11866	Global_Positioning_System	201301	37	9	0	0	28	17	5	0	7274	2967	1301	4648	1283	273
11866	Global_Positioning_System	201302	24	5	0	0	17	13	5	0	7298	2978	1306	4665	1290	274
11866	Global_Positioning_System	201303	27	7	0	0	24	15	4	0	7325	2993	1313	4683	1296	275
11866	Global_Positioning_System	201304	29	9	0	0	19	15	7	0	7354	3007	1322	4706	1306	279
11866	Global_Positioning_System	201305	29	7	0	0	20	12	5	0	7383	3021	1329	4721	1312	280
11866	Global_Positioning_System	201306	30	13	2	0	23	15	10	2	7413	3037	1342	4741	1320	286
11866	Global_Positioning_System	201307	27	7	0	0	21	16	6	0	7440	3052	1349	4761	1331	288
11866	Global_Positioning_System	201308	18	7	0	0	16	11	6	0	7458	3061	1356	4774	1335	290
11866	Global_Positioning_System	201309	43	6	0	0	25	17	5	0	7501	3076	1362	4807	1342	291
11866	Global_Positioning_System	201310	32	7	0	0	22	16	6	0	7533	3092	1369	4831	1352	291
11866	Global_Positioning_System	201311	30	10	0	0	25	16	9	0	7563	3111	1379	4849	1362	291
11866	Global_Positioning_System	201312	16	4	0	0	15	8	4	0	7579	3123	1383	4857	1367	291
11866	Global_Positioning_System	201401	47	13	4	2	29	13	7	3	7626	3145	1396	4880	1373	293
11866	Global_Positioning_System	201402	24	4	0	0	18	13	4	0	7650	3158	1400	4896	1381	293
11866	Global_Positioning_System	201403	17	5	0	0	14	8	4	0	7667	3166	1405	4906	1383	293
11866	Global_Positioning_System	201404	6	1	0	0	6	5	1	0	7673	3168	1406	4911	1383	293
11866	Global_Positioning_System	201405	31	5	0	0	20	16	5	0	7704	3180	1411	4936	1391	294
11866	Global_Positioning_System	201406	19	5	0	0	15	9	4	0	7723	3189	1416	4947	1394	295
11866	Global_Positioning_System	201407	22	4	0	0	15	9	4	0	7745	3198	1420	4960	1397	296
11866	Global_Positioning_System	201408	9	3	0	0	8	6	2	0	7754	3202	1423	4967	1399	297
11866	Global_Positioning_System	201409	20	4	0	0	16	11	3	0	7774	3213	1427	4980	1405	298
11866	Global_Positioning_System	201410	20	4	0	0	13	7	4	0	7794	3222	1431	4990	1408	298
11866	Global_Positioning_System	201411	21	5	0	0	19	11	5	0	7815	3235	1436	5003	1412	298
11866	Global_Positioning_System	201412	57	8	0	0	22	11	6	0	7872	3251	1444	5046	1417	298
11866	Global_Positioning_System	201501	12	2	0	0	8	5	2	0	7884	3257	1446	5052	1420	299
11866	Global_Positioning_System	201502	33	8	0	0	20	15	6	0	7917	3270	1454	5080	1428	304
11866	Global_Positioning_System	201503	56	15	2	1	29	20	11	2	7973	3288	1469	5121	1436	308
11866	Global_Positioning_System	201504	39	5	0	0	23	15	5	0	8012	3305	1474	5151	1443	309
11866	Global_Positioning_System	201505	28	3	0	0	13	8	2	0	8040	3313	1477	5171	1446	310
11866	Global_Positioning_System	201506	23	6	0	0	12	8	2	0	8063	3322	1483	5184	1451	311
11866	Global_Positioning_System	201507	41	10	4	2	22	14	7	2	8104	3334	1493	5214	1454	317
11866	Global_Positioning_System	201508	15	3	0	0	13	10	3	0	8119	3342	1496	5226	1459	318
11866	Global_Positioning_System	201509	28	6	0	0	20	13	4	0	8147	3354	1502	5247	1464	320
11866	Global_Positioning_System	201510	54	17	1	0	27	15	10	1	8201	3374	1519	5272	1472	322
11866	Global_Positioning_System	201511	46	15	0	0	27	19	10	0	8247	3393	1534	5307	1483	331
11866	Global_Positioning_System	201512	19	5	0	0	14	9	4	0	8266	3402	1539	5319	1486	335
11866	Global_Positioning_System	201601	15	3	0	0	11	9	3	0	8281	3407	1542	5332	1489	336
11866	Global_Positioning_System	201602	13	2	0	0	11	8	1	0	8294	3412	1544	5341	1490	336
11866	Global_Positioning_System	201603	30	3	0	0	15	11	3	0	8324	3422	1547	5364	1495	336
11866	Global_Positioning_System	201604	24	9	0	0	17	11	6	0	8348	3433	1556	5378	1500	336
11866	Global_Positioning_System	201605	28	6	0	0	16	8	4	0	8376	3444	1562	5390	1503	337
11866	Global_Positioning_System	201606	23	2	0	0	17	8	2	0	8399	3456	1564	5400	1506	337
11866	Global_Positioning_System	201607	14	5	0	0	14	10	5	0	8413	3466	1569	5410	1513	338
11866	Global_Positioning_System	201608	16	3	0	0	11	9	3	0	8429	3472	1572	5424	1516	339
11866	Global_Positioning_System	201609	23	4	0	0	17	11	3	0	8452	3483	1576	5440	1521	339
11866	Global_Positioning_System	201610	13	4	0	0	13	7	4	0	8465	3492	1580	5447	1523	339
11866	Global_Positioning_System	201611	29	9	0	0	16	9	4	0	8494	3504	1589	5467	1526	343
11866	Global_Positioning_System	201612	21	6	0	0	10	6	3	0	8515	3511	1595	5481	1526	348
11866	Global_Positioning_System	201701	14	3	0	0	14	10	3	0	8529	3518	1598	5491	1529	349
11866	Global_Positioning_System	201702	28	10	1	0	19	14	8	1	8557	3530	1608	5513	1535	355
11866	Global_Positioning_System	201703	22	4	0	0	20	15	4	0	8579	3544	1612	5530	1544	356
11866	Global_Positioning_System	201704	24	2	0	0	13	10	2	0	8603	3554	1614	5551	1549	357
11866	Global_Positioning_System	201705	35	9	0	0	17	9	7	0	8638	3565	1623	5570	1551	359
11866	Global_Positioning_System	201706	19	2	0	0	14	8	2	0	8657	3572	1625	5580	1552	360
11866	Global_Positioning_System	201707	17	2	0	0	11	8	2	0	8674	3579	1627	5594	1556	360
11866	Global_Positioning_System	201708	28	8	0	0	17	12	4	0	8702	3587	1635	5616	1557	363
11866	Global_Positioning_System	201709	6	0	0	0	6	6	0	0	8708	3592	1635	5622	1561	363
11866	Global_Positioning_System	201710	17	2	0	0	9	4	2	0	8725	3597	1637	5627	1561	363
11866	Global_Positioning_System	201711	37	13	0	0	29	18	10	0	8762	3620	1650	5649	1570	364
11866	Global_Positioning_System	201712	21	6	0	0	14	9	5	0	8783	3631	1656	5661	1575	366
11866	Global_Positioning_System	201801	17	4	0	0	16	14	4	0	8800	3640	1660	5676	1580	369
11866	Global_Positioning_System	201802	20	6	0	0	15	11	4	0	8820	3649	1666	5691	1584	370
11866	Global_Positioning_System	201803	16	5	0	0	13	10	5	0	8836	3661	1671	5701	1592	372
11866	Global_Positioning_System	201804	47	8	0	0	20	17	6	0	8883	3672	1679	5745	1598	378
11866	Global_Positioning_System	201805	12	3	0	0	9	5	2	0	8895	3678	1682	5752	1600	378
11866	Global_Positioning_System	201806	14	3	0	0	12	8	3	0	8909	3686	1685	5761	1604	378
11866	Global_Positioning_System	201807	13	5	0	0	11	10	4	0	8922	3692	1690	5773	1606	383
1092923	Google	200411	30	0	0	0	6	5	0	0	30	6	0	29	5	0
1092923	Google	200412	48	0	0	0	17	14	0	0	78	22	0	74	18	0
1092923	Google	200501	13	1	0	0	10	7	1	0	91	32	1	84	25	1
1092923	Google	200502	51	1	0	0	9	8	1	0	142	38	2	134	30	1
1092923	Google	200503	76	6	0	0	38	25	5	0	218	74	8	188	53	2
1092923	Google	200504	55	9	0	0	34	16	5	0	273	104	17	220	65	2
1092923	Google	200505	137	33	0	0	86	51	22	0	410	177	50	296	104	6
1092923	Google	200506	68	16	0	0	58	34	13	0	478	224	66	336	127	8
1092923	Google	200507	120	23	0	0	83	44	17	0	598	295	89	397	160	15
1092923	Google	200508	118	14	0	0	73	38	12	0	716	357	103	467	187	16
1092923	Google	200509	123	23	0	0	84	45	16	0	839	434	126	532	225	20
1092923	Google	200510	187	45	0	0	118	50	30	0	1026	537	171	614	261	24
1092923	Google	200511	310	59	0	0	170	75	37	0	1336	684	230	769	314	31
1092923	Google	200512	255	63	0	0	151	64	32	0	1591	809	293	903	355	34
1092923	Google	200601	256	71	0	0	160	78	42	0	1847	943	364	1026	409	40
1092923	Google	200602	442	113	4	0	267	137	67	4	2289	1174	477	1286	514	61
1092923	Google	200603	309	97	2	1	196	92	56	2	2598	1341	574	1459	578	80
1092923	Google	200604	445	160	12	4	237	106	82	8	3043	1537	734	1700	647	117
1092923	Google	200605	499	176	7	0	285	133	81	6	3542	1779	910	1977	746	150
1092923	Google	200606	494	185	14	1	289	123	89	7	4036	2017	1095	2234	830	176
1092923	Google	200607	256	95	3	0	177	89	52	3	4292	2162	1190	2377	890	194
1092923	Google	200608	370	103	8	4	179	93	52	4	4662	2308	1293	2606	953	228
1092923	Google	200609	284	92	1	0	167	75	43	1	4946	2445	1385	2760	1003	244
1092923	Google	200610	457	196	4	0	262	119	78	3	5403	2665	1581	3021	1086	295
1092923	Google	200611	423	151	2	0	237	117	64	2	5826	2851	1732	3283	1160	331
1092923	Google	200612	94	10	0	0	42	42	6	0	5920	2875	1742	3377	1184	341
1092923	Google	200701	61	10	0	0	45	45	9	0	5981	2906	1752	3438	1215	350
1092923	Google	200702	91	17	0	0	61	61	14	0	6072	2954	1769	3529	1263	367
1092923	Google	200703	159	19	0	0	67	67	16	0	6231	3006	1788	3688	1315	386
1092923	Google	200704	140	43	0	0	89	77	33	0	6371	3078	1831	3814	1375	420
1092923	Google	200705	97	20	3	1	53	53	14	2	6468	3118	1851	3911	1415	440
1092923	Google	200706	91	22	0	0	67	67	17	0	6559	3167	1873	4002	1464	462
1092923	Google	200707	79	15	0	0	47	47	10	0	6638	3211	1888	4081	1508	477
1092923	Google	200708	283	92	0	0	182	96	56	0	6921	3364	1980	4252	1576	498
1092923	Google	200709	359	137	0	0	221	100	66	0	7280	3555	2117	4439	1646	525
1092923	Google	200710	262	93	5	1	153	82	45	5	7542	3689	2210	4599	1710	554
1092923	Google	200711	79	12	0	0	50	50	8	0	7621	3721	2222	4678	1742	566
1092923	Google	200712	78	25	1	0	54	54	18	1	7699	3763	2247	4756	1784	591
1092923	Google	200801	63	12	1	0	44	44	9	1	7762	3798	2259	4819	1819	603
1092923	Google	200802	66	15	1	0	42	42	13	1	7828	3829	2274	4885	1850	618
1092923	Google	200803	94	14	0	0	52	52	12	0	7922	3865	2288	4979	1886	632
1092923	Google	200804	65	14	0	0	49	49	11	0	7987	3901	2302	5044	1922	646
1092923	Google	200805	72	18	0	0	47	47	13	0	8059	3938	2320	5116	1959	664
1092923	Google	200806	58	18	0	0	44	44	12	0	8117	3973	2338	5174	1994	682
1092923	Google	200807	49	5	0	0	30	30	5	0	8166	3998	2343	5223	2019	687
1092923	Google	200808	26	1	0	0	17	17	1	0	8192	4009	2344	5249	2030	688
1092923	Google	200809	36	4	0	0	23	23	3	0	8228	4027	2348	5285	2048	692
1092923	Google	200810	88	17	2	0	45	45	12	2	8316	4058	2365	5373	2079	709
1092923	Google	200811	35	4	0	0	28	28	4	0	8351	4076	2369	5408	2097	713
1092923	Google	200812	44	7	0	0	29	29	6	0	8395	4095	2376	5452	2116	720
1092923	Google	200901	21	5	0	0	16	16	3	0	8416	4108	2381	5473	2129	725
1092923	Google	200902	31	5	0	0	25	25	5	0	8447	4128	2386	5504	2149	730
1092923	Google	200903	23	6	0	0	16	16	5	0	8470	4136	2392	5527	2157	736
1092923	Google	200904	21	5	0	0	18	18	4	0	8491	4147	2397	5548	2168	741
1092923	Google	200905	31	6	0	0	24	24	6	0	8522	4163	2403	5579	2184	747
1092923	Google	200906	39	10	0	0	23	23	6	0	8561	4180	2413	5618	2201	757
1092923	Google	200907	25	4	0	0	22	22	4	0	8586	4194	2417	5643	2215	761
1092923	Google	200908	23	1	0	0	21	21	1	0	8609	4207	2418	5666	2228	762
1092923	Google	200909	19	3	0	0	15	15	3	0	8628	4218	2421	5685	2239	765
1092923	Google	200910	33	1	0	0	22	22	1	0	8661	4234	2422	5718	2255	766
1092923	Google	200911	24	4	0	0	21	21	4	0	8685	4252	2426	5742	2273	770
1092923	Google	200912	15	1	0	0	10	10	1	0	8700	4260	2427	5757	2281	771
1092923	Google	201001	34	1	0	0	17	17	1	0	8734	4273	2428	5791	2294	772
1092923	Google	201002	20	2	0	0	19	19	2	0	8754	4282	2430	5811	2303	774
1092923	Google	201003	81	4	0	0	24	24	4	0	8835	4300	2434	5892	2321	778
1092923	Google	201004	46	8	0	0	23	23	5	0	8881	4318	2442	5938	2339	786
1092923	Google	201005	63	7	2	1	35	35	6	2	8944	4346	2449	6001	2367	793
1092923	Google	201006	61	11	2	1	33	33	6	2	9005	4373	2460	6062	2394	804
1092923	Google	201007	102	29	0	0	58	36	22	0	9107	4421	2489	6141	2420	813
1092923	Google	201008	71	9	1	0	25	25	5	1	9178	4440	2498	6212	2439	822
1092923	Google	201009	44	3	0	0	22	22	3	0	9222	4455	2501	6256	2454	825
1092923	Google	201010	39	0	0	0	18	18	0	0	9261	4469	2501	6295	2468	825
1092923	Google	201011	41	2	0	0	21	21	2	0	9302	4481	2503	6336	2480	827
1092923	Google	201012	13	4	2	1	6	6	2	2	9315	4484	2507	6349	2483	831
1092923	Google	201101	20	1	0	0	12	12	1	0	9335	4491	2508	6369	2490	832
1092923	Google	201102	15	0	0	0	9	9	0	0	9350	4497	2508	6384	2496	832
1092923	Google	201103	15	2	1	0	10	10	2	1	9365	4503	2510	6399	2502	834
1092923	Google	201104	28	6	1	0	22	22	4	1	9393	4522	2516	6427	2521	840
1092923	Google	201105	39	3	0	0	27	27	3	0	9432	4539	2519	6466	2538	843
1092923	Google	201106	19	1	0	0	16	16	1	0	9451	4548	2520	6485	2547	844
1092923	Google	201107	19	1	0	0	16	16	1	0	9470	4557	2521	6504	2556	845
1092923	Google	201108	26	4	0	0	20	20	3	0	9496	4571	2525	6530	2570	849
1092923	Google	201109	47	4	0	0	37	37	4	0	9543	4597	2529	6577	2596	853
1092923	Google	201110	30	1	0	0	22	22	1	0	9573	4614	2530	6607	2613	854
1092923	Google	201111	12	1	0	0	12	12	1	0	9585	4623	2531	6619	2622	855
1092923	Google	201112	14	2	1	0	7	7	2	1	9599	4627	2533	6633	2626	857
1092923	Google	201201	23	2	0	0	16	16	2	0	9622	4638	2535	6656	2637	859
1092923	Google	201202	28	3	0	0	25	25	3	0	9650	4653	2538	6684	2652	862
1092923	Google	201203	30	5	0	0	22	22	5	0	9680	4669	2543	6714	2668	867
1092923	Google	201204	12	2	0	0	12	12	2	0	9692	4679	2545	6726	2678	869
1092923	Google	201205	33	4	1	0	22	22	4	1	9725	4692	2549	6759	2691	873
1092923	Google	201206	43	9	4	3	20	20	6	2	9768	4702	2558	6802	2701	882
1092923	Google	201207	18	1	0	0	16	16	1	0	9786	4714	2559	6820	2713	883
1092923	Google	201208	25	1	0	0	17	17	1	0	9811	4722	2560	6845	2721	884
1092923	Google	201209	19	1	0	0	13	13	1	0	9830	4729	2561	6864	2728	885
1092923	Google	201210	33	1	0	0	16	16	1	0	9863	4740	2562	6897	2739	886
1092923	Google	201211	29	2	0	0	23	23	2	0	9892	4753	2564	6926	2752	888
1092923	Google	201212	14	3	0	0	12	12	3	0	9906	4762	2567	6940	2761	891
1092923	Google	201301	24	1	0	0	21	21	1	0	9930	4778	2568	6964	2777	892
1092923	Google	201302	19	2	0	0	15	15	2	0	9949	4784	2570	6983	2783	894
1092923	Google	201303	18	2	0	0	16	16	2	0	9967	4794	2572	7001	2793	896
1092923	Google	201304	29	2	0	0	21	21	2	0	9996	4809	2574	7030	2808	898
1092923	Google	201305	20	0	0	0	13	13	0	0	10016	4819	2574	7050	2818	898
1092923	Google	201306	40	2	0	0	24	24	2	0	10056	4837	2576	7090	2836	900
1092923	Google	201307	16	1	0	0	14	14	1	0	10072	4847	2577	7106	2846	901
1092923	Google	201308	27	1	0	0	16	16	1	0	10099	4856	2578	7133	2855	902
1092923	Google	201309	13	2	0	0	10	10	2	0	10112	4863	2580	7146	2862	904
1092923	Google	201310	66	1	0	0	14	14	1	0	10178	4872	2581	7212	2871	905
1092923	Google	201311	22	1	0	0	18	18	1	0	10200	4885	2582	7234	2884	906
1092923	Google	201312	42	5	0	0	19	19	3	0	10242	4899	2587	7276	2898	911
1092923	Google	201401	17	2	0	0	12	12	2	0	10259	4907	2589	7293	2906	913
1092923	Google	201402	9	1	0	0	7	7	1	0	10268	4912	2590	7302	2911	914
1092923	Google	201403	28	5	0	0	18	18	4	0	10296	4924	2595	7330	2923	919
1092923	Google	201404	14	1	0	0	14	14	1	0	10310	4933	2596	7344	2932	920
1092923	Google	201405	27	3	1	0	18	18	3	1	10337	4942	2599	7371	2941	923
1092923	Google	201406	20	2	0	0	14	14	2	0	10357	4950	2601	7391	2949	925
1092923	Google	201407	17	0	0	0	8	8	0	0	10374	4956	2601	7408	2955	925
1092923	Google	201408	17	0	0	0	13	13	0	0	10391	4962	2601	7425	2961	925
1092923	Google	201409	11	0	0	0	9	9	0	0	10402	4968	2601	7436	2967	925
1092923	Google	201410	15	1	0	0	11	11	1	0	10417	4978	2602	7451	2977	926
1092923	Google	201411	24	2	0	0	14	14	2	0	10441	4986	2604	7475	2985	928
1092923	Google	201412	26	3	0	0	18	18	3	0	10467	4995	2607	7501	2994	931
1092923	Google	201501	20	3	0	0	11	11	2	0	10487	5002	2610	7521	3001	934
1092923	Google	201502	8	0	0	0	6	6	0	0	10495	5004	2610	7529	3003	934
1092923	Google	201503	19	3	0	0	14	14	3	0	10514	5012	2613	7548	3011	937
1092923	Google	201504	40	1	0	0	16	16	1	0	10554	5021	2614	7588	3020	938
1092923	Google	201505	26	5	0	0	15	15	2	0	10580	5031	2619	7614	3030	943
1092923	Google	201506	29	2	0	0	14	14	1	0	10609	5042	2621	7643	3041	945
1092923	Google	201507	17	4	1	0	15	15	4	1	10626	5050	2625	7660	3049	949
1092923	Google	201508	7	0	0	0	6	6	0	0	10633	5053	2625	7667	3052	949
1092923	Google	201509	92	9	0	0	38	38	9	0	10725	5081	2634	7759	3080	958
1092923	Google	201510	39	4	1	0	32	32	4	1	10764	5103	2638	7798	3102	962
1092923	Google	201511	26	2	0	0	19	19	2	0	10790	5116	2640	7824	3115	964
1092923	Google	201512	14	3	0	0	13	13	3	0	10804	5123	2643	7838	3122	967
1092923	Google	201601	22	2	0	0	20	20	2	0	10826	5135	2645	7860	3134	969
1092923	Google	201602	27	2	0	0	14	14	2	0	10853	5145	2647	7887	3144	971
1092923	Google	201603	20	1	0	0	13	13	1	0	10873	5151	2648	7907	3150	972
1092923	Google	201604	9	0	0	0	8	8	0	0	10882	5156	2648	7916	3155	972
1092923	Google	201605	11	1	0	0	7	7	1	0	10893	5163	2649	7927	3162	973
1092923	Google	201606	14	3	0	0	13	13	3	0	10907	5170	2652	7941	3169	976
1092923	Google	201607	14	0	0	0	8	8	0	0	10921	5174	2652	7955	3173	976
1092923	Google	201608	11	1	0	0	10	10	1	0	10932	5180	2653	7966	3179	977
1092923	Google	201609	18	4	0	0	13	13	3	0	10950	5190	2657	7984	3189	981
1092923	Google	201610	20	2	0	0	14	14	2	0	10970	5198	2659	8004	3197	983
1092923	Google	201611	26	0	0	0	10	10	0	0	10996	5205	2659	8030	3204	983
1092923	Google	201612	46	8	0	0	20	20	4	0	11042	5218	2667	8076	3217	991
1092923	Google	201701	20	1	0	0	11	11	1	0	11062	5221	2668	8096	3220	992
1092923	Google	201702	40	4	0	0	17	17	2	0	11102	5230	2672	8136	3229	996
1092923	Google	201703	7	0	0	0	7	7	0	0	11109	5234	2672	8143	3233	996
1092923	Google	201704	29	1	0	0	13	13	1	0	11138	5239	2673	8172	3238	997
1092923	Google	201705	45	3	0	0	20	20	2	0	11183	5250	2676	8217	3249	1000
1092923	Google	201706	36	2	0	0	8	8	2	0	11219	5256	2678	8253	3255	1002
1092923	Google	201707	38	4	0	0	11	11	1	0	11257	5264	2682	8291	3263	1006
1092923	Google	201708	35	2	0	0	16	16	2	0	11292	5272	2684	8326	3271	1008
1092923	Google	201709	72	8	4	2	27	27	5	3	11364	5295	2692	8398	3294	1016
1092923	Google	201710	32	2	0	0	17	17	1	0	11396	5305	2694	8430	3304	1018
1092923	Google	201711	28	9	2	1	15	15	4	2	11424	5312	2703	8458	3311	1027
1092923	Google	201712	27	7	2	1	18	18	3	2	11451	5325	2710	8485	3324	1034
1092923	Google	201801	8	1	0	0	8	8	1	0	11459	5331	2711	8493	3330	1035
1092923	Google	201802	19	3	0	0	17	17	2	0	11478	5341	2714	8512	3340	1038
1092923	Google	201803	11	1	0	0	7	7	1	0	11489	5344	2715	8523	3343	1039
1092923	Google	201804	28	9	1	0	12	12	3	1	11517	5351	2724	8551	3350	1048
1092923	Google	201805	21	1	0	0	19	19	1	0	11538	5365	2725	8572	3364	1049
1092923	Google	201806	25	0	0	0	13	13	0	0	11563	5372	2725	8597	3371	1049
1092923	Google	201807	23	5	1	1	14	14	3	1	11586	5381	2730	8620	3380	1054
45294486	Guix_System_Distribution	201503	11	0	0	0	3	3	0	0	11	3	0	11	3	0
45294486	Guix_System_Distribution	201505	12	1	0	0	4	4	1	0	23	7	1	23	6	1
45294486	Guix_System_Distribution	201507	1	0	0	0	1	1	0	0	24	8	1	24	7	1
45294486	Guix_System_Distribution	201508	1	0	0	0	1	1	0	0	25	9	1	25	8	1
45294486	Guix_System_Distribution	201510	3	0	0	0	1	1	0	0	28	10	1	28	9	1
45294486	Guix_System_Distribution	201511	1	0	0	0	1	1	0	0	29	11	1	29	10	1
45294486	Guix_System_Distribution	201512	8	3	2	1	5	5	2	2	37	15	4	37	14	4
45294486	Guix_System_Distribution	201601	2	0	0	0	2	1	0	0	39	16	4	38	14	4
45294486	Guix_System_Distribution	201602	2	1	0	0	2	2	1	0	41	17	5	40	15	5
45294486	Guix_System_Distribution	201603	1	0	0	0	1	1	0	0	42	17	5	41	15	5
45294486	Guix_System_Distribution	201604	3	0	0	0	3	2	0	0	45	19	5	43	16	5
45294486	Guix_System_Distribution	201605	1	0	0	0	1	1	0	0	46	20	5	44	17	5
45294486	Guix_System_Distribution	201606	3	1	0	0	2	1	1	0	49	21	6	46	17	5
45294486	Guix_System_Distribution	201607	2	1	0	0	2	1	1	0	51	22	7	47	17	5
45294486	Guix_System_Distribution	201608	1	0	0	0	1	1	0	0	52	23	7	48	18	5
45294486	Guix_System_Distribution	201609	5	0	0	0	3	2	0	0	57	26	7	52	20	5
45294486	Guix_System_Distribution	201611	1	0	0	0	1	1	0	0	58	26	7	53	20	5
45294486	Guix_System_Distribution	201612	14	0	0	0	7	4	0	0	72	31	7	60	22	5
45294486	Guix_System_Distribution	201701	16	2	0	0	5	2	2	0	88	34	9	72	23	6
45294486	Guix_System_Distribution	201702	5	0	0	0	3	2	0	0	93	35	9	76	24	6
45294486	Guix_System_Distribution	201703	6	0	0	0	2	2	0	0	99	35	9	82	24	6
45294486	Guix_System_Distribution	201704	9	1	0	0	3	1	1	0	108	37	10	86	24	6
45294486	Guix_System_Distribution	201705	5	0	0	0	2	1	0	0	113	38	10	87	24	6
45294486	Guix_System_Distribution	201706	7	2	1	0	3	2	2	1	120	39	12	90	24	7
45294486	Guix_System_Distribution	201707	2	0	0	0	2	2	0	0	122	40	12	92	25	7
45294486	Guix_System_Distribution	201708	1	0	0	0	1	0	0	0	123	41	12	92	25	7
45294486	Guix_System_Distribution	201712	5	3	2	1	3	3	2	2	128	42	15	97	26	10
45294486	Guix_System_Distribution	201801	1	0	0	0	1	1	0	0	129	43	15	98	27	10
45294486	Guix_System_Distribution	201802	3	0	0	0	2	1	0	0	132	44	15	99	27	10
45294486	Guix_System_Distribution	201805	2	0	0	0	1	1	0	0	134	45	15	101	28	10
45294486	Guix_System_Distribution	201807	2	1	0	0	2	2	1	0	136	46	16	103	29	11
4939073	Homomorphic_encryption	200605	17	4	0	0	6	2	3	0	17	6	4	2	2	0
4939073	Homomorphic_encryption	200606	2	0	0	0	2	1	0	0	19	8	4	3	3	0
4939073	Homomorphic_encryption	200607	2	0	0	0	2	2	0	0	21	10	4	5	5	0
4939073	Homomorphic_encryption	200608	4	0	0	0	1	1	0	0	25	11	4	9	6	0
4939073	Homomorphic_encryption	200609	1	0	0	0	1	1	0	0	26	11	4	10	6	0
4939073	Homomorphic_encryption	200612	1	0	0	0	1	1	0	0	27	12	4	11	7	0
4939073	Homomorphic_encryption	200704	2	0	0	0	1	1	0	0	29	13	4	13	8	0
4939073	Homomorphic_encryption	200705	2	1	0	0	2	2	1	0	31	15	5	15	10	1
4939073	Homomorphic_encryption	200707	3	0	0	0	3	3	0	0	34	17	5	18	12	1
4939073	Homomorphic_encryption	200803	1	0	0	0	1	1	0	0	35	18	5	19	13	1
4939073	Homomorphic_encryption	200809	1	0	0	0	1	0	0	0	36	19	5	19	13	1
4939073	Homomorphic_encryption	200810	1	0	0	0	1	1	0	0	37	20	5	20	14	1
4939073	Homomorphic_encryption	200811	1	0	0	0	1	0	0	0	38	21	5	20	14	1
4939073	Homomorphic_encryption	200812	1	0	0	0	1	0	0	0	39	22	5	20	14	1
4939073	Homomorphic_encryption	200901	2	0	0	0	1	0	0	0	41	23	5	20	14	1
4939073	Homomorphic_encryption	200903	2	1	0	0	2	1	1	0	43	24	6	21	14	1
4939073	Homomorphic_encryption	200906	1	0	0	0	1	0	0	0	44	25	6	21	14	1
4939073	Homomorphic_encryption	200907	12	0	0	0	8	4	0	0	56	33	6	29	18	1
4939073	Homomorphic_encryption	200908	3	0	0	0	3	2	0	0	59	36	6	31	20	1
4939073	Homomorphic_encryption	200909	8	0	0	0	7	4	0	0	67	42	6	36	23	1
4939073	Homomorphic_encryption	200910	2	0	0	0	2	2	0	0	69	43	6	38	24	1
4939073	Homomorphic_encryption	201002	2	0	0	0	2	2	0	0	71	44	6	40	25	1
4939073	Homomorphic_encryption	201003	1	0	0	0	1	1	0	0	72	45	6	41	26	1
4939073	Homomorphic_encryption	201004	12	0	0	0	4	2	0	0	84	48	6	51	27	1
4939073	Homomorphic_encryption	201005	1	0	0	0	1	1	0	0	85	49	6	52	28	1
4939073	Homomorphic_encryption	201006	3	0	0	0	2	1	0	0	88	51	6	53	29	1
4939073	Homomorphic_encryption	201007	68	1	0	0	12	8	1	0	156	62	7	107	36	2
4939073	Homomorphic_encryption	201008	2	0	0	0	2	2	0	0	158	64	7	109	38	2
4939073	Homomorphic_encryption	201009	1	0	0	0	1	0	0	0	159	65	7	109	38	2
4939073	Homomorphic_encryption	201010	3	0	0	0	2	1	0	0	162	67	7	110	39	2
4939073	Homomorphic_encryption	201101	5	0	0	0	3	2	0	0	167	70	7	114	41	2
4939073	Homomorphic_encryption	201105	3	0	0	0	3	2	0	0	170	73	7	116	43	2
4939073	Homomorphic_encryption	201106	5	0	0	0	4	3	0	0	175	77	7	119	46	2
4939073	Homomorphic_encryption	201107	4	0	0	0	4	2	0	0	179	81	7	121	48	2
4939073	Homomorphic_encryption	201108	1	0	0	0	1	0	0	0	180	82	7	121	48	2
4939073	Homomorphic_encryption	201110	5	0	0	0	5	2	0	0	185	87	7	123	50	2
4939073	Homomorphic_encryption	201111	2	0	0	0	2	1	0	0	187	89	7	124	51	2
4939073	Homomorphic_encryption	201112	5	0	0	0	3	2	0	0	192	92	7	127	53	2
4939073	Homomorphic_encryption	201201	1	0	0	0	1	1	0	0	193	93	7	128	54	2
4939073	Homomorphic_encryption	201202	1	0	0	0	1	1	0	0	194	94	7	129	55	2
4939073	Homomorphic_encryption	201204	4	0	0	0	4	3	0	0	198	97	7	132	57	2
4939073	Homomorphic_encryption	201205	3	0	0	0	3	2	0	0	201	99	7	134	58	2
4939073	Homomorphic_encryption	201206	7	0	0	0	1	0	0	0	208	100	7	134	58	2
4939073	Homomorphic_encryption	201208	1	0	0	0	1	1	0	0	209	101	7	135	59	2
4939073	Homomorphic_encryption	201209	3	1	0	0	3	2	1	0	212	103	8	137	60	2
4939073	Homomorphic_encryption	201210	4	1	0	0	3	0	1	0	216	106	9	137	60	2
4939073	Homomorphic_encryption	201211	2	0	0	0	2	0	0	0	218	108	9	137	60	2
4939073	Homomorphic_encryption	201212	3	0	0	0	3	3	0	0	221	110	9	140	62	2
4939073	Homomorphic_encryption	201301	5	3	0	0	5	3	3	0	226	115	12	143	65	4
4939073	Homomorphic_encryption	201302	2	0	0	0	2	1	0	0	228	117	12	144	66	4
4939073	Homomorphic_encryption	201303	1	0	0	0	1	1	0	0	229	118	12	145	67	4
4939073	Homomorphic_encryption	201304	1	0	0	0	1	1	0	0	230	119	12	146	68	4
4939073	Homomorphic_encryption	201305	9	1	0	0	8	5	1	0	239	127	13	151	73	4
4939073	Homomorphic_encryption	201306	5	0	0	0	5	1	0	0	244	132	13	152	74	4
4939073	Homomorphic_encryption	201307	2	0	0	0	2	2	0	0	246	134	13	154	76	4
4939073	Homomorphic_encryption	201308	2	0	0	0	2	1	0	0	248	136	13	155	77	4
4939073	Homomorphic_encryption	201309	4	0	0	0	3	2	0	0	252	138	13	157	78	4
4939073	Homomorphic_encryption	201310	13	0	0	0	3	3	0	0	265	140	13	170	80	4
4939073	Homomorphic_encryption	201312	1	0	0	0	1	1	0	0	266	141	13	171	81	4
4939073	Homomorphic_encryption	201401	3	0	0	0	2	2	0	0	269	143	13	174	83	4
4939073	Homomorphic_encryption	201402	2	0	0	0	2	1	0	0	271	145	13	175	84	4
4939073	Homomorphic_encryption	201403	4	0	0	0	4	2	0	0	275	149	13	177	86	4
4939073	Homomorphic_encryption	201404	5	0	0	0	2	1	0	0	280	151	13	178	87	4
4939073	Homomorphic_encryption	201405	1	0	0	0	1	0	0	0	281	152	13	178	87	4
4939073	Homomorphic_encryption	201407	2	0	0	0	1	1	0	0	283	153	13	180	88	4
4939073	Homomorphic_encryption	201409	1	0	0	0	1	0	0	0	284	154	13	180	88	4
4939073	Homomorphic_encryption	201410	10	0	0	0	4	2	0	0	294	158	13	188	90	4
4939073	Homomorphic_encryption	201411	2	0	0	0	2	2	0	0	296	160	13	190	92	4
4939073	Homomorphic_encryption	201501	3	0	0	0	2	0	0	0	299	162	13	190	92	4
4939073	Homomorphic_encryption	201502	8	0	0	0	5	4	0	0	307	163	13	197	92	4
4939073	Homomorphic_encryption	201503	1	0	0	0	1	1	0	0	308	164	13	198	93	4
4939073	Homomorphic_encryption	201506	2	0	0	0	2	1	0	0	310	166	13	199	94	4
4939073	Homomorphic_encryption	201508	4	0	0	0	4	3	0	0	314	170	13	202	96	4
4939073	Homomorphic_encryption	201511	2	0	0	0	2	1	0	0	316	172	13	203	97	4
4939073	Homomorphic_encryption	201512	1	0	0	0	1	0	0	0	317	173	13	203	97	4
4939073	Homomorphic_encryption	201601	9	0	0	0	4	2	0	0	326	177	13	205	99	4
4939073	Homomorphic_encryption	201604	2	0	0	0	2	2	0	0	328	179	13	207	101	4
4939073	Homomorphic_encryption	201605	1	0	0	0	1	1	0	0	329	180	13	208	102	4
4939073	Homomorphic_encryption	201607	1	0	0	0	1	0	0	0	330	181	13	208	102	4
4939073	Homomorphic_encryption	201608	2	1	0	0	2	2	1	0	332	183	14	210	102	5
4939073	Homomorphic_encryption	201610	1	0	0	0	1	1	0	0	333	184	14	211	103	5
4939073	Homomorphic_encryption	201611	2	0	0	0	2	2	0	0	335	186	14	213	105	5
4939073	Homomorphic_encryption	201701	2	0	0	0	2	2	0	0	337	188	14	215	107	5
4939073	Homomorphic_encryption	201702	4	1	0	0	3	2	1	0	341	190	15	218	108	5
4939073	Homomorphic_encryption	201704	1	0	0	0	1	1	0	0	342	190	15	219	108	5
4939073	Homomorphic_encryption	201705	1	0	0	0	1	1	0	0	343	191	15	220	109	5
4939073	Homomorphic_encryption	201706	3	0	0	0	1	0	0	0	346	192	15	220	109	5
4939073	Homomorphic_encryption	201709	3	0	0	0	2	1	0	0	349	194	15	221	109	5
4939073	Homomorphic_encryption	201710	2	0	0	0	2	1	0	0	351	195	15	222	109	5
4939073	Homomorphic_encryption	201711	1	0	0	0	1	1	0	0	352	196	15	223	110	5
4939073	Homomorphic_encryption	201712	6	1	0	0	4	3	1	0	358	200	16	228	113	6
4939073	Homomorphic_encryption	201801	3	0	0	0	3	1	0	0	361	203	16	229	114	6
4939073	Homomorphic_encryption	201802	3	0	0	0	2	2	0	0	364	205	16	232	115	6
4939073	Homomorphic_encryption	201803	3	0	0	0	3	1	0	0	367	208	16	233	116	6
4939073	Homomorphic_encryption	201805	1	0	0	0	1	0	0	0	368	209	16	233	116	6
4939073	Homomorphic_encryption	201806	4	0	0	0	1	1	0	0	372	210	16	237	117	6
4939073	Homomorphic_encryption	201807	1	0	0	0	1	0	0	0	373	211	16	237	117	6
22060017	Human-computer_interaction	200905	1	0	0	0	1	1	0	0	1	1	0	1	1	0
22060017	Human-computer_interaction	201002	1	0	0	0	1	1	0	0	2	2	0	2	2	0
22060017	Human-computer_interaction	201108	1	0	0	0	1	1	0	0	3	3	0	3	3	0
22060017	Human-computer_interaction	201607	1	0	0	0	1	1	0	0	4	4	0	4	4	0
22060017	Human-computer_interaction	201705	2	1	0	0	2	1	1	0	6	6	1	5	5	0
49459089	Hyperledger	201603	8	1	0	0	6	4	1	0	8	6	1	6	4	1
49459089	Hyperledger	201604	6	4	2	0	3	1	3	2	14	8	5	8	4	3
49459089	Hyperledger	201605	7	0	0	0	4	3	0	0	21	12	5	14	7	3
49459089	Hyperledger	201606	4	0	0	0	3	3	0	0	25	14	5	18	9	3
49459089	Hyperledger	201608	5	0	0	0	4	3	0	0	30	17	5	22	11	3
49459089	Hyperledger	201609	3	0	0	0	3	3	0	0	33	20	5	25	14	3
49459089	Hyperledger	201610	1	0	0	0	1	1	0	0	34	21	5	26	15	3
49459089	Hyperledger	201612	3	0	0	0	3	2	0	0	37	24	5	28	17	3
49459089	Hyperledger	201702	2	0	0	0	2	2	0	0	39	25	5	30	18	3
49459089	Hyperledger	201703	3	0	0	0	2	1	0	0	42	27	5	31	19	3
49459089	Hyperledger	201704	4	0	0	0	4	2	0	0	46	31	5	33	21	3
49459089	Hyperledger	201705	6	0	0	0	4	3	0	0	52	34	5	38	22	3
49459089	Hyperledger	201706	20	0	0	0	5	5	0	0	72	38	5	58	26	3
49459089	Hyperledger	201707	3	0	0	0	2	1	0	0	75	40	5	59	27	3
49459089	Hyperledger	201709	5	0	0	0	3	1	0	0	80	42	5	61	28	3
49459089	Hyperledger	201710	4	0	0	0	4	4	0	0	84	46	5	65	31	3
49459089	Hyperledger	201711	1	0	0	0	1	1	0	0	85	47	5	66	32	3
49459089	Hyperledger	201712	7	0	0	0	7	4	0	0	92	54	5	70	36	3
49459089	Hyperledger	201801	7	0	0	0	6	4	0	0	99	60	5	75	40	3
49459089	Hyperledger	201802	5	0	0	0	3	3	0	0	104	63	5	80	43	3
49459089	Hyperledger	201803	3	1	0	0	3	2	1	0	107	66	6	82	44	4
49459089	Hyperledger	201804	1	0	0	0	1	1	0	0	108	66	6	83	44	4
49459089	Hyperledger	201805	13	0	0	0	6	6	0	0	121	72	6	96	50	4
49459089	Hyperledger	201806	3	1	0	0	3	2	1	0	124	74	7	98	51	5
13443	Hypertext_Transfer_Protocol	200111	1	0	0	0	1	1	0	0	1	1	0	1	1	0
13443	Hypertext_Transfer_Protocol	200202	1	0	0	0	1	1	0	0	2	2	0	2	2	0
13443	Hypertext_Transfer_Protocol	200203	2	0	0	0	2	2	0	0	4	4	0	4	4	0
13443	Hypertext_Transfer_Protocol	200204	2	0	0	0	2	1	0	0	6	6	0	5	5	0
13443	Hypertext_Transfer_Protocol	200208	1	0	0	0	1	0	0	0	7	7	0	5	5	0
13443	Hypertext_Transfer_Protocol	200209	2	0	0	0	1	0	0	0	9	8	0	5	5	0
13443	Hypertext_Transfer_Protocol	200212	1	0	0	0	1	1	0	0	10	9	0	6	6	0
13443	Hypertext_Transfer_Protocol	200301	5	0	0	0	5	2	0	0	15	14	0	8	8	0
13443	Hypertext_Transfer_Protocol	200302	7	0	0	0	6	6	0	0	22	20	0	15	14	0
13443	Hypertext_Transfer_Protocol	200306	2	0	0	0	2	1	0	0	24	22	0	16	15	0
13443	Hypertext_Transfer_Protocol	200308	4	0	0	0	3	2	0	0	28	24	0	19	16	0
13443	Hypertext_Transfer_Protocol	200312	2	0	0	0	2	2	0	0	30	26	0	21	18	0
13443	Hypertext_Transfer_Protocol	200401	4	0	0	0	3	3	0	0	34	28	0	25	20	0
13443	Hypertext_Transfer_Protocol	200402	4	0	0	0	2	2	0	0	38	29	0	29	21	0
13443	Hypertext_Transfer_Protocol	200403	1	0	0	0	1	1	0	0	39	30	0	30	22	0
13443	Hypertext_Transfer_Protocol	200404	2	0	0	0	2	2	0	0	41	32	0	32	24	0
13443	Hypertext_Transfer_Protocol	200406	1	0	0	0	1	1	0	0	42	33	0	33	25	0
13443	Hypertext_Transfer_Protocol	200407	7	0	0	0	7	7	0	0	49	39	0	40	30	0
13443	Hypertext_Transfer_Protocol	200408	1	0	0	0	1	1	0	0	50	39	0	41	30	0
13443	Hypertext_Transfer_Protocol	200409	3	1	0	0	3	1	1	0	53	42	1	42	31	0
13443	Hypertext_Transfer_Protocol	200410	5	0	0	0	5	3	0	0	58	46	1	45	33	0
13443	Hypertext_Transfer_Protocol	200411	11	2	0	0	10	8	2	0	69	54	3	53	39	1
13443	Hypertext_Transfer_Protocol	200412	10	0	0	0	8	4	0	0	79	62	3	57	43	1
13443	Hypertext_Transfer_Protocol	200501	4	1	0	0	3	1	1	0	83	65	4	58	44	1
13443	Hypertext_Transfer_Protocol	200502	5	0	0	0	5	3	0	0	88	69	4	61	46	1
13443	Hypertext_Transfer_Protocol	200503	6	1	0	0	6	3	1	0	94	74	5	64	48	1
13443	Hypertext_Transfer_Protocol	200504	11	0	0	0	8	4	0	0	105	79	5	70	50	1
13443	Hypertext_Transfer_Protocol	200505	22	4	0	0	15	10	3	0	127	92	9	87	58	1
13443	Hypertext_Transfer_Protocol	200506	7	2	0	0	6	4	2	0	134	95	11	92	59	3
13443	Hypertext_Transfer_Protocol	200507	10	2	0	0	9	6	2	0	144	102	13	98	63	3
13443	Hypertext_Transfer_Protocol	200508	9	1	0	0	9	5	1	0	153	111	14	103	68	3
13443	Hypertext_Transfer_Protocol	200509	5	0	0	0	4	3	0	0	158	115	14	107	71	3
13443	Hypertext_Transfer_Protocol	200510	20	2	0	0	14	9	2	0	178	128	16	119	79	3
13443	Hypertext_Transfer_Protocol	200511	25	5	0	0	18	7	4	0	203	143	21	128	83	3
13443	Hypertext_Transfer_Protocol	200512	20	3	0	0	10	5	3	0	223	151	24	140	86	3
13443	Hypertext_Transfer_Protocol	200601	15	3	0	0	11	6	2	0	238	161	27	148	91	3
13443	Hypertext_Transfer_Protocol	200602	16	1	0	0	13	8	1	0	254	172	28	159	97	3
13443	Hypertext_Transfer_Protocol	200603	23	4	0	0	18	12	3	0	277	187	32	173	106	3
13443	Hypertext_Transfer_Protocol	200604	20	2	0	0	15	9	2	0	297	199	34	186	112	3
13443	Hypertext_Transfer_Protocol	200605	11	0	0	0	9	7	0	0	308	207	34	194	118	3
13443	Hypertext_Transfer_Protocol	200606	18	2	0	0	15	10	2	0	326	220	36	207	126	3
13443	Hypertext_Transfer_Protocol	200607	21	1	0	0	17	6	1	0	347	237	37	214	132	3
13443	Hypertext_Transfer_Protocol	200608	25	5	0	0	21	13	5	0	372	253	42	230	140	3
13443	Hypertext_Transfer_Protocol	200609	36	7	0	0	25	13	7	0	408	274	49	250	149	5
13443	Hypertext_Transfer_Protocol	200610	19	6	0	0	17	7	6	0	427	287	55	258	152	5
13443	Hypertext_Transfer_Protocol	200611	18	6	0	0	15	9	5	0	445	299	61	269	158	5
13443	Hypertext_Transfer_Protocol	200612	23	6	0	0	19	10	6	0	468	315	67	280	165	5
13443	Hypertext_Transfer_Protocol	200701	18	5	0	0	17	10	5	0	486	332	72	291	175	6
13443	Hypertext_Transfer_Protocol	200702	18	4	0	0	15	6	4	0	504	347	76	298	181	6
13443	Hypertext_Transfer_Protocol	200703	14	3	0	0	14	8	3	0	518	361	79	306	189	7
13443	Hypertext_Transfer_Protocol	200704	63	19	0	0	37	20	10	0	581	394	98	336	206	10
13443	Hypertext_Transfer_Protocol	200705	54	18	0	0	34	15	13	0	635	423	116	358	216	11
13443	Hypertext_Transfer_Protocol	200706	52	15	1	0	42	23	11	1	687	455	131	387	229	13
13443	Hypertext_Transfer_Protocol	200707	65	20	0	0	47	21	15	0	752	497	151	415	246	14
13443	Hypertext_Transfer_Protocol	200708	42	14	0	0	32	15	11	0	794	525	165	437	257	16
13443	Hypertext_Transfer_Protocol	200709	40	16	0	0	33	16	14	0	834	555	181	456	270	18
13443	Hypertext_Transfer_Protocol	200710	55	16	1	0	40	21	14	1	889	591	197	480	287	22
13443	Hypertext_Transfer_Protocol	200711	73	22	2	0	49	19	15	2	962	634	219	507	300	25
13443	Hypertext_Transfer_Protocol	200712	56	18	1	0	41	22	13	1	1018	667	237	539	314	28
13443	Hypertext_Transfer_Protocol	200801	36	13	1	0	32	13	10	1	1054	693	250	556	321	29
13443	Hypertext_Transfer_Protocol	200802	44	14	1	0	35	20	11	1	1098	719	264	580	332	30
13443	Hypertext_Transfer_Protocol	200803	46	18	0	0	32	13	9	0	1144	746	282	603	340	31
13443	Hypertext_Transfer_Protocol	200804	40	16	0	0	25	15	12	0	1184	767	298	633	351	38
13443	Hypertext_Transfer_Protocol	200805	37	10	0	0	29	12	8	0	1221	792	308	649	359	38
13443	Hypertext_Transfer_Protocol	200806	26	9	0	0	22	11	9	0	1247	811	317	660	367	39
13443	Hypertext_Transfer_Protocol	200807	22	7	0	0	18	9	4	0	1269	828	324	672	375	39
13443	Hypertext_Transfer_Protocol	200808	18	4	0	0	13	9	3	0	1287	839	328	684	382	39
13443	Hypertext_Transfer_Protocol	200809	28	7	0	0	26	14	7	0	1315	859	335	698	390	39
13443	Hypertext_Transfer_Protocol	200810	23	5	0	0	20	8	5	0	1338	875	340	707	395	39
13443	Hypertext_Transfer_Protocol	200811	47	16	0	0	36	18	15	0	1385	905	356	730	407	42
13443	Hypertext_Transfer_Protocol	200812	41	3	0	0	20	8	2	0	1426	923	359	759	413	42
13443	Hypertext_Transfer_Protocol	200901	21	7	0	0	18	8	7	0	1447	941	366	767	421	43
13443	Hypertext_Transfer_Protocol	200902	49	15	0	0	35	14	11	0	1496	969	381	788	428	45
13443	Hypertext_Transfer_Protocol	200903	62	23	0	0	36	11	13	0	1558	1000	404	810	434	46
13443	Hypertext_Transfer_Protocol	200904	43	15	2	1	30	13	9	2	1601	1026	419	831	443	48
13443	Hypertext_Transfer_Protocol	200905	28	9	0	0	19	11	7	0	1629	1043	428	844	452	48
13443	Hypertext_Transfer_Protocol	200906	28	11	0	0	26	11	9	0	1657	1062	439	857	456	48
13443	Hypertext_Transfer_Protocol	200907	27	8	0	0	22	13	6	0	1684	1079	447	873	464	49
13443	Hypertext_Transfer_Protocol	200908	17	4	0	0	12	5	3	0	1701	1088	451	881	466	51
13443	Hypertext_Transfer_Protocol	200909	12	4	0	0	11	4	4	0	1713	1098	455	885	469	51
13443	Hypertext_Transfer_Protocol	200910	23	5	0	0	15	7	5	0	1736	1108	460	894	471	51
13443	Hypertext_Transfer_Protocol	200911	34	14	0	0	28	13	9	0	1770	1131	474	913	479	52
13443	Hypertext_Transfer_Protocol	200912	30	8	0	0	23	9	6	0	1800	1153	482	924	487	53
13443	Hypertext_Transfer_Protocol	201001	32	10	0	0	26	13	7	0	1832	1171	492	941	493	53
13443	Hypertext_Transfer_Protocol	201002	45	15	0	0	29	14	9	0	1877	1192	507	964	499	56
13443	Hypertext_Transfer_Protocol	201003	31	13	2	0	25	12	11	2	1908	1211	520	978	505	58
13443	Hypertext_Transfer_Protocol	201004	57	18	0	0	27	13	10	0	1965	1234	538	999	514	58
13443	Hypertext_Transfer_Protocol	201005	32	12	0	0	25	11	8	0	1997	1256	550	1014	522	59
13443	Hypertext_Transfer_Protocol	201006	28	7	0	0	19	8	5	0	2025	1270	557	1026	525	59
13443	Hypertext_Transfer_Protocol	201007	30	7	0	0	21	13	7	0	2055	1287	564	1048	534	60
13443	Hypertext_Transfer_Protocol	201008	41	14	0	0	23	13	9	0	2096	1304	578	1070	541	63
13443	Hypertext_Transfer_Protocol	201009	40	9	0	0	26	12	7	0	2136	1326	587	1092	549	64
13443	Hypertext_Transfer_Protocol	201010	38	13	3	1	22	13	9	3	2174	1341	600	1115	555	68
13443	Hypertext_Transfer_Protocol	201011	35	10	0	0	25	9	8	0	2209	1363	610	1129	561	68
13443	Hypertext_Transfer_Protocol	201012	17	6	0	0	13	6	6	0	2226	1372	616	1137	563	68
13443	Hypertext_Transfer_Protocol	201101	33	14	0	0	23	10	8	0	2259	1390	630	1155	568	69
13443	Hypertext_Transfer_Protocol	201102	29	14	1	0	20	9	8	1	2288	1406	644	1171	573	70
13443	Hypertext_Transfer_Protocol	201103	12	3	0	0	10	6	3	0	2300	1415	647	1177	578	71
13443	Hypertext_Transfer_Protocol	201104	29	10	0	0	23	10	6	0	2329	1432	657	1191	582	72
13443	Hypertext_Transfer_Protocol	201105	21	6	0	0	17	11	6	0	2350	1442	663	1205	586	72
13443	Hypertext_Transfer_Protocol	201106	9	3	0	0	8	4	3	0	2359	1447	666	1209	587	73
13443	Hypertext_Transfer_Protocol	201107	20	8	0	0	18	8	8	0	2379	1460	674	1217	590	74
13443	Hypertext_Transfer_Protocol	201108	15	6	0	0	11	5	5	0	2394	1467	680	1225	591	74
13443	Hypertext_Transfer_Protocol	201109	20	4	0	0	13	8	4	0	2414	1475	684	1240	595	74
13443	Hypertext_Transfer_Protocol	201110	18	6	0	0	14	6	4	0	2432	1486	690	1248	598	74
13443	Hypertext_Transfer_Protocol	201111	10	3	0	0	10	4	3	0	2442	1493	693	1252	599	74
13443	Hypertext_Transfer_Protocol	201112	16	6	0	0	13	6	4	0	2458	1502	699	1260	601	76
13443	Hypertext_Transfer_Protocol	201201	26	7	0	0	22	13	7	0	2484	1521	706	1274	611	78
13443	Hypertext_Transfer_Protocol	201202	20	5	0	0	18	8	5	0	2504	1535	711	1282	615	78
13443	Hypertext_Transfer_Protocol	201203	30	8	0	0	19	11	5	0	2534	1550	719	1297	622	78
13443	Hypertext_Transfer_Protocol	201204	31	11	0	0	21	9	8	0	2565	1567	730	1312	627	80
13443	Hypertext_Transfer_Protocol	201205	58	15	0	0	30	14	8	0	2623	1590	745	1350	634	88
13443	Hypertext_Transfer_Protocol	201206	27	8	0	0	21	11	6	0	2650	1605	753	1366	639	88
13443	Hypertext_Transfer_Protocol	201207	11	2	0	0	10	4	2	0	2661	1615	755	1370	643	88
13443	Hypertext_Transfer_Protocol	201208	22	5	0	0	15	10	5	0	2683	1624	760	1384	647	89
13443	Hypertext_Transfer_Protocol	201209	17	5	0	0	16	10	5	0	2700	1636	765	1395	653	90
13443	Hypertext_Transfer_Protocol	201210	25	6	0	0	19	9	4	0	2725	1649	771	1408	656	90
13443	Hypertext_Transfer_Protocol	201211	9	3	0	0	7	4	2	0	2734	1654	774	1413	658	91
13443	Hypertext_Transfer_Protocol	201212	22	5	0	0	16	11	5	0	2756	1668	779	1429	667	91
13443	Hypertext_Transfer_Protocol	201301	16	4	0	0	11	8	4	0	2772	1675	783	1439	670	92
13443	Hypertext_Transfer_Protocol	201302	21	8	0	0	14	7	6	0	2793	1686	791	1453	674	94
13443	Hypertext_Transfer_Protocol	201303	6	2	0	0	5	3	1	0	2799	1690	793	1457	676	94
13443	Hypertext_Transfer_Protocol	201304	19	4	0	0	16	8	3	0	2818	1703	797	1466	681	94
13443	Hypertext_Transfer_Protocol	201305	34	13	0	0	24	13	9	0	2852	1719	810	1483	687	94
13443	Hypertext_Transfer_Protocol	201306	16	5	1	0	14	9	5	1	2868	1731	815	1493	694	96
13443	Hypertext_Transfer_Protocol	201307	16	3	0	0	12	8	3	0	2884	1739	818	1502	698	96
13443	Hypertext_Transfer_Protocol	201308	16	5	0	0	12	7	3	0	2900	1747	823	1511	701	96
13443	Hypertext_Transfer_Protocol	201309	17	5	0	0	14	8	5	0	2917	1759	828	1520	707	96
13443	Hypertext_Transfer_Protocol	201310	9	2	0	0	9	4	2	0	2926	1767	830	1524	710	96
13443	Hypertext_Transfer_Protocol	201311	3	0	0	0	3	1	0	0	2929	1770	830	1525	711	96
13443	Hypertext_Transfer_Protocol	201312	20	6	0	0	8	5	4	0	2949	1777	836	1542	715	99
13443	Hypertext_Transfer_Protocol	201401	11	4	0	0	11	6	4	0	2960	1786	840	1548	719	99
13443	Hypertext_Transfer_Protocol	201402	10	3	0	0	10	4	3	0	2970	1795	843	1552	722	99
13443	Hypertext_Transfer_Protocol	201403	12	4	0	0	11	8	4	0	2982	1804	847	1560	728	100
13443	Hypertext_Transfer_Protocol	201404	31	11	0	0	26	14	9	0	3013	1824	858	1577	736	102
13443	Hypertext_Transfer_Protocol	201405	21	7	0	0	16	8	6	0	3034	1836	865	1589	740	102
13443	Hypertext_Transfer_Protocol	201406	6	2	0	0	6	5	2	0	3040	1841	867	1594	744	103
13443	Hypertext_Transfer_Protocol	201407	14	4	0	0	13	7	3	0	3054	1851	871	1602	748	105
13443	Hypertext_Transfer_Protocol	201408	22	7	1	1	14	9	4	1	3076	1860	878	1618	752	108
13443	Hypertext_Transfer_Protocol	201409	15	6	0	0	14	8	6	0	3091	1871	884	1627	758	109
13443	Hypertext_Transfer_Protocol	201410	13	4	0	0	10	6	3	0	3104	1878	888	1636	761	109
13443	Hypertext_Transfer_Protocol	201411	9	4	0	0	7	3	4	0	3113	1883	892	1639	762	110
13443	Hypertext_Transfer_Protocol	201412	11	5	0	0	11	7	5	0	3124	1889	897	1646	763	111
13443	Hypertext_Transfer_Protocol	201501	7	2	0	0	7	5	2	0	3131	1893	899	1651	765	111
13443	Hypertext_Transfer_Protocol	201502	6	2	0	0	4	4	2	0	3137	1896	901	1657	768	113
13443	Hypertext_Transfer_Protocol	201503	15	4	0	0	11	6	4	0	3152	1903	905	1664	770	113
13443	Hypertext_Transfer_Protocol	201504	10	4	0	0	8	4	3	0	3162	1909	909	1669	771	113
13443	Hypertext_Transfer_Protocol	201505	20	7	0	0	19	14	6	0	3182	1921	916	1684	777	116
13443	Hypertext_Transfer_Protocol	201506	12	3	0	0	10	6	3	0	3194	1929	919	1691	781	116
13443	Hypertext_Transfer_Protocol	201507	11	5	0	0	7	5	2	0	3205	1933	924	1699	782	118
13443	Hypertext_Transfer_Protocol	201508	19	6	0	0	12	6	5	0	3224	1940	930	1712	783	118
13443	Hypertext_Transfer_Protocol	201509	25	9	0	0	22	12	8	0	3249	1957	939	1725	789	119
13443	Hypertext_Transfer_Protocol	201510	10	4	0	0	9	4	4	0	3259	1964	943	1729	791	119
13443	Hypertext_Transfer_Protocol	201511	16	7	0	0	12	9	6	0	3275	1972	950	1739	794	122
13443	Hypertext_Transfer_Protocol	201512	6	3	0	0	6	5	3	0	3281	1975	953	1744	796	124
13443	Hypertext_Transfer_Protocol	201601	11	5	0	0	9	5	4	0	3292	1983	958	1750	800	124
13443	Hypertext_Transfer_Protocol	201602	18	7	0	0	16	7	6	0	3310	1998	965	1758	806	124
13443	Hypertext_Transfer_Protocol	201603	39	12	0	0	25	14	9	0	3349	2018	977	1782	815	126
13443	Hypertext_Transfer_Protocol	201604	17	8	0	0	15	8	6	0	3366	2029	985	1792	818	128
13443	Hypertext_Transfer_Protocol	201605	24	11	1	0	15	8	8	1	3390	2039	996	1803	821	129
13443	Hypertext_Transfer_Protocol	201606	18	7	2	1	12	7	5	2	3408	2049	1003	1814	825	132
13443	Hypertext_Transfer_Protocol	201607	18	7	0	0	16	10	5	0	3426	2063	1010	1826	832	134
13443	Hypertext_Transfer_Protocol	201608	11	5	0	0	9	3	3	0	3437	2069	1015	1831	832	134
13443	Hypertext_Transfer_Protocol	201609	24	9	0	0	21	11	7	0	3461	2086	1024	1844	837	136
13443	Hypertext_Transfer_Protocol	201610	11	3	0	0	8	5	3	0	3472	2092	1027	1852	839	137
13443	Hypertext_Transfer_Protocol	201611	26	8	0	0	22	11	8	0	3498	2110	1035	1863	845	137
13443	Hypertext_Transfer_Protocol	201612	14	6	0	0	11	6	6	0	3512	2119	1041	1869	850	139
13443	Hypertext_Transfer_Protocol	201701	26	11	0	0	21	11	9	0	3538	2136	1052	1882	856	141
13443	Hypertext_Transfer_Protocol	201702	14	7	0	0	14	7	7	0	3552	2145	1059	1889	858	141
13443	Hypertext_Transfer_Protocol	201703	27	9	0	0	18	11	8	0	3579	2156	1068	1905	861	142
13443	Hypertext_Transfer_Protocol	201704	12	6	0	0	12	9	6	0	3591	2165	1074	1914	866	146
13443	Hypertext_Transfer_Protocol	201705	18	7	0	0	18	11	7	0	3609	2179	1081	1925	872	146
13443	Hypertext_Transfer_Protocol	201706	18	7	0	0	17	10	7	0	3627	2193	1088	1935	877	148
13443	Hypertext_Transfer_Protocol	201707	10	4	0	0	10	6	4	0	3637	2202	1092	1941	882	148
13443	Hypertext_Transfer_Protocol	201708	29	10	0	0	21	14	8	0	3666	2217	1102	1958	886	153
13443	Hypertext_Transfer_Protocol	201709	15	6	0	0	13	9	5	0	3681	2227	1108	1968	890	155
13443	Hypertext_Transfer_Protocol	201710	21	10	0	0	17	11	7	0	3702	2239	1118	1983	895	159
13443	Hypertext_Transfer_Protocol	201711	28	13	0	0	23	13	10	0	3730	2255	1131	2001	900	162
13443	Hypertext_Transfer_Protocol	201712	33	17	0	0	29	22	15	0	3763	2277	1148	2026	912	171
13443	Hypertext_Transfer_Protocol	201801	25	11	0	0	19	12	9	0	3788	2290	1159	2041	915	174
13443	Hypertext_Transfer_Protocol	201802	25	10	0	0	19	13	7	0	3813	2302	1169	2060	918	180
13443	Hypertext_Transfer_Protocol	201803	29	13	0	0	23	15	10	0	3842	2322	1182	2079	927	183
13443	Hypertext_Transfer_Protocol	201804	34	15	0	0	30	20	14	0	3876	2343	1197	2102	933	187
13443	Hypertext_Transfer_Protocol	201805	12	6	0	0	12	9	6	0	3888	2351	1203	2111	937	190
13443	Hypertext_Transfer_Protocol	201806	32	13	0	0	29	20	12	0	3920	2377	1216	2133	953	193
13443	Hypertext_Transfer_Protocol	201807	26	12	0	0	22	11	9	0	3946	2394	1228	2147	958	195
1419779	IDMS	200503	1	0	0	0	1	0	0	0	1	1	0	0	0	0
1419779	IDMS	200505	1	0	0	0	1	1	0	0	2	2	0	1	1	0
1419779	IDMS	200506	10	0	0	0	2	1	0	0	12	4	0	2	2	0
1419779	IDMS	200507	20	0	0	0	5	2	0	0	32	8	0	7	4	0
1419779	IDMS	200508	10	0	0	0	3	0	0	0	42	10	0	7	4	0
1419779	IDMS	200509	2	0	0	0	2	1	0	0	44	12	0	8	5	0
1419779	IDMS	200512	6	0	0	0	5	3	0	0	50	15	0	12	6	0
1419779	IDMS	200603	5	0	0	0	3	1	0	0	55	17	0	15	6	0
1419779	IDMS	200604	6	0	0	0	6	2	0	0	61	22	0	17	7	0
1419779	IDMS	200606	6	0	0	0	4	1	0	0	67	26	0	19	8	0
1419779	IDMS	200607	3	1	0	0	3	2	1	0	70	29	1	21	10	0
1419779	IDMS	200608	3	0	0	0	3	0	0	0	73	31	1	21	10	0
1419779	IDMS	200609	2	0	0	0	1	1	0	0	75	31	1	23	10	0
1419779	IDMS	200610	2	0	0	0	2	2	0	0	77	33	1	25	12	0
1419779	IDMS	200701	2	0	0	0	2	0	0	0	79	33	1	25	12	0
1419779	IDMS	200702	2	1	0	0	2	1	1	0	81	35	2	26	13	0
1419779	IDMS	200703	3	0	0	0	3	1	0	0	84	38	2	27	14	0
1419779	IDMS	200705	2	0	0	0	2	1	0	0	86	40	2	28	15	0
1419779	IDMS	200706	3	0	0	0	3	2	0	0	89	42	2	30	16	0
1419779	IDMS	200707	2	1	0	0	2	1	1	0	91	42	3	31	16	0
1419779	IDMS	200708	1	0	0	0	1	0	0	0	92	43	3	31	16	0
1419779	IDMS	200711	1	0	0	0	1	0	0	0	93	43	3	31	16	0
1419779	IDMS	200712	4	0	0	0	3	1	0	0	97	46	3	32	17	0
1419779	IDMS	200801	2	0	0	0	1	0	0	0	99	47	3	32	17	0
1419779	IDMS	200802	3	0	0	0	2	1	0	0	102	49	3	34	18	0
1419779	IDMS	200803	2	0	0	0	2	0	0	0	104	50	3	34	18	0
1419779	IDMS	200806	1	0	0	0	1	0	0	0	105	51	3	34	18	0
1419779	IDMS	200807	1	0	0	0	1	0	0	0	106	52	3	34	18	0
1419779	IDMS	200901	6	2	0	0	6	5	2	0	112	55	5	39	21	1
1419779	IDMS	200902	1	0	0	0	1	0	0	0	113	56	5	39	21	1
1419779	IDMS	200904	4	1	0	0	2	1	1	0	117	58	6	40	22	1
1419779	IDMS	200905	2	0	0	0	2	0	0	0	119	60	6	40	22	1
1419779	IDMS	200906	2	1	0	0	2	1	1	0	121	61	7	41	22	1
1419779	IDMS	200910	1	0	0	0	1	0	0	0	122	62	7	41	22	1
1419779	IDMS	200911	2	1	0	0	2	1	1	0	124	64	8	42	23	1
1419779	IDMS	200912	4	2	0	0	3	1	1	0	128	66	10	44	23	1
1419779	IDMS	201001	3	1	0	0	3	1	1	0	131	67	11	45	23	1
1419779	IDMS	201004	3	1	0	0	3	2	1	0	134	70	12	47	25	1
1419779	IDMS	201005	1	0	0	0	1	1	0	0	135	71	12	48	26	1
1419779	IDMS	201006	3	1	0	0	2	1	1	0	138	73	13	50	27	1
1419779	IDMS	201007	1	0	0	0	1	0	0	0	139	74	13	50	27	1
1419779	IDMS	201008	1	0	0	0	1	1	0	0	140	75	13	51	28	1
1419779	IDMS	201011	2	0	0	0	1	1	0	0	142	76	13	53	29	1
1419779	IDMS	201012	1	0	0	0	1	1	0	0	143	77	13	54	30	1
1419779	IDMS	201102	1	0	0	0	1	0	0	0	144	78	13	54	30	1
1419779	IDMS	201104	19	1	0	0	4	3	1	0	163	81	14	71	32	1
1419779	IDMS	201105	2	0	0	0	2	2	0	0	165	82	14	73	33	1
1419779	IDMS	201106	1	0	0	0	1	1	0	0	166	83	14	74	34	1
1419779	IDMS	201108	6	0	0	0	2	1	0	0	172	84	14	79	34	1
1419779	IDMS	201111	2	0	0	0	2	1	0	0	174	86	14	80	35	1
1419779	IDMS	201202	3	0	0	0	3	3	0	0	177	86	14	83	35	1
1419779	IDMS	201204	1	0	0	0	1	1	0	0	178	87	14	84	36	1
1419779	IDMS	201205	1	0	0	0	1	1	0	0	179	87	14	85	36	1
1419779	IDMS	201207	1	0	0	0	1	1	0	0	180	88	14	86	37	1
1419779	IDMS	201208	4	1	0	0	3	2	1	0	184	90	15	88	38	1
1419779	IDMS	201210	1	0	0	0	1	1	0	0	185	90	15	89	38	1
1419779	IDMS	201301	1	0	0	0	1	0	0	0	186	91	15	89	38	1
1419779	IDMS	201304	2	0	0	0	2	1	0	0	188	93	15	90	39	1
1419779	IDMS	201305	3	1	0	0	3	2	1	0	191	95	16	92	40	1
1419779	IDMS	201309	1	0	0	0	1	1	0	0	192	95	16	93	40	1
1419779	IDMS	201312	2	0	0	0	1	1	0	0	194	96	16	95	41	1
1419779	IDMS	201402	4	0	0	0	3	2	0	0	198	99	16	98	43	1
1419779	IDMS	201403	3	0	0	0	2	1	0	0	201	101	16	100	44	1
1419779	IDMS	201408	3	1	0	0	2	1	1	0	204	102	17	101	44	1
1419779	IDMS	201502	1	0	0	0	1	0	0	0	205	103	17	101	44	1
1419779	IDMS	201503	1	0	0	0	1	0	0	0	206	104	17	101	44	1
1419779	IDMS	201504	1	0	0	0	1	0	0	0	207	105	17	101	44	1
1419779	IDMS	201510	1	0	0	0	1	1	0	0	208	106	17	102	45	1
1419779	IDMS	201511	1	0	0	0	1	1	0	0	209	107	17	103	46	1
1419779	IDMS	201512	1	0	0	0	1	1	0	0	210	108	17	104	47	1
1419779	IDMS	201601	1	0	0	0	1	0	0	0	211	109	17	104	47	1
1419779	IDMS	201611	2	0	0	0	2	1	0	0	213	111	17	105	48	1
1419779	IDMS	201612	1	0	0	0	1	1	0	0	214	112	17	106	49	1
1419779	IDMS	201702	2	0	0	0	2	1	0	0	216	114	17	107	50	1
1419779	IDMS	201703	2	1	0	0	2	1	1	0	218	116	18	108	51	1
1419779	IDMS	201710	1	0	0	0	1	1	0	0	219	117	18	109	52	1
1419779	IDMS	201712	1	0	0	0	1	1	0	0	220	118	18	110	53	1
1419779	IDMS	201803	1	0	0	0	1	1	0	0	221	119	18	111	54	1
1419779	IDMS	201805	2	1	0	0	2	1	1	0	223	121	19	112	55	1
14739	IEEE_802.11	200109	1	0	0	0	1	1	0	0	1	1	0	1	1	0
14739	IEEE_802.11	200202	1	0	0	0	1	1	0	0	2	2	0	2	2	0
14739	IEEE_802.11	200204	5	0	0	0	2	2	0	0	7	4	0	7	3	0
14739	IEEE_802.11	200205	1	0	0	0	1	1	0	0	8	5	0	8	4	0
14739	IEEE_802.11	200207	2	0	0	0	2	2	0	0	10	7	0	10	6	0
14739	IEEE_802.11	200208	4	0	0	0	3	1	0	0	14	10	0	11	7	0
14739	IEEE_802.11	200209	1	0	0	0	1	0	0	0	15	11	0	11	7	0
14739	IEEE_802.11	200211	1	0	0	0	1	1	0	0	16	11	0	12	7	0
14739	IEEE_802.11	200212	4	0	0	0	2	1	0	0	20	13	0	13	8	0
14739	IEEE_802.11	200301	8	0	0	0	2	2	0	0	28	15	0	21	10	0
14739	IEEE_802.11	200302	1	0	0	0	1	1	0	0	29	16	0	22	11	0
14739	IEEE_802.11	200303	1	0	0	0	1	0	0	0	30	17	0	22	11	0
14739	IEEE_802.11	200305	1	0	0	0	1	1	0	0	31	18	0	23	12	0
14739	IEEE_802.11	200306	2	0	0	0	1	0	0	0	33	19	0	23	12	0
14739	IEEE_802.11	200307	2	0	0	0	2	2	0	0	35	21	0	25	14	0
14739	IEEE_802.11	200308	2	0	0	0	2	1	0	0	37	23	0	26	15	0
14739	IEEE_802.11	200309	12	0	0	0	6	5	0	0	49	29	0	35	20	0
14739	IEEE_802.11	200310	3	0	0	0	2	1	0	0	52	31	0	37	21	0
14739	IEEE_802.11	200311	10	0	0	0	6	3	0	0	62	37	0	42	24	0
14739	IEEE_802.11	200312	1	0	0	0	1	1	0	0	63	37	0	43	24	0
14739	IEEE_802.11	200401	1	0	0	0	1	1	0	0	64	38	0	44	25	0
14739	IEEE_802.11	200402	2	0	0	0	1	1	0	0	66	39	0	46	26	0
14739	IEEE_802.11	200403	1	0	0	0	1	1	0	0	67	40	0	47	27	0
14739	IEEE_802.11	200404	6	0	0	0	5	1	0	0	73	44	0	48	28	0
14739	IEEE_802.11	200405	7	0	0	0	7	4	0	0	80	51	0	52	32	0
14739	IEEE_802.11	200406	3	0	0	0	3	0	0	0	83	54	0	52	32	0
14739	IEEE_802.11	200407	17	1	0	0	9	1	1	0	100	63	1	53	33	0
14739	IEEE_802.11	200408	19	1	0	0	7	4	1	0	119	70	2	62	37	0
14739	IEEE_802.11	200409	11	1	0	0	9	8	1	0	130	78	3	72	44	0
14739	IEEE_802.11	200410	16	1	0	0	10	5	1	0	146	88	4	81	49	0
14739	IEEE_802.11	200411	15	2	0	0	12	4	2	0	161	100	6	87	53	0
14739	IEEE_802.11	200412	24	3	0	0	19	7	3	0	185	119	9	95	60	0
14739	IEEE_802.11	200501	6	0	0	0	4	2	0	0	191	123	9	98	62	0
14739	IEEE_802.11	200502	47	1	0	0	23	10	1	0	238	143	10	123	70	0
14739	IEEE_802.11	200503	11	1	0	0	9	4	1	0	249	150	11	127	73	0
14739	IEEE_802.11	200504	35	3	0	0	24	11	3	0	284	174	14	142	84	0
14739	IEEE_802.11	200505	11	1	0	0	10	2	1	0	295	184	15	144	86	0
14739	IEEE_802.11	200506	26	0	0	0	13	6	0	0	321	195	15	161	90	0
14739	IEEE_802.11	200507	22	0	0	0	13	6	0	0	343	208	15	169	96	0
14739	IEEE_802.11	200508	10	0	0	0	9	4	0	0	353	216	15	174	99	0
14739	IEEE_802.11	200509	26	2	0	0	20	5	2	0	379	233	17	179	103	0
14739	IEEE_802.11	200510	24	1	0	0	16	7	1	0	403	247	18	191	109	0
14739	IEEE_802.11	200511	46	8	0	0	27	12	7	0	449	271	26	218	118	0
14739	IEEE_802.11	200512	27	4	0	0	22	13	4	0	476	291	30	233	129	0
14739	IEEE_802.11	200601	30	1	0	0	17	9	1	0	506	306	31	247	136	0
14739	IEEE_802.11	200602	38	3	0	0	27	12	2	0	544	330	34	264	145	0
14739	IEEE_802.11	200603	38	8	2	1	22	12	6	2	582	351	42	289	156	2
14739	IEEE_802.11	200604	23	4	0	0	20	8	4	0	605	368	46	299	161	3
14739	IEEE_802.11	200605	31	2	0	0	21	10	2	0	636	386	48	310	168	3
14739	IEEE_802.11	200606	45	6	0	0	30	13	6	0	681	412	54	327	178	3
14739	IEEE_802.11	200607	41	3	0	0	31	18	3	0	722	436	57	350	191	4
14739	IEEE_802.11	200608	22	2	0	0	17	10	2	0	744	451	59	360	199	4
14739	IEEE_802.11	200609	60	10	0	0	38	17	9	0	804	484	69	384	211	4
14739	IEEE_802.11	200610	39	7	1	0	28	7	6	1	843	510	76	394	217	5
14739	IEEE_802.11	200611	53	3	0	0	36	11	3	0	896	542	79	405	224	5
14739	IEEE_802.11	200612	53	3	0	0	37	12	3	0	949	575	82	423	233	6
14739	IEEE_802.11	200701	52	5	0	0	31	11	4	0	1001	602	87	439	240	6
14739	IEEE_802.11	200702	113	7	0	0	71	26	7	0	1114	668	94	488	261	7
14739	IEEE_802.11	200703	65	7	0	0	38	15	5	0	1179	703	101	511	273	7
14739	IEEE_802.11	200704	39	4	0	0	32	13	4	0	1218	732	105	528	283	7
14739	IEEE_802.11	200705	86	15	1	0	48	19	13	1	1304	775	120	557	298	10
14739	IEEE_802.11	200706	139	2	0	0	56	23	2	0	1443	827	122	585	318	10
14739	IEEE_802.11	200707	37	1	0	0	30	12	1	0	1480	855	123	601	329	10
14739	IEEE_802.11	200708	51	2	0	0	32	13	2	0	1531	885	125	620	340	10
14739	IEEE_802.11	200709	66	5	0	0	43	19	5	0	1597	922	130	652	354	10
14739	IEEE_802.11	200710	92	4	0	0	30	13	3	0	1689	948	134	684	364	10
14739	IEEE_802.11	200711	61	6	0	0	31	16	6	0	1750	972	140	720	374	10
14739	IEEE_802.11	200712	56	11	0	0	31	13	9	0	1806	999	151	740	383	10
14739	IEEE_802.11	200801	20	4	0	0	11	4	3	0	1826	1005	155	748	383	10
14739	IEEE_802.11	200802	40	8	0	0	28	10	6	0	1866	1029	163	766	390	12
14739	IEEE_802.11	200803	18	2	0	0	15	9	2	0	1884	1040	165	776	396	12
14739	IEEE_802.11	200804	4	1	0	0	3	2	1	0	1888	1042	166	779	397	12
14739	IEEE_802.11	200805	12	4	0	0	8	1	2	0	1900	1049	170	782	397	12
14739	IEEE_802.11	200806	13	4	0	0	9	4	2	0	1913	1056	174	789	399	13
14739	IEEE_802.11	200807	9	2	0	0	8	3	2	0	1922	1064	176	793	402	13
14739	IEEE_802.11	200808	28	6	0	0	20	7	5	0	1950	1081	182	802	406	13
14739	IEEE_802.11	200809	29	3	0	0	16	10	3	0	1979	1093	185	820	412	13
14739	IEEE_802.11	200810	19	3	0	0	12	4	3	0	1998	1103	188	825	414	13
14739	IEEE_802.11	200811	22	3	0	0	16	9	3	0	2020	1115	191	838	419	13
14739	IEEE_802.11	200812	20	1	0	0	12	6	1	0	2040	1126	192	847	424	14
14739	IEEE_802.11	200901	40	3	0	0	17	6	1	0	2080	1139	195	865	426	14
14739	IEEE_802.11	200902	21	5	0	0	21	8	5	0	2101	1158	200	873	432	14
14739	IEEE_802.11	200903	42	5	0	0	24	12	5	0	2143	1179	205	888	441	15
14739	IEEE_802.11	200904	74	10	0	0	28	12	9	0	2217	1203	215	910	450	18
14739	IEEE_802.11	200905	25	5	0	0	16	6	3	0	2242	1215	220	922	452	19
14739	IEEE_802.11	200906	38	4	0	0	23	11	3	0	2280	1234	224	937	459	20
14739	IEEE_802.11	200907	14	3	0	0	14	9	3	0	2294	1247	227	946	467	21
14739	IEEE_802.11	200908	26	2	0	0	18	6	2	0	2320	1263	229	955	471	21
14739	IEEE_802.11	200909	29	2	0	0	13	9	2	0	2349	1273	231	979	477	21
14739	IEEE_802.11	200910	39	7	1	0	24	10	7	1	2388	1293	238	1000	485	22
14739	IEEE_802.11	200911	23	1	0	0	13	5	1	0	2411	1301	239	1011	485	22
14739	IEEE_802.11	200912	17	3	0	0	11	7	3	0	2428	1310	242	1020	490	22
14739	IEEE_802.11	201001	21	4	0	0	17	7	3	0	2449	1325	246	1029	495	22
14739	IEEE_802.11	201002	39	5	0	0	25	13	4	0	2488	1347	251	1047	506	23
14739	IEEE_802.11	201003	8	1	0	0	6	3	1	0	2496	1352	252	1051	508	23
14739	IEEE_802.11	201004	5	2	0	0	5	3	2	0	2501	1354	254	1054	509	23
14739	IEEE_802.11	201005	17	5	0	0	15	8	5	0	2518	1366	259	1062	514	23
14739	IEEE_802.11	201006	10	3	0	0	9	5	3	0	2528	1375	262	1067	519	23
14739	IEEE_802.11	201007	4	0	0	0	4	3	0	0	2532	1378	262	1070	521	23
14739	IEEE_802.11	201008	11	3	0	0	9	5	3	0	2543	1385	265	1077	524	23
14739	IEEE_802.11	201009	11	3	0	0	7	2	2	0	2554	1389	268	1081	524	23
14739	IEEE_802.11	201010	14	0	0	0	7	3	0	0	2568	1395	268	1087	526	23
14739	IEEE_802.11	201011	7	2	0	0	6	4	1	0	2575	1399	270	1092	528	23
14739	IEEE_802.11	201012	19	5	0	0	15	7	4	0	2594	1412	275	1100	533	23
14739	IEEE_802.11	201101	6	0	0	0	6	3	0	0	2600	1417	275	1103	535	23
14739	IEEE_802.11	201102	17	6	0	0	13	6	5	0	2617	1428	281	1110	539	23
14739	IEEE_802.11	201103	9	0	0	0	6	3	0	0	2626	1434	281	1113	542	23
14739	IEEE_802.11	201104	8	0	0	0	8	6	0	0	2634	1441	281	1119	547	23
14739	IEEE_802.11	201105	14	3	0	0	11	7	3	0	2648	1450	284	1127	552	23
14739	IEEE_802.11	201106	3	1	0	0	3	2	1	0	2651	1452	285	1129	553	23
14739	IEEE_802.11	201107	12	3	0	0	8	4	2	0	2663	1457	288	1136	554	24
14739	IEEE_802.11	201108	4	1	0	0	3	2	1	0	2667	1460	289	1139	556	24
14739	IEEE_802.11	201109	28	4	0	0	17	7	3	0	2695	1474	293	1149	560	24
14739	IEEE_802.11	201110	13	3	0	0	11	6	2	0	2708	1482	296	1157	563	24
14739	IEEE_802.11	201111	8	2	0	0	8	5	2	0	2716	1489	298	1162	567	24
14739	IEEE_802.11	201112	9	1	0	0	5	4	1	0	2725	1492	299	1168	569	24
14739	IEEE_802.11	201201	13	2	0	0	9	6	1	0	2738	1500	301	1178	574	24
14739	IEEE_802.11	201202	13	2	0	0	9	4	1	0	2751	1507	303	1185	576	24
14739	IEEE_802.11	201203	7	2	0	0	7	4	2	0	2758	1511	305	1189	577	24
14739	IEEE_802.11	201204	3	0	0	0	1	1	0	0	2761	1511	305	1192	577	24
14739	IEEE_802.11	201205	14	2	0	0	9	4	2	0	2775	1517	307	1197	578	24
14739	IEEE_802.11	201206	12	2	0	0	10	5	2	0	2787	1524	309	1202	581	24
14739	IEEE_802.11	201207	6	0	0	0	4	4	0	0	2793	1526	309	1208	583	24
14739	IEEE_802.11	201208	17	4	0	0	12	5	3	0	2810	1536	313	1214	586	24
14739	IEEE_802.11	201209	12	2	0	0	9	3	1	0	2822	1543	315	1220	587	24
14739	IEEE_802.11	201210	14	2	0	0	10	6	2	0	2836	1550	317	1226	590	24
14739	IEEE_802.11	201211	17	4	0	0	9	5	3	0	2853	1556	321	1232	592	24
14739	IEEE_802.11	201212	16	4	0	0	13	6	2	0	2869	1565	325	1240	594	24
14739	IEEE_802.11	201301	13	3	0	0	8	4	2	0	2882	1571	328	1246	596	24
14739	IEEE_802.11	201302	16	2	0	0	11	3	2	0	2898	1578	330	1251	596	24
14739	IEEE_802.11	201303	14	4	0	0	11	8	4	0	2912	1587	334	1259	602	24
14739	IEEE_802.11	201304	12	1	0	0	6	2	1	0	2924	1591	335	1262	602	24
14739	IEEE_802.11	201305	11	1	0	0	7	4	1	0	2935	1595	336	1270	604	25
14739	IEEE_802.11	201306	24	5	0	0	15	7	5	0	2959	1606	341	1278	608	25
14739	IEEE_802.11	201307	15	2	0	0	12	6	2	0	2974	1618	343	1285	614	25
14739	IEEE_802.11	201308	19	2	0	0	10	6	2	0	2993	1625	345	1295	617	25
14739	IEEE_802.11	201309	7	0	0	0	6	2	0	0	3000	1629	345	1297	618	25
14739	IEEE_802.11	201310	8	0	0	0	6	2	0	0	3008	1634	345	1299	619	25
14739	IEEE_802.11	201311	15	3	0	0	10	4	3	0	3023	1641	348	1304	620	25
14739	IEEE_802.11	201312	16	4	0	0	10	8	3	0	3039	1650	352	1318	627	27
14739	IEEE_802.11	201401	20	2	0	0	9	4	2	0	3059	1658	354	1331	630	27
14739	IEEE_802.11	201402	28	7	2	0	17	12	6	1	3087	1670	361	1354	637	30
14739	IEEE_802.11	201403	9	1	0	0	6	3	1	0	3096	1673	362	1358	637	30
14739	IEEE_802.11	201404	12	3	0	0	9	5	2	0	3108	1679	365	1365	639	30
14739	IEEE_802.11	201405	18	1	0	0	10	4	1	0	3126	1686	366	1369	640	30
14739	IEEE_802.11	201406	13	2	0	0	7	4	2	0	3139	1692	368	1378	642	30
14739	IEEE_802.11	201407	6	1	0	0	3	1	1	0	3145	1694	369	1380	642	30
14739	IEEE_802.11	201408	8	1	0	0	7	4	1	0	3153	1698	370	1385	643	30
14739	IEEE_802.11	201409	28	3	0	0	11	6	3	0	3181	1705	373	1406	645	30
14739	IEEE_802.11	201410	10	3	0	0	6	4	2	0	3191	1711	376	1412	649	30
14739	IEEE_802.11	201411	12	1	0	0	8	5	1	0	3203	1717	377	1418	653	30
14739	IEEE_802.11	201412	12	3	0	0	11	4	2	0	3215	1725	380	1423	654	31
14739	IEEE_802.11	201501	10	2	0	0	6	4	2	0	3225	1731	382	1428	658	32
14739	IEEE_802.11	201502	3	1	0	0	3	2	1	0	3228	1734	383	1430	660	32
14739	IEEE_802.11	201503	10	3	0	0	8	3	3	0	3238	1739	386	1434	660	32
14739	IEEE_802.11	201504	15	3	0	0	11	7	3	0	3253	1746	389	1442	663	33
14739	IEEE_802.11	201505	13	3	0	0	9	4	3	0	3266	1752	392	1447	664	33
14739	IEEE_802.11	201506	1	0	0	0	1	0	0	0	3267	1753	392	1447	664	33
14739	IEEE_802.11	201507	10	1	0	0	7	5	1	0	3277	1757	393	1454	666	33
14739	IEEE_802.11	201508	1	0	0	0	1	1	0	0	3278	1758	393	1455	667	33
14739	IEEE_802.11	201509	14	2	0	0	12	7	2	0	3292	1767	395	1464	671	33
14739	IEEE_802.11	201510	17	3	0	0	10	6	2	0	3309	1773	398	1474	673	33
14739	IEEE_802.11	201511	12	3	0	0	8	4	2	0	3321	1779	401	1479	674	34
14739	IEEE_802.11	201512	11	3	0	0	6	3	2	0	3332	1783	404	1485	674	34
14739	IEEE_802.11	201601	5	1	0	0	5	4	1	0	3337	1786	405	1489	676	34
14739	IEEE_802.11	201602	17	3	0	0	11	6	2	0	3354	1796	408	1499	681	35
14739	IEEE_802.11	201603	6	0	0	0	4	3	0	0	3360	1798	408	1504	682	35
14739	IEEE_802.11	201604	12	3	0	0	9	5	1	0	3372	1805	411	1512	684	36
14739	IEEE_802.11	201605	14	5	0	0	11	6	3	0	3386	1812	416	1520	686	36
14739	IEEE_802.11	201606	7	2	0	0	7	6	2	0	3393	1817	418	1526	689	37
14739	IEEE_802.11	201607	2	0	0	0	1	0	0	0	3395	1818	418	1526	689	37
14739	IEEE_802.11	201608	7	1	0	0	6	4	1	0	3402	1822	419	1530	689	38
14739	IEEE_802.11	201609	9	3	0	0	7	5	2	0	3411	1826	422	1536	691	38
14739	IEEE_802.11	201610	3	0	0	0	3	2	0	0	3414	1828	422	1538	692	38
14739	IEEE_802.11	201611	12	4	0	0	8	4	3	0	3426	1834	426	1543	694	38
14739	IEEE_802.11	201612	2	1	0	0	2	1	1	0	3428	1835	427	1544	694	38
14739	IEEE_802.11	201701	6	1	0	0	6	4	1	0	3434	1839	428	1548	696	38
14739	IEEE_802.11	201702	25	5	0	0	12	7	4	0	3459	1846	433	1564	698	38
14739	IEEE_802.11	201703	8	1	0	0	5	4	1	0	3467	1850	434	1571	701	38
14739	IEEE_802.11	201704	10	2	0	0	8	5	2	0	3477	1856	436	1578	704	39
14739	IEEE_802.11	201705	7	1	0	0	6	4	1	0	3484	1861	437	1583	707	40
14739	IEEE_802.11	201706	7	3	0	0	6	4	3	0	3491	1865	440	1587	709	40
14739	IEEE_802.11	201707	7	1	0	0	5	5	1	0	3498	1868	441	1594	711	41
14739	IEEE_802.11	201708	4	2	0	0	3	2	2	0	3502	1870	443	1596	712	41
14739	IEEE_802.11	201709	4	0	0	0	4	4	0	0	3506	1874	443	1600	716	41
14739	IEEE_802.11	201710	4	1	0	0	4	3	1	0	3510	1877	444	1603	718	41
14739	IEEE_802.11	201711	17	6	0	0	8	5	4	0	3527	1883	450	1611	721	41
14739	IEEE_802.11	201712	23	5	0	0	8	4	3	0	3550	1889	455	1618	723	41
14739	IEEE_802.11	201801	7	0	0	0	7	4	0	0	3557	1894	455	1622	725	41
14739	IEEE_802.11	201802	6	1	0	0	5	4	1	0	3563	1896	456	1627	726	41
14739	IEEE_802.11	201803	11	3	0	0	8	7	3	0	3574	1902	459	1637	729	43
14739	IEEE_802.11	201804	21	5	2	1	8	5	2	2	3595	1909	464	1655	732	47
14739	IEEE_802.11	201805	5	0	0	0	3	3	0	0	3600	1912	464	1660	734	47
14739	IEEE_802.11	201806	9	4	0	0	8	4	3	0	3609	1917	468	1665	735	47
14739	IEEE_802.11	201807	18	4	0	0	8	4	2	0	3627	1922	472	1675	736	47
14735	IEEE_802.15	200202	1	0	0	0	1	1	0	0	1	1	0	1	1	0
14735	IEEE_802.15	200308	1	0	0	0	1	1	0	0	2	2	0	2	2	0
14735	IEEE_802.15	200402	2	0	0	0	2	2	0	0	4	4	0	4	4	0
14735	IEEE_802.15	200409	1	0	0	0	1	1	0	0	5	5	0	5	5	0
14735	IEEE_802.15	200412	1	0	0	0	1	1	0	0	6	6	0	6	6	0
14735	IEEE_802.15	200501	1	0	0	0	1	1	0	0	7	7	0	7	7	0
14735	IEEE_802.15	200503	2	0	0	0	2	2	0	0	9	9	0	9	9	0
14735	IEEE_802.15	200504	1	0	0	0	1	1	0	0	10	10	0	10	10	0
14735	IEEE_802.15	200505	1	0	0	0	1	1	0	0	11	11	0	11	11	0
14735	IEEE_802.15	200506	2	0	0	0	2	2	0	0	13	13	0	13	13	0
14735	IEEE_802.15	200507	1	0	0	0	1	1	0	0	14	14	0	14	14	0
14735	IEEE_802.15	200509	1	0	0	0	1	1	0	0	15	15	0	15	15	0
14735	IEEE_802.15	200510	2	0	0	0	2	2	0	0	17	17	0	17	17	0
14735	IEEE_802.15	200511	1	0	0	0	1	1	0	0	18	18	0	18	18	0
14735	IEEE_802.15	200512	4	1	0	0	3	1	1	0	22	20	1	19	18	0
14735	IEEE_802.15	200601	4	0	0	0	2	0	0	0	26	22	1	19	18	0
14735	IEEE_802.15	200603	3	0	0	0	3	2	0	0	29	25	1	21	20	0
14735	IEEE_802.15	200605	1	0	0	0	1	1	0	0	30	26	1	22	21	0
14735	IEEE_802.15	200606	9	0	0	0	7	4	0	0	39	31	1	27	23	0
14735	IEEE_802.15	200607	5	0	0	0	2	1	0	0	44	33	1	31	24	0
14735	IEEE_802.15	200609	4	0	0	0	2	2	0	0	48	34	1	35	25	0
14735	IEEE_802.15	200610	1	0	0	0	1	0	0	0	49	35	1	35	25	0
14735	IEEE_802.15	200611	5	0	0	0	3	1	0	0	54	38	1	37	26	0
14735	IEEE_802.15	200701	4	0	0	0	4	3	0	0	58	41	1	40	28	0
14735	IEEE_802.15	200702	8	1	0	0	5	2	1	0	66	45	2	44	29	0
14735	IEEE_802.15	200704	3	0	0	0	2	1	0	0	69	46	2	46	29	0
14735	IEEE_802.15	200705	2	0	0	0	2	1	0	0	71	48	2	47	30	0
14735	IEEE_802.15	200706	2	0	0	0	1	0	0	0	73	49	2	47	30	0
14735	IEEE_802.15	200707	5	1	0	0	5	5	1	0	78	54	3	52	35	1
14735	IEEE_802.15	200708	3	0	0	0	3	3	0	0	81	57	3	55	38	1
14735	IEEE_802.15	200709	3	0	0	0	3	1	0	0	84	59	3	56	38	1
14735	IEEE_802.15	200710	1	0	0	0	1	1	0	0	85	60	3	57	39	1
14735	IEEE_802.15	200711	3	0	0	0	1	1	0	0	88	61	3	60	40	1
14735	IEEE_802.15	200712	2	0	0	0	1	1	0	0	90	62	3	62	41	1
14735	IEEE_802.15	200801	7	1	0	0	5	3	1	0	97	66	4	66	43	1
14735	IEEE_802.15	200802	2	0	0	0	2	1	0	0	99	68	4	67	44	1
14735	IEEE_802.15	200804	7	0	0	0	3	2	0	0	106	70	4	73	45	1
14735	IEEE_802.15	200805	2	1	0	0	2	1	1	0	108	71	5	74	45	1
14735	IEEE_802.15	200806	2	0	0	0	1	1	0	0	110	72	5	76	46	1
14735	IEEE_802.15	200807	7	1	0	0	5	1	1	0	117	76	6	77	46	1
14735	IEEE_802.15	200808	1	0	0	0	1	0	0	0	118	77	6	77	46	1
14735	IEEE_802.15	200810	1	0	0	0	1	0	0	0	119	78	6	77	46	1
14735	IEEE_802.15	200811	1	0	0	0	1	1	0	0	120	79	6	78	47	1
14735	IEEE_802.15	200812	2	0	0	0	2	2	0	0	122	81	6	80	49	1
14735	IEEE_802.15	200902	2	0	0	0	2	0	0	0	124	83	6	80	49	1
14735	IEEE_802.15	200904	3	0	0	0	3	2	0	0	127	86	6	82	51	1
14735	IEEE_802.15	200905	5	1	0	0	3	2	1	0	132	88	7	85	52	1
14735	IEEE_802.15	200907	6	0	0	0	3	2	0	0	138	90	7	90	53	1
14735	IEEE_802.15	200908	2	1	0	0	2	1	1	0	140	92	8	91	54	1
14735	IEEE_802.15	200909	1	0	0	0	1	1	0	0	141	93	8	92	55	1
14735	IEEE_802.15	200910	5	1	0	0	3	1	1	0	146	96	9	93	56	1
14735	IEEE_802.15	200911	1	0	0	0	1	1	0	0	147	96	9	94	56	1
14735	IEEE_802.15	201003	1	0	0	0	1	1	0	0	148	96	9	95	56	1
14735	IEEE_802.15	201004	1	0	0	0	1	0	0	0	149	97	9	95	56	1
14735	IEEE_802.15	201005	2	0	0	0	1	1	0	0	151	98	9	97	57	1
14735	IEEE_802.15	201006	2	0	0	0	1	0	0	0	153	99	9	97	57	1
14735	IEEE_802.15	201008	3	1	0	0	3	2	1	0	156	101	10	99	58	1
14735	IEEE_802.15	201009	2	0	0	0	2	1	0	0	158	103	10	100	59	1
14735	IEEE_802.15	201010	13	0	0	0	2	1	0	0	171	105	10	112	60	1
14735	IEEE_802.15	201102	4	0	0	0	2	2	0	0	175	106	10	116	61	1
14735	IEEE_802.15	201103	3	0	0	0	2	1	0	0	178	108	10	117	62	1
14735	IEEE_802.15	201104	3	0	0	0	2	2	0	0	181	110	10	120	64	1
14735	IEEE_802.15	201106	3	0	0	0	3	1	0	0	184	113	10	121	65	1
14735	IEEE_802.15	201111	10	1	0	0	4	3	1	0	194	117	11	130	68	1
14735	IEEE_802.15	201112	1	0	0	0	1	1	0	0	195	118	11	131	69	1
14735	IEEE_802.15	201201	21	0	0	0	1	1	0	0	216	119	11	152	70	1
14735	IEEE_802.15	201205	4	0	0	0	4	4	0	0	220	123	11	156	74	1
14735	IEEE_802.15	201206	1	0	0	0	1	0	0	0	221	124	11	156	74	1
14735	IEEE_802.15	201208	3	0	0	0	1	1	0	0	224	125	11	159	75	1
14735	IEEE_802.15	201302	1	0	0	0	1	0	0	0	225	126	11	159	75	1
14735	IEEE_802.15	201311	1	0	0	0	1	1	0	0	226	127	11	160	76	1
14735	IEEE_802.15	201312	3	0	0	0	1	1	0	0	229	127	11	163	76	1
14735	IEEE_802.15	201404	1	0	0	0	1	1	0	0	230	128	11	164	77	1
14735	IEEE_802.15	201405	1	0	0	0	1	1	0	0	231	128	11	165	77	1
14735	IEEE_802.15	201406	1	0	0	0	1	1	0	0	232	128	11	166	77	1
14735	IEEE_802.15	201410	1	0	0	0	1	0	0	0	233	129	11	166	77	1
14735	IEEE_802.15	201411	1	0	0	0	1	0	0	0	234	130	11	166	77	1
14735	IEEE_802.15	201501	3	1	0	0	2	1	1	0	237	132	12	167	78	1
14735	IEEE_802.15	201503	2	0	0	0	1	1	0	0	239	133	12	169	79	1
14735	IEEE_802.15	201508	5	0	0	0	2	1	0	0	244	135	12	170	80	1
14735	IEEE_802.15	201509	1	0	0	0	1	1	0	0	245	136	12	171	81	1
14735	IEEE_802.15	201511	3	0	0	0	3	2	0	0	248	137	12	173	81	1
14735	IEEE_802.15	201512	1	0	0	0	1	1	0	0	249	138	12	174	82	1
14735	IEEE_802.15	201601	1	0	0	0	1	1	0	0	250	139	12	175	83	1
14735	IEEE_802.15	201603	3	0	0	0	3	2	0	0	253	142	12	177	85	1
14735	IEEE_802.15	201604	1	0	0	0	1	1	0	0	254	143	12	178	86	1
14735	IEEE_802.15	201607	3	1	0	0	2	1	1	0	257	145	13	179	87	1
14735	IEEE_802.15	201610	1	0	0	0	1	1	0	0	258	146	13	180	88	1
14735	IEEE_802.15	201701	2	1	0	0	2	1	1	0	260	147	14	181	88	1
14735	IEEE_802.15	201707	1	0	0	0	1	1	0	0	261	148	14	182	89	1
14735	IEEE_802.15	201709	2	0	0	0	1	0	0	0	263	149	14	182	89	1
14735	IEEE_802.15	201710	1	0	0	0	1	1	0	0	264	150	14	183	90	1
14735	IEEE_802.15	201712	1	0	0	0	1	0	0	0	265	150	14	183	90	1
14735	IEEE_802.15	201801	2	1	0	0	2	1	1	0	267	152	15	184	90	2
14735	IEEE_802.15	201804	1	0	0	0	1	0	0	0	268	153	15	184	90	2
14735	IEEE_802.15	201806	1	0	0	0	1	1	0	0	269	154	15	185	91	2
15318	IPv6	200201	3	0	0	0	3	3	0	0	3	3	0	3	3	0
15318	IPv6	200202	2	0	0	0	1	1	0	0	5	4	0	5	4	0
15318	IPv6	200205	1	0	0	0	1	1	0	0	6	5	0	6	4	0
15318	IPv6	200302	1	0	0	0	1	1	0	0	7	6	0	7	5	0
15318	IPv6	200303	2	0	0	0	1	0	0	0	9	7	0	7	5	0
15318	IPv6	200305	2	1	0	0	2	1	1	0	11	9	1	8	6	0
15318	IPv6	200306	1	0	0	0	1	1	0	0	12	10	1	9	7	0
15318	IPv6	200307	2	0	0	0	2	2	0	0	14	12	1	11	9	0
15318	IPv6	200308	2	0	0	0	1	1	0	0	16	13	1	13	10	0
15318	IPv6	200309	6	0	0	0	3	2	0	0	22	15	1	17	11	0
15318	IPv6	200311	2	0	0	0	1	1	0	0	24	16	1	19	12	0
15318	IPv6	200312	3	0	0	0	3	3	0	0	27	19	1	22	15	0
15318	IPv6	200401	7	0	0	0	5	3	0	0	34	24	1	26	18	0
15318	IPv6	200402	6	1	0	0	4	3	1	0	40	27	2	31	20	0
15318	IPv6	200403	2	0	0	0	2	1	0	0	42	29	2	32	21	0
15318	IPv6	200404	2	0	0	0	2	2	0	0	44	31	2	34	23	0
15318	IPv6	200405	3	0	0	0	3	3	0	0	47	32	2	37	24	0
15318	IPv6	200406	7	0	0	0	3	3	0	0	54	34	2	44	26	0
15318	IPv6	200407	8	0	0	0	8	4	0	0	62	41	2	48	28	0
15318	IPv6	200408	11	0	0	0	9	7	0	0	73	49	2	57	34	0
15318	IPv6	200409	5	0	0	0	5	3	0	0	78	53	2	60	36	0
15318	IPv6	200410	11	1	0	0	7	5	1	0	89	59	3	67	40	0
15318	IPv6	200411	12	0	0	0	7	5	0	0	101	65	3	77	44	0
15318	IPv6	200412	15	0	0	0	9	5	0	0	116	72	3	85	47	0
15318	IPv6	200501	11	0	0	0	5	5	0	0	127	76	3	96	51	0
15318	IPv6	200502	8	2	0	0	7	2	2	0	135	83	5	98	53	0
15318	IPv6	200503	6	0	0	0	6	3	0	0	141	89	5	101	56	0
15318	IPv6	200504	14	2	0	0	13	3	2	0	155	102	7	105	59	0
15318	IPv6	200505	15	2	0	0	13	8	2	0	170	114	9	115	66	0
15318	IPv6	200506	23	0	0	0	12	6	0	0	193	124	9	125	70	0
15318	IPv6	200507	17	2	0	0	11	5	2	0	210	132	11	131	72	0
15318	IPv6	200508	19	3	1	0	15	6	3	1	229	144	14	141	76	1
15318	IPv6	200509	13	2	0	0	10	3	2	0	242	151	16	145	77	1
15318	IPv6	200510	22	2	0	0	18	10	2	0	264	167	18	158	85	1
15318	IPv6	200511	86	2	0	0	24	9	2	0	350	189	20	178	93	2
15318	IPv6	200512	19	1	0	0	14	7	1	0	369	202	21	187	99	2
15318	IPv6	200601	49	4	0	0	31	10	4	0	418	229	25	210	105	2
15318	IPv6	200602	55	3	0	0	34	16	2	0	473	259	28	238	118	2
15318	IPv6	200603	61	3	0	0	30	12	3	0	534	285	31	275	128	2
15318	IPv6	200604	42	8	0	0	31	12	7	0	576	312	39	289	137	3
15318	IPv6	200605	40	5	0	0	22	10	5	0	616	332	44	312	145	3
15318	IPv6	200606	34	1	0	0	22	10	1	0	650	351	45	328	152	3
15318	IPv6	200607	51	4	0	0	30	17	3	0	701	379	49	354	167	3
15318	IPv6	200608	18	3	0	0	15	10	3	0	719	394	52	367	177	3
15318	IPv6	200609	53	6	0	0	35	19	5	0	772	424	58	394	192	4
15318	IPv6	200610	57	7	0	0	36	17	4	0	829	450	65	424	202	6
15318	IPv6	200611	52	8	0	0	27	16	4	0	881	471	73	459	213	8
15318	IPv6	200612	51	4	0	0	34	19	3	0	932	503	77	487	230	8
15318	IPv6	200701	61	9	0	0	39	20	8	0	993	536	86	519	246	9
15318	IPv6	200702	67	4	0	0	40	19	4	0	1060	571	90	559	260	9
15318	IPv6	200703	64	13	0	0	35	18	8	0	1124	598	103	599	271	9
15318	IPv6	200704	56	7	0	0	39	23	7	0	1180	634	110	630	291	10
15318	IPv6	200705	53	1	0	0	33	16	1	0	1233	660	111	661	301	10
15318	IPv6	200706	58	6	0	0	47	30	6	0	1291	700	117	698	326	11
15318	IPv6	200707	42	3	0	0	26	16	3	0	1333	722	120	728	338	12
15318	IPv6	200708	70	6	0	0	42	19	6	0	1403	753	126	764	346	12
15318	IPv6	200709	51	4	0	0	35	17	4	0	1454	782	130	791	357	12
15318	IPv6	200710	50	6	0	0	32	16	5	0	1504	808	136	811	367	13
15318	IPv6	200711	39	6	1	0	24	11	5	1	1543	825	142	833	372	15
15318	IPv6	200712	38	2	0	0	19	11	2	0	1581	842	144	862	381	15
15318	IPv6	200801	41	2	0	0	29	18	2	0	1622	867	146	890	395	15
15318	IPv6	200802	59	4	0	0	32	15	3	0	1681	892	150	921	403	15
15318	IPv6	200803	70	8	0	0	47	22	8	0	1751	930	158	956	417	15
15318	IPv6	200804	39	4	0	0	29	10	4	0	1790	952	162	969	420	16
15318	IPv6	200805	37	4	0	0	30	13	3	0	1827	976	166	986	428	16
15318	IPv6	200806	51	8	0	0	38	18	7	0	1878	1007	174	1014	439	16
15318	IPv6	200807	86	7	1	0	36	13	5	1	1964	1035	181	1060	446	18
15318	IPv6	200808	91	5	0	0	37	20	3	0	2055	1065	186	1129	460	18
15318	IPv6	200809	65	2	0	0	32	13	2	0	2120	1091	188	1169	469	18
15318	IPv6	200810	69	12	0	0	33	15	9	0	2189	1116	200	1212	477	22
15318	IPv6	200811	36	7	0	0	26	12	6	0	2225	1140	207	1228	487	23
15318	IPv6	200812	35	8	0	0	17	11	3	0	2260	1152	215	1253	493	25
15318	IPv6	200901	100	10	0	0	32	22	6	0	2360	1171	225	1340	503	30
15318	IPv6	200902	43	10	0	0	28	15	5	0	2403	1194	235	1368	513	34
15318	IPv6	200903	41	8	0	0	24	11	3	0	2444	1215	243	1388	521	38
15318	IPv6	200904	32	9	0	0	22	10	3	0	2476	1234	252	1406	528	40
15318	IPv6	200905	46	12	2	1	26	12	5	2	2522	1255	264	1433	535	43
15318	IPv6	200906	25	6	0	0	18	8	4	0	2547	1267	270	1444	538	45
15318	IPv6	200907	38	6	1	0	14	8	3	1	2585	1278	276	1472	543	47
15318	IPv6	200908	39	8	1	0	20	11	5	1	2624	1292	284	1501	549	51
15318	IPv6	200909	55	7	0	0	25	16	6	0	2679	1308	291	1537	557	52
15318	IPv6	200910	47	4	0	0	23	15	3	0	2726	1325	295	1569	566	52
15318	IPv6	200911	19	3	0	0	11	6	2	0	2745	1334	298	1582	570	53
15318	IPv6	200912	73	15	0	0	37	21	12	0	2818	1363	313	1623	583	55
15318	IPv6	201001	51	7	0	0	24	12	4	0	2869	1381	320	1653	589	55
15318	IPv6	201002	37	7	1	0	25	17	6	1	2906	1398	327	1679	599	58
15318	IPv6	201003	39	9	0	0	24	15	6	0	2945	1415	336	1707	607	59
15318	IPv6	201004	30	3	0	0	20	11	3	0	2975	1427	339	1725	611	59
15318	IPv6	201005	19	4	0	0	15	10	3	0	2994	1437	343	1737	617	61
15318	IPv6	201006	38	7	0	0	31	17	5	0	3032	1462	350	1760	628	61
15318	IPv6	201007	18	3	0	0	17	11	3	0	3050	1473	353	1771	633	61
15318	IPv6	201008	41	6	0	0	26	12	5	0	3091	1493	359	1792	639	61
15318	IPv6	201009	42	6	0	0	25	16	4	0	3133	1511	365	1825	648	62
15318	IPv6	201010	63	11	1	0	28	15	7	1	3196	1532	376	1875	656	66
15318	IPv6	201011	54	8	3	1	21	13	3	3	3250	1543	384	1919	660	72
15318	IPv6	201012	41	8	0	0	26	11	5	0	3291	1562	392	1937	664	74
15318	IPv6	201101	88	25	3	1	39	21	14	3	3379	1593	417	1986	677	80
15318	IPv6	201102	99	20	0	0	44	22	8	0	3478	1626	437	2057	688	87
15318	IPv6	201103	110	9	0	0	54	31	5	0	3588	1670	446	2143	709	92
15318	IPv6	201104	64	16	4	0	32	19	11	3	3652	1692	462	2181	720	99
15318	IPv6	201105	13	3	0	0	12	8	3	0	3665	1698	465	2190	723	100
15318	IPv6	201106	36	4	0	0	24	16	4	0	3701	1714	469	2214	731	102
15318	IPv6	201107	75	21	1	0	37	20	10	1	3776	1741	490	2266	742	112
15318	IPv6	201108	46	13	4	3	22	13	9	2	3822	1759	503	2287	751	113
15318	IPv6	201109	23	5	0	0	17	10	4	0	3845	1771	508	2301	756	113
15318	IPv6	201110	27	9	0	0	20	11	7	0	3872	1785	517	2317	761	114
15318	IPv6	201111	30	4	0	0	15	10	3	0	3902	1796	521	2341	767	115
15318	IPv6	201112	22	3	0	0	15	8	2	0	3924	1809	524	2352	773	116
15318	IPv6	201201	30	4	0	0	20	13	3	0	3954	1824	528	2369	781	117
15318	IPv6	201202	49	8	0	0	17	12	3	0	4003	1835	536	2413	787	122
15318	IPv6	201203	71	6	0	0	24	17	6	0	4074	1851	542	2475	796	124
15318	IPv6	201204	21	4	0	0	13	6	3	0	4095	1860	546	2487	799	126
15318	IPv6	201205	23	4	0	0	16	6	4	0	4118	1871	550	2496	801	126
15318	IPv6	201206	31	7	0	0	21	12	4	0	4149	1887	557	2514	808	126
15318	IPv6	201207	83	9	0	0	55	37	7	0	4232	1927	566	2574	826	127
15318	IPv6	201208	52	8	0	0	27	16	8	0	4284	1946	574	2609	833	131
15318	IPv6	201209	44	7	0	0	23	17	4	0	4328	1963	581	2644	844	133
15318	IPv6	201210	17	2	0	0	12	8	2	0	4345	1971	583	2654	848	133
15318	IPv6	201211	20	6	0	0	15	7	6	0	4365	1982	589	2664	851	133
15318	IPv6	201212	15	2	0	0	11	8	2	0	4380	1989	591	2676	854	134
15318	IPv6	201301	24	5	0	0	18	9	4	0	4404	2002	596	2687	858	137
15318	IPv6	201302	27	3	0	0	19	13	3	0	4431	2015	599	2708	865	137
15318	IPv6	201303	20	7	0	0	16	12	4	0	4451	2027	606	2724	872	141
15318	IPv6	201304	13	1	0	0	11	7	1	0	4464	2035	607	2733	876	141
15318	IPv6	201305	14	2	0	0	9	6	2	0	4478	2040	609	2743	878	141
15318	IPv6	201306	14	2	0	0	8	7	2	0	4492	2044	611	2756	881	142
15318	IPv6	201307	19	7	0	0	18	11	7	0	4511	2056	618	2767	886	143
15318	IPv6	201308	19	7	0	0	14	6	4	0	4530	2065	625	2776	886	143
15318	IPv6	201309	18	6	0	0	12	7	5	0	4548	2072	631	2786	888	144
15318	IPv6	201310	12	3	0	0	10	5	2	0	4560	2080	634	2793	891	144
15318	IPv6	201311	16	2	0	0	11	6	2	0	4576	2089	636	2803	895	144
15318	IPv6	201312	21	6	0	0	13	6	6	0	4597	2100	642	2809	899	144
15318	IPv6	201401	11	3	0	0	9	7	2	0	4608	2108	645	2818	905	145
15318	IPv6	201402	2	0	0	0	1	0	0	0	4610	2109	645	2818	905	145
15318	IPv6	201403	7	1	0	0	7	4	1	0	4617	2115	646	2822	908	145
15318	IPv6	201404	28	6	1	0	16	10	6	1	4645	2126	652	2833	913	146
15318	IPv6	201405	16	8	1	0	15	12	7	1	4661	2136	660	2846	921	151
15318	IPv6	201406	35	7	1	0	13	10	4	1	4696	2147	667	2878	929	157
15318	IPv6	201407	15	2	0	0	12	6	2	0	4711	2156	669	2886	932	157
15318	IPv6	201408	24	5	0	0	20	13	5	0	4735	2169	674	2902	936	158
15318	IPv6	201409	23	6	0	0	19	14	3	0	4758	2183	680	2920	944	162
15318	IPv6	201410	12	4	0	0	10	6	3	0	4770	2190	684	2927	947	164
15318	IPv6	201411	9	2	0	0	7	5	2	0	4779	2195	686	2934	949	164
15318	IPv6	201412	5	2	0	0	5	4	2	0	4784	2198	688	2938	951	165
15318	IPv6	201501	7	0	0	0	4	3	0	0	4791	2201	688	2944	953	165
15318	IPv6	201502	21	3	0	0	14	11	3	0	4812	2208	691	2961	957	165
15318	IPv6	201503	56	9	6	5	10	7	3	3	4868	2214	700	3014	960	173
15318	IPv6	201504	9	3	0	0	9	6	3	0	4877	2220	703	3020	963	175
15318	IPv6	201505	36	9	1	0	14	13	6	1	4913	2227	712	3053	967	181
15318	IPv6	201506	6	2	0	0	6	4	2	0	4919	2231	714	3057	969	182
15318	IPv6	201507	12	3	0	0	11	7	3	0	4931	2240	717	3065	974	183
15318	IPv6	201508	11	2	0	0	8	7	1	0	4942	2242	719	3075	974	185
15318	IPv6	201509	10	3	0	0	10	9	3	0	4952	2249	722	3084	980	187
15318	IPv6	201510	8	3	0	0	6	3	1	0	4960	2254	725	3089	982	187
15318	IPv6	201511	15	2	0	0	8	5	2	0	4975	2258	727	3101	983	187
15318	IPv6	201512	9	3	0	0	7	4	2	0	4984	2262	730	3107	984	188
15318	IPv6	201601	23	5	0	0	15	10	4	0	5007	2273	735	3118	989	190
15318	IPv6	201602	27	5	0	0	11	7	4	0	5034	2279	740	3128	991	191
15318	IPv6	201603	7	3	0	0	7	5	3	0	5041	2283	743	3133	993	192
15318	IPv6	201604	2	0	0	0	1	0	0	0	5043	2284	743	3133	993	192
15318	IPv6	201605	16	5	0	0	13	10	5	0	5059	2292	748	3145	996	194
15318	IPv6	201606	6	2	0	0	3	2	1	0	5065	2294	750	3149	997	194
15318	IPv6	201607	4	1	0	0	4	3	1	0	5069	2295	751	3152	997	194
15318	IPv6	201608	6	3	0	0	6	4	3	0	5075	2299	754	3156	999	195
15318	IPv6	201609	20	3	0	0	12	7	2	0	5095	2308	757	3171	1002	197
15318	IPv6	201610	16	4	0	0	11	8	4	0	5111	2316	761	3183	1006	199
15318	IPv6	201611	7	1	0	0	5	3	1	0	5118	2319	762	3186	1007	199
15318	IPv6	201612	14	4	0	0	10	7	4	0	5132	2327	766	3196	1012	200
15318	IPv6	201701	35	6	0	0	18	12	5	0	5167	2337	772	3217	1014	201
15318	IPv6	201702	9	3	0	0	8	5	3	0	5176	2344	775	3223	1018	201
15318	IPv6	201703	8	2	0	0	7	3	2	0	5184	2349	777	3226	1019	201
15318	IPv6	201704	6	2	0	0	6	5	2	0	5190	2352	779	3231	1021	202
15318	IPv6	201705	10	3	0	0	8	6	3	0	5200	2356	782	3238	1023	203
15318	IPv6	201706	7	1	0	0	6	4	1	0	5207	2359	783	3242	1024	203
15318	IPv6	201707	4	1	0	0	4	4	1	0	5211	2360	784	3246	1025	204
15318	IPv6	201708	14	3	0	0	12	10	3	0	5225	2369	787	3257	1030	205
15318	IPv6	201709	25	9	0	0	19	13	8	0	5250	2383	796	3274	1038	209
15318	IPv6	201710	7	2	0	0	7	4	2	0	5257	2388	798	3278	1039	210
15318	IPv6	201711	7	1	0	0	5	5	1	0	5264	2391	799	3285	1042	211
15318	IPv6	201712	30	6	0	0	15	13	5	0	5294	2399	805	3313	1047	216
15318	IPv6	201801	4	0	0	0	3	3	0	0	5298	2400	805	3317	1048	216
15318	IPv6	201802	18	5	0	0	16	13	5	0	5316	2412	810	3332	1055	219
15318	IPv6	201803	5	0	0	0	4	3	0	0	5321	2415	810	3336	1056	219
15318	IPv6	201804	8	4	0	0	8	5	4	0	5329	2419	814	3341	1056	220
15318	IPv6	201805	16	0	0	0	7	7	0	0	5345	2425	814	3357	1060	220
15318	IPv6	201806	5	0	0	0	4	4	0	0	5350	2426	814	3362	1061	220
15318	IPv6	201807	2	0	0	0	2	1	0	0	5352	2428	814	3363	1062	220
87409	ISCSI	200210	2	0	0	0	2	1	0	0	2	2	0	1	1	0
87409	ISCSI	200301	1	0	0	0	1	0	0	0	3	2	0	1	1	0
87409	ISCSI	200307	1	0	0	0	1	1	0	0	4	3	0	2	2	0
87409	ISCSI	200309	1	0	0	0	1	1	0	0	5	4	0	3	3	0
87409	ISCSI	200310	2	0	0	0	1	0	0	0	7	5	0	3	3	0
87409	ISCSI	200402	2	0	0	0	1	0	0	0	9	6	0	3	3	0
87409	ISCSI	200407	2	0	0	0	2	1	0	0	11	8	0	4	4	0
87409	ISCSI	200408	2	0	0	0	1	1	0	0	13	9	0	6	5	0
87409	ISCSI	200409	3	0	0	0	3	1	0	0	16	12	0	7	6	0
87409	ISCSI	200410	8	0	0	0	5	2	0	0	24	16	0	10	7	0
87409	ISCSI	200411	2	0	0	0	2	1	0	0	26	18	0	11	8	0
87409	ISCSI	200412	2	0	0	0	1	1	0	0	28	19	0	13	9	0
87409	ISCSI	200501	1	0	0	0	1	1	0	0	29	20	0	14	10	0
87409	ISCSI	200502	1	0	0	0	1	0	0	0	30	21	0	14	10	0
87409	ISCSI	200503	3	1	0	0	3	1	1	0	33	24	1	15	11	0
87409	ISCSI	200504	6	0	0	0	4	3	0	0	39	27	1	19	13	0
87409	ISCSI	200506	11	0	0	0	5	0	0	0	50	32	1	19	13	0
87409	ISCSI	200507	8	0	0	0	7	3	0	0	58	39	1	22	16	0
87409	ISCSI	200508	7	0	0	0	4	0	0	0	65	43	1	22	16	0
87409	ISCSI	200509	24	0	0	0	8	1	0	0	89	50	1	23	17	0
87409	ISCSI	200510	8	0	0	0	8	4	0	0	97	57	1	27	21	0
87409	ISCSI	200511	15	0	0	0	10	4	0	0	112	66	1	33	25	0
87409	ISCSI	200512	18	0	0	0	8	3	0	0	130	72	1	36	28	0
87409	ISCSI	200601	25	0	0	0	14	3	0	0	155	86	1	39	31	0
87409	ISCSI	200602	14	0	0	0	11	3	0	0	169	96	1	42	34	0
87409	ISCSI	200603	15	0	0	0	10	3	0	0	184	104	1	49	36	0
87409	ISCSI	200604	18	0	0	0	10	6	0	0	202	113	1	61	41	0
87409	ISCSI	200605	11	0	0	0	5	2	0	0	213	118	1	63	43	0
87409	ISCSI	200606	12	1	0	0	7	2	1	0	225	123	2	66	44	0
87409	ISCSI	200607	5	0	0	0	4	1	0	0	230	127	2	68	45	0
87409	ISCSI	200608	7	0	0	0	7	2	0	0	237	133	2	70	46	0
87409	ISCSI	200609	9	0	0	0	8	4	0	0	246	141	2	75	50	0
87409	ISCSI	200610	14	0	0	0	10	3	0	0	260	149	2	78	52	0
87409	ISCSI	200611	26	1	0	0	20	8	1	0	286	169	3	88	60	0
87409	ISCSI	200612	21	3	1	0	13	6	3	1	307	181	6	100	65	1
87409	ISCSI	200701	16	1	0	0	11	6	1	0	323	192	7	106	71	1
87409	ISCSI	200702	25	0	0	0	15	6	0	0	348	205	7	117	77	1
87409	ISCSI	200703	9	1	0	0	8	4	1	0	357	212	8	121	81	2
87409	ISCSI	200704	22	1	0	0	17	7	1	0	379	226	9	130	86	2
87409	ISCSI	200705	27	2	0	0	19	11	2	0	406	241	11	144	93	2
87409	ISCSI	200706	14	1	0	0	7	1	1	0	420	246	12	145	93	2
87409	ISCSI	200707	6	1	0	0	6	6	1	0	426	252	13	151	99	3
87409	ISCSI	200708	35	2	0	0	14	6	2	0	461	262	15	164	101	4
87409	ISCSI	200709	3	0	0	0	3	3	0	0	464	264	15	167	103	4
87409	ISCSI	200710	5	1	0	0	5	2	1	0	469	269	16	169	105	4
87409	ISCSI	200711	7	1	0	0	6	3	1	0	476	273	17	173	106	5
87409	ISCSI	200712	52	2	0	0	20	7	2	0	528	290	19	209	110	5
87409	ISCSI	200801	13	0	0	0	10	8	0	0	541	298	19	220	116	5
87409	ISCSI	200802	20	3	0	0	8	6	2	0	561	304	22	235	120	6
87409	ISCSI	200803	7	1	0	0	6	2	1	0	568	310	23	237	122	6
87409	ISCSI	200804	9	0	0	0	8	3	0	0	577	317	23	240	124	6
87409	ISCSI	200805	19	1	0	0	9	5	1	0	596	325	24	254	128	6
87409	ISCSI	200806	15	1	0	0	11	6	1	0	611	335	25	263	133	6
87409	ISCSI	200807	8	0	0	0	8	3	0	0	619	343	25	266	136	6
87409	ISCSI	200808	7	0	0	0	6	1	0	0	626	348	25	267	136	6
87409	ISCSI	200809	6	1	0	0	5	3	1	0	632	353	26	270	139	7
87409	ISCSI	200810	18	3	0	0	7	2	3	0	650	359	29	272	140	7
87409	ISCSI	200811	7	0	0	0	6	2	0	0	657	364	29	274	141	7
87409	ISCSI	200812	14	3	0	0	13	7	3	0	671	376	32	281	147	7
87409	ISCSI	200901	2	0	0	0	2	2	0	0	673	378	32	283	149	7
87409	ISCSI	200902	10	0	0	0	6	0	0	0	683	384	32	283	149	7
87409	ISCSI	200903	13	1	0	0	7	3	1	0	696	391	33	287	152	7
87409	ISCSI	200904	7	1	0	0	7	3	1	0	703	398	34	290	155	7
87409	ISCSI	200905	5	0	0	0	5	2	0	0	708	402	34	292	157	7
87409	ISCSI	200906	8	2	0	0	6	2	1	0	716	406	36	295	158	7
87409	ISCSI	200907	7	2	0	0	6	0	1	0	723	412	38	295	158	7
87409	ISCSI	200908	15	1	0	0	11	5	1	0	738	421	39	300	162	7
87409	ISCSI	200909	28	2	0	0	21	5	2	0	766	440	41	305	166	7
87409	ISCSI	200910	32	2	0	0	23	6	2	0	798	459	43	312	170	7
87409	ISCSI	200911	22	3	2	1	12	6	2	2	820	470	46	322	175	8
87409	ISCSI	200912	27	6	2	0	13	9	5	1	847	482	52	336	184	10
87409	ISCSI	201001	8	1	0	0	8	4	1	0	855	489	53	340	187	11
87409	ISCSI	201002	11	3	0	0	9	3	3	0	866	496	56	343	189	11
87409	ISCSI	201003	15	3	0	0	11	4	2	0	881	503	59	349	190	12
87409	ISCSI	201004	18	2	0	0	11	4	2	0	899	513	61	354	193	12
87409	ISCSI	201005	4	0	0	0	2	1	0	0	903	514	61	355	193	12
87409	ISCSI	201006	5	0	0	0	4	1	0	0	908	518	61	356	194	12
87409	ISCSI	201007	5	0	0	0	3	1	0	0	913	521	61	357	195	12
87409	ISCSI	201008	14	0	0	0	8	1	0	0	927	529	61	359	196	12
87409	ISCSI	201009	2	0	0	0	2	1	0	0	929	531	61	360	197	12
87409	ISCSI	201010	21	3	0	0	10	4	2	0	950	538	64	371	198	13
87409	ISCSI	201012	6	0	0	0	4	1	0	0	956	541	64	372	199	13
87409	ISCSI	201101	4	0	0	0	4	2	0	0	960	545	64	374	201	13
87409	ISCSI	201102	6	1	0	0	4	3	1	0	966	548	65	379	203	13
87409	ISCSI	201103	5	0	0	0	5	4	0	0	971	553	65	383	207	13
87409	ISCSI	201104	1	0	0	0	1	0	0	0	972	554	65	383	207	13
87409	ISCSI	201105	1	0	0	0	1	1	0	0	973	555	65	384	208	13
87409	ISCSI	201106	8	1	0	0	6	5	1	0	981	560	66	391	212	14
87409	ISCSI	201107	1	0	0	0	1	1	0	0	982	560	66	392	212	14
87409	ISCSI	201108	2	0	0	0	1	0	0	0	984	561	66	392	212	14
87409	ISCSI	201109	3	0	0	0	2	1	0	0	987	562	66	394	212	14
87409	ISCSI	201110	4	0	0	0	4	2	0	0	991	565	66	396	213	14
87409	ISCSI	201111	4	1	0	0	3	1	1	0	995	568	67	398	214	14
87409	ISCSI	201112	29	12	0	0	8	5	6	0	1024	575	79	413	218	18
87409	ISCSI	201201	9	1	0	0	7	3	1	0	1033	580	80	417	219	18
87409	ISCSI	201202	3	0	0	0	3	1	0	0	1036	583	80	418	220	18
87409	ISCSI	201203	3	0	0	0	3	1	0	0	1039	586	80	419	221	18
87409	ISCSI	201204	5	0	0	0	4	3	0	0	1044	588	80	422	222	18
87409	ISCSI	201205	7	0	0	0	3	1	0	0	1051	590	80	427	222	18
87409	ISCSI	201206	3	0	0	0	2	2	0	0	1054	592	80	430	224	18
87409	ISCSI	201207	6	0	0	0	5	3	0	0	1060	597	80	433	227	18
87409	ISCSI	201208	4	0	0	0	3	1	0	0	1064	600	80	435	228	18
87409	ISCSI	201209	12	2	0	0	6	5	1	0	1076	605	82	446	232	19
87409	ISCSI	201210	4	0	0	0	2	1	0	0	1080	607	82	449	233	19
87409	ISCSI	201211	1	0	0	0	1	0	0	0	1081	608	82	449	233	19
87409	ISCSI	201212	12	0	0	0	4	2	0	0	1093	611	82	458	234	19
87409	ISCSI	201301	6	1	0	0	6	3	1	0	1099	617	83	461	237	19
87409	ISCSI	201302	1	0	0	0	1	1	0	0	1100	618	83	462	238	19
87409	ISCSI	201303	4	0	0	0	4	3	0	0	1104	622	83	465	241	19
87409	ISCSI	201305	8	1	0	0	4	1	1	0	1112	625	84	466	241	19
87409	ISCSI	201306	5	0	0	0	4	2	0	0	1117	629	84	468	243	19
87409	ISCSI	201307	1	0	0	0	1	0	0	0	1118	630	84	468	243	19
87409	ISCSI	201308	2	0	0	0	2	2	0	0	1120	631	84	470	244	19
87409	ISCSI	201309	4	0	0	0	4	2	0	0	1124	634	84	472	245	19
87409	ISCSI	201310	5	0	0	0	4	2	0	0	1129	638	84	475	247	19
87409	ISCSI	201311	5	0	0	0	5	3	0	0	1134	642	84	478	249	19
87409	ISCSI	201312	17	0	0	0	5	3	0	0	1151	645	84	485	250	19
87409	ISCSI	201401	3	0	0	0	2	1	0	0	1154	647	84	486	251	19
87409	ISCSI	201403	1	0	0	0	1	1	0	0	1155	648	84	487	252	19
87409	ISCSI	201404	3	0	0	0	3	3	0	0	1158	649	84	490	253	19
87409	ISCSI	201405	3	1	0	0	3	1	1	0	1161	651	85	491	253	19
87409	ISCSI	201406	2	1	0	0	2	1	1	0	1163	652	86	492	253	19
87409	ISCSI	201407	3	0	0	0	2	1	0	0	1166	653	86	494	253	19
87409	ISCSI	201408	5	2	0	0	5	3	2	0	1171	657	88	497	255	19
87409	ISCSI	201409	4	1	0	0	4	3	1	0	1175	660	89	500	257	19
87409	ISCSI	201410	1	0	0	0	1	1	0	0	1176	660	89	501	257	19
87409	ISCSI	201411	5	2	0	0	4	1	1	0	1181	663	91	503	257	19
87409	ISCSI	201501	2	1	0	0	2	1	1	0	1183	664	92	504	257	19
87409	ISCSI	201502	7	0	0	0	4	3	0	0	1190	665	92	510	257	19
87409	ISCSI	201504	4	0	0	0	3	2	0	0	1194	666	92	513	257	19
87409	ISCSI	201506	6	1	0	0	4	3	1	0	1200	669	93	518	259	19
87409	ISCSI	201507	3	1	0	0	3	1	1	0	1203	671	94	519	259	19
87409	ISCSI	201508	3	0	0	0	3	3	0	0	1206	672	94	522	260	19
87409	ISCSI	201510	4	0	0	0	3	2	0	0	1210	674	94	524	261	19
87409	ISCSI	201511	1	0	0	0	1	1	0	0	1211	674	94	525	261	19
87409	ISCSI	201602	2	0	0	0	2	1	0	0	1213	676	94	526	262	19
87409	ISCSI	201603	3	0	0	0	2	2	0	0	1216	677	94	529	263	19
87409	ISCSI	201608	3	0	0	0	1	0	0	0	1219	678	94	529	263	19
87409	ISCSI	201609	4	2	0	0	4	2	2	0	1223	681	96	531	264	19
87409	ISCSI	201612	5	0	0	0	4	3	0	0	1228	683	96	534	265	19
87409	ISCSI	201701	1	0	0	0	1	0	0	0	1229	684	96	534	265	19
87409	ISCSI	201702	2	0	0	0	2	2	0	0	1231	686	96	536	267	19
87409	ISCSI	201703	2	0	0	0	2	2	0	0	1233	687	96	538	268	19
87409	ISCSI	201705	3	1	0	0	3	2	1	0	1236	689	97	540	269	19
87409	ISCSI	201706	2	0	0	0	1	1	0	0	1238	690	97	542	270	19
87409	ISCSI	201707	3	0	0	0	3	3	0	0	1241	692	97	545	272	19
87409	ISCSI	201709	3	0	0	0	2	0	0	0	1244	694	97	545	272	19
87409	ISCSI	201710	2	0	0	0	2	0	0	0	1246	696	97	545	272	19
87409	ISCSI	201712	6	3	0	0	3	2	2	0	1252	698	100	548	273	19
87409	ISCSI	201805	1	0	0	0	1	0	0	0	1253	699	100	548	273	19
87409	ISCSI	201807	2	0	0	0	2	2	0	0	1255	701	100	550	275	19
927507	Identity_management	200412	7	0	0	0	4	3	0	0	7	4	0	6	3	0
927507	Identity_management	200501	6	0	0	0	3	1	0	0	13	7	0	7	4	0
927507	Identity_management	200502	2	0	0	0	2	1	0	0	15	9	0	8	5	0
927507	Identity_management	200503	2	0	0	0	1	0	0	0	17	10	0	8	5	0
927507	Identity_management	200504	3	0	0	0	3	1	0	0	20	13	0	9	6	0
927507	Identity_management	200505	3	0	0	0	3	1	0	0	23	16	0	10	7	0
927507	Identity_management	200506	2	0	0	0	1	0	0	0	25	17	0	10	7	0
927507	Identity_management	200507	6	0	0	0	4	2	0	0	31	21	0	14	9	0
927507	Identity_management	200508	3	0	0	0	3	2	0	0	34	24	0	16	11	0
927507	Identity_management	200509	5	0	0	0	4	1	0	0	39	28	0	17	12	0
927507	Identity_management	200510	9	1	0	0	7	3	1	0	48	34	1	20	14	0
927507	Identity_management	200511	7	0	0	0	2	1	0	0	55	35	1	22	15	0
927507	Identity_management	200512	1	0	0	0	1	1	0	0	56	36	1	23	16	0
927507	Identity_management	200601	5	0	0	0	5	1	0	0	61	41	1	24	17	0
927507	Identity_management	200602	9	0	0	0	5	1	0	0	70	45	1	25	17	0
927507	Identity_management	200603	13	0	0	0	9	1	0	0	83	53	1	26	17	0
927507	Identity_management	200604	17	0	0	0	13	2	0	0	100	66	1	28	19	0
927507	Identity_management	200605	15	1	0	0	9	3	1	0	115	74	2	33	22	0
927507	Identity_management	200606	6	1	0	0	6	2	1	0	121	79	3	35	23	0
927507	Identity_management	200607	4	0	0	0	3	1	0	0	125	82	3	36	24	0
927507	Identity_management	200608	2	0	0	0	2	0	0	0	127	84	3	36	24	0
927507	Identity_management	200609	30	2	0	0	13	7	2	0	157	96	5	48	30	0
927507	Identity_management	200610	15	1	0	0	7	3	1	0	172	103	6	55	33	0
927507	Identity_management	200611	21	2	0	0	15	6	1	0	193	117	8	65	39	0
927507	Identity_management	200612	12	1	0	0	7	2	1	0	205	123	9	67	40	0
927507	Identity_management	200701	12	0	0	0	9	4	0	0	217	132	9	72	44	0
927507	Identity_management	200702	2	1	0	0	2	1	1	0	219	133	10	73	45	1
927507	Identity_management	200703	11	1	0	0	8	6	1	0	230	140	11	80	50	1
927507	Identity_management	200704	9	3	0	0	6	2	2	0	239	146	14	83	52	1
927507	Identity_management	200705	6	0	0	0	3	2	0	0	245	149	14	87	54	1
927507	Identity_management	200706	7	1	0	0	5	2	1	0	252	154	15	90	56	1
927507	Identity_management	200707	4	0	0	0	3	1	0	0	256	157	15	91	57	1
927507	Identity_management	200708	7	0	0	0	5	4	0	0	263	162	15	97	61	1
927507	Identity_management	200709	13	2	0	0	6	3	2	0	276	167	17	102	64	1
927507	Identity_management	200710	7	1	0	0	6	2	1	0	283	173	18	104	66	1
927507	Identity_management	200711	7	0	0	0	5	1	0	0	290	176	18	105	66	1
927507	Identity_management	200712	4	0	0	0	4	1	0	0	294	180	18	106	67	1
927507	Identity_management	200801	12	0	0	0	4	4	0	0	306	183	18	118	70	1
927507	Identity_management	200802	5	0	0	0	4	2	0	0	311	186	18	121	71	1
927507	Identity_management	200803	5	1	0	0	3	2	1	0	316	189	19	125	73	1
927507	Identity_management	200804	37	4	0	0	9	3	2	0	353	197	23	132	75	2
927507	Identity_management	200805	7	1	0	0	6	2	1	0	360	202	24	134	76	3
927507	Identity_management	200806	5	0	0	0	3	3	0	0	365	204	24	139	78	3
927507	Identity_management	200807	8	0	0	0	7	5	0	0	373	210	24	145	82	3
927507	Identity_management	200808	6	1	0	0	5	2	1	0	379	213	25	148	82	3
927507	Identity_management	200809	4	1	0	0	4	3	1	0	383	215	26	151	84	3
927507	Identity_management	200810	14	1	0	0	10	8	1	0	397	224	27	163	91	4
927507	Identity_management	200811	17	2	0	0	14	7	2	0	414	236	29	170	96	4
927507	Identity_management	200812	10	2	0	0	9	6	2	0	424	243	31	177	100	5
927507	Identity_management	200902	13	2	0	0	8	5	2	0	437	248	33	184	103	6
927507	Identity_management	200903	22	0	0	0	11	6	0	0	459	256	33	192	106	6
927507	Identity_management	200904	75	0	0	0	5	3	0	0	534	260	33	265	108	6
927507	Identity_management	200905	3	0	0	0	3	2	0	0	537	262	33	267	109	6
927507	Identity_management	200906	8	0	0	0	1	1	0	0	545	262	33	275	109	6
927507	Identity_management	200907	14	2	0	0	7	4	2	0	559	268	35	279	112	6
927507	Identity_management	200908	9	2	0	0	7	5	2	0	568	271	37	286	114	6
927507	Identity_management	200909	9	2	1	0	7	5	2	1	577	275	39	293	116	7
927507	Identity_management	200910	9	0	0	0	3	2	0	0	586	276	39	301	116	7
927507	Identity_management	200912	4	1	0	0	4	2	1	0	590	279	40	303	117	7
927507	Identity_management	201001	2	0	0	0	2	1	0	0	592	281	40	304	118	7
927507	Identity_management	201002	2	0	0	0	2	1	0	0	594	283	40	305	119	7
927507	Identity_management	201003	3	0	0	0	2	2	0	0	597	284	40	308	120	7
927507	Identity_management	201004	4	0	0	0	4	3	0	0	601	288	40	311	123	7
927507	Identity_management	201005	9	1	0	0	5	4	1	0	610	292	41	319	126	8
927507	Identity_management	201006	2	0	0	0	2	0	0	0	612	294	41	319	126	8
927507	Identity_management	201007	2	0	0	0	2	1	0	0	614	296	41	320	127	8
927507	Identity_management	201008	4	0	0	0	2	2	0	0	618	298	41	324	129	8
927507	Identity_management	201009	5	0	0	0	5	4	0	0	623	303	41	328	133	8
927507	Identity_management	201010	5	1	0	0	5	4	1	0	628	306	42	332	135	8
927507	Identity_management	201011	12	2	0	0	7	4	2	0	640	311	44	340	137	8
927507	Identity_management	201012	3	1	0	0	3	1	1	0	643	314	45	341	138	8
927507	Identity_management	201101	1	0	0	0	1	1	0	0	644	315	45	342	139	8
927507	Identity_management	201102	1	0	0	0	1	0	0	0	645	316	45	342	139	8
927507	Identity_management	201103	3	0	0	0	3	3	0	0	648	319	45	345	142	8
927507	Identity_management	201104	3	1	0	0	3	2	1	0	651	321	46	347	143	8
927507	Identity_management	201105	8	3	0	0	7	5	3	0	659	326	49	353	146	10
927507	Identity_management	201106	1	0	0	0	1	1	0	0	660	327	49	354	147	10
927507	Identity_management	201107	2	0	0	0	2	0	0	0	662	329	49	354	147	10
927507	Identity_management	201108	7	0	0	0	5	3	0	0	669	333	49	358	149	10
927507	Identity_management	201109	4	0	0	0	4	1	0	0	673	336	49	359	149	10
927507	Identity_management	201201	2	0	0	0	1	1	0	0	675	337	49	361	150	10
927507	Identity_management	201202	18	0	0	0	3	2	0	0	693	340	49	378	152	10
927507	Identity_management	201203	11	0	0	0	7	5	0	0	704	346	49	387	156	10
927507	Identity_management	201204	1	0	0	0	1	0	0	0	705	347	49	387	156	10
927507	Identity_management	201205	1	0	0	0	1	1	0	0	706	348	49	388	157	10
927507	Identity_management	201206	8	0	0	0	5	4	0	0	714	353	49	395	161	10
927507	Identity_management	201207	4	0	0	0	4	2	0	0	718	356	49	397	162	10
927507	Identity_management	201210	11	1	0	0	4	3	1	0	729	359	50	407	164	11
927507	Identity_management	201211	7	1	0	0	4	3	1	0	736	363	51	410	167	11
927507	Identity_management	201212	5	2	0	0	5	2	2	0	741	366	53	412	167	11
927507	Identity_management	201301	3	1	0	0	3	2	1	0	744	367	54	414	167	11
927507	Identity_management	201302	24	0	0	0	5	4	0	0	768	372	54	437	171	11
927507	Identity_management	201303	5	0	0	0	5	3	0	0	773	376	54	440	173	11
927507	Identity_management	201304	3	0	0	0	3	3	0	0	776	377	54	443	174	11
927507	Identity_management	201305	4	0	0	0	3	3	0	0	780	379	54	447	176	11
927507	Identity_management	201306	5	1	0	0	5	3	1	0	785	383	55	450	178	11
927507	Identity_management	201307	1	0	0	0	1	1	0	0	786	383	55	451	178	11
927507	Identity_management	201308	2	0	0	0	2	2	0	0	788	384	55	453	179	11
927507	Identity_management	201309	2	0	0	0	2	0	0	0	790	386	55	453	179	11
927507	Identity_management	201312	1	0	0	0	1	1	0	0	791	387	55	454	180	11
927507	Identity_management	201401	2	0	0	0	1	1	0	0	793	387	55	456	180	11
927507	Identity_management	201404	5	1	0	0	4	3	1	0	798	390	56	459	183	12
927507	Identity_management	201405	7	1	0	0	5	5	1	0	805	393	57	466	186	13
927507	Identity_management	201406	5	0	0	0	3	2	0	0	810	396	57	468	188	13
927507	Identity_management	201407	1	0	0	0	1	0	0	0	811	397	57	468	188	13
927507	Identity_management	201408	3	0	0	0	3	3	0	0	814	399	57	471	190	13
927507	Identity_management	201409	4	1	0	0	3	1	1	0	818	401	58	472	190	13
927507	Identity_management	201410	3	0	0	0	3	2	0	0	821	404	58	474	192	13
927507	Identity_management	201412	2	1	0	0	2	1	1	0	823	405	59	475	192	13
927507	Identity_management	201502	1	0	0	0	1	0	0	0	824	406	59	475	192	13
927507	Identity_management	201504	1	0	0	0	1	1	0	0	825	407	59	476	193	13
927507	Identity_management	201506	2	1	0	0	2	1	1	0	827	408	60	477	193	13
927507	Identity_management	201509	2	0	0	0	1	0	0	0	829	409	60	477	193	13
927507	Identity_management	201510	8	2	0	0	4	1	1	0	837	412	62	479	193	13
927507	Identity_management	201511	3	0	0	0	3	3	0	0	840	413	62	482	194	13
927507	Identity_management	201512	3	1	0	0	3	2	1	0	843	416	63	484	196	13
927507	Identity_management	201601	2	0	0	0	2	0	0	0	845	418	63	484	196	13
927507	Identity_management	201602	2	0	0	0	2	2	0	0	847	420	63	486	198	13
927507	Identity_management	201603	2	1	0	0	2	2	1	0	849	421	64	488	199	14
927507	Identity_management	201604	4	1	0	0	2	1	1	0	853	423	65	489	200	14
927507	Identity_management	201605	10	1	0	0	6	5	1	0	863	426	66	498	202	14
927507	Identity_management	201608	10	2	0	0	6	5	2	0	873	432	68	506	207	16
927507	Identity_management	201609	7	1	0	0	3	2	1	0	880	433	69	512	207	16
927507	Identity_management	201610	6	0	0	0	5	4	0	0	886	435	69	516	208	16
927507	Identity_management	201611	7	1	0	0	4	2	1	0	893	438	70	521	209	16
927507	Identity_management	201702	1	0	0	0	1	0	0	0	894	439	70	521	209	16
927507	Identity_management	201703	2	0	0	0	2	2	0	0	896	440	70	523	210	16
927507	Identity_management	201704	3	0	0	0	3	3	0	0	899	442	70	526	212	16
927507	Identity_management	201707	1	0	0	0	1	1	0	0	900	443	70	527	213	16
927507	Identity_management	201709	4	0	0	0	3	2	0	0	904	444	70	529	213	16
927507	Identity_management	201710	1	0	0	0	1	1	0	0	905	445	70	530	214	16
927507	Identity_management	201711	3	1	0	0	2	1	1	0	908	447	71	531	215	16
927507	Identity_management	201712	2	0	0	0	2	2	0	0	910	448	71	533	216	16
927507	Identity_management	201801	5	2	0	0	4	3	2	0	915	452	73	537	218	18
927507	Identity_management	201802	2	1	0	0	2	2	1	0	917	453	74	539	219	19
927507	Identity_management	201803	3	1	0	0	2	1	1	0	920	454	75	540	219	19
927507	Identity_management	201805	2	1	0	0	2	2	1	0	922	456	76	542	221	20
927507	Identity_management	201806	1	0	0	0	1	1	0	0	923	457	76	543	222	20
927507	Identity_management	201807	1	0	0	0	1	0	0	0	924	458	76	543	222	20
21825051	Identity_management_system	200906	34	0	0	0	2	2	0	0	34	2	0	34	2	0
21825051	Identity_management_system	200907	1	0	0	0	1	0	0	0	35	3	0	34	2	0
21825051	Identity_management_system	200908	2	0	0	0	1	1	0	0	37	4	0	36	3	0
21825051	Identity_management_system	200909	2	0	0	0	1	1	0	0	39	5	0	38	4	0
21825051	Identity_management_system	200910	1	0	0	0	1	1	0	0	40	5	0	39	4	0
21825051	Identity_management_system	200911	1	0	0	0	1	0	0	0	41	6	0	39	4	0
21825051	Identity_management_system	201003	4	0	0	0	3	2	0	0	45	9	0	42	6	0
21825051	Identity_management_system	201004	1	0	0	0	1	1	0	0	46	10	0	43	7	0
21825051	Identity_management_system	201005	1	0	0	0	1	1	0	0	47	11	0	44	8	0
21825051	Identity_management_system	201101	1	0	0	0	1	1	0	0	48	12	0	45	9	0
21825051	Identity_management_system	201102	2	0	0	0	2	1	0	0	50	14	0	46	10	0
21825051	Identity_management_system	201103	2	0	0	0	2	1	0	0	52	16	0	47	11	0
21825051	Identity_management_system	201104	5	0	0	0	1	0	0	0	57	17	0	47	11	0
21825051	Identity_management_system	201105	7	1	0	0	4	2	1	0	64	20	1	49	13	1
21825051	Identity_management_system	201107	1	0	0	0	1	1	0	0	65	21	1	50	14	1
21825051	Identity_management_system	201108	1	0	0	0	1	1	0	0	66	22	1	51	15	1
21825051	Identity_management_system	201201	1	0	0	0	1	0	0	0	67	23	1	51	15	1
21825051	Identity_management_system	201202	21	0	0	0	5	4	0	0	88	28	1	71	19	1
21825051	Identity_management_system	201203	3	0	0	0	3	1	0	0	91	31	1	72	20	1
21825051	Identity_management_system	201204	1	0	0	0	1	1	0	0	92	32	1	73	21	1
21825051	Identity_management_system	201206	1	0	0	0	1	1	0	0	93	33	1	74	22	1
21825051	Identity_management_system	201207	1	0	0	0	1	0	0	0	94	34	1	74	22	1
21825051	Identity_management_system	201208	2	0	0	0	1	1	0	0	96	35	1	76	23	1
21825051	Identity_management_system	201209	1	0	0	0	1	1	0	0	97	36	1	77	24	1
21825051	Identity_management_system	201211	3	0	0	0	2	2	0	0	100	38	1	80	26	1
21825051	Identity_management_system	201212	2	0	0	0	1	1	0	0	102	39	1	82	27	1
21825051	Identity_management_system	201301	6	0	0	0	3	2	0	0	108	42	1	86	29	1
21825051	Identity_management_system	201302	1	0	0	0	1	1	0	0	109	42	1	87	29	1
21825051	Identity_management_system	201303	2	0	0	0	1	1	0	0	111	43	1	89	30	1
21825051	Identity_management_system	201305	1	0	0	0	1	1	0	0	112	44	1	90	31	1
21825051	Identity_management_system	201306	1	0	0	0	1	1	0	0	113	45	1	91	32	1
21825051	Identity_management_system	201307	2	0	0	0	2	0	0	0	115	47	1	91	32	1
21825051	Identity_management_system	201310	3	0	0	0	3	2	0	0	118	50	1	93	34	1
21825051	Identity_management_system	201401	2	0	0	0	1	1	0	0	120	51	1	95	35	1
21825051	Identity_management_system	201402	2	0	0	0	1	0	0	0	122	52	1	95	35	1
21825051	Identity_management_system	201404	1	0	0	0	1	0	0	0	123	53	1	95	35	1
21825051	Identity_management_system	201405	2	1	0	0	2	2	1	0	125	55	2	97	37	2
21825051	Identity_management_system	201409	2	0	0	0	2	1	0	0	127	57	2	98	38	2
21825051	Identity_management_system	201410	8	0	0	0	4	2	0	0	135	61	2	101	40	2
21825051	Identity_management_system	201501	3	0	0	0	3	1	0	0	138	64	2	102	41	2
21825051	Identity_management_system	201502	2	1	0	0	2	1	1	0	140	66	3	103	42	2
21825051	Identity_management_system	201503	1	0	0	0	1	0	0	0	141	67	3	103	42	2
21825051	Identity_management_system	201504	2	0	0	0	1	0	0	0	143	68	3	103	42	2
21825051	Identity_management_system	201505	3	0	0	0	2	0	0	0	146	70	3	103	42	2
21825051	Identity_management_system	201506	1	0	0	0	1	1	0	0	147	71	3	104	43	2
21825051	Identity_management_system	201509	4	1	0	0	3	1	1	0	151	73	4	106	44	2
21825051	Identity_management_system	201512	3	0	0	0	1	0	0	0	154	74	4	106	44	2
21825051	Identity_management_system	201603	4	0	0	0	2	2	0	0	158	76	4	110	46	2
21825051	Identity_management_system	201604	2	0	0	0	2	2	0	0	160	78	4	112	48	2
21825051	Identity_management_system	201608	3	0	0	0	3	2	0	0	163	81	4	114	50	2
21825051	Identity_management_system	201705	1	0	0	0	1	1	0	0	164	82	4	115	51	2
21825051	Identity_management_system	201711	2	0	0	0	1	1	0	0	166	83	4	117	52	2
21825051	Identity_management_system	201803	2	0	0	0	2	1	0	0	168	85	4	118	53	2
50489717	Incident_Object_Description_Exchange_Format	201606	9	0	0	0	5	5	0	0	9	5	0	9	5	0
50489717	Incident_Object_Description_Exchange_Format	201612	5	0	0	0	2	1	0	0	14	6	0	11	5	0
50489717	Incident_Object_Description_Exchange_Format	201710	2	0	0	0	1	1	0	0	16	7	0	13	6	0
50489717	Incident_Object_Description_Exchange_Format	201711	1	0	0	0	1	1	0	0	17	8	0	14	7	0
50489717	Incident_Object_Description_Exchange_Format	201801	1	0	0	0	1	1	0	0	18	9	0	15	8	0
50489717	Incident_Object_Description_Exchange_Format	201803	2	0	0	0	1	1	0	0	20	10	0	17	9	0
50489717	Incident_Object_Description_Exchange_Format	201804	2	0	0	0	1	1	0	0	22	10	0	19	9	0
39773873	Industry_4.0	201307	7	0	0	0	3	3	0	0	7	3	0	7	3	0
39773873	Industry_4.0	201308	8	0	0	0	2	2	0	0	15	4	0	15	4	0
39773873	Industry_4.0	201309	3	0	0	0	3	3	0	0	18	6	0	18	6	0
39773873	Industry_4.0	201310	1	0	0	0	1	1	0	0	19	7	0	19	7	0
39773873	Industry_4.0	201311	3	0	0	0	2	0	0	0	22	9	0	19	7	0
39773873	Industry_4.0	201401	12	0	0	0	5	4	0	0	34	14	0	25	11	0
39773873	Industry_4.0	201402	1	0	0	0	1	0	0	0	35	15	0	25	11	0
39773873	Industry_4.0	201403	1	0	0	0	1	1	0	0	36	16	0	26	12	0
39773873	Industry_4.0	201404	2	0	0	0	2	0	0	0	38	18	0	26	12	0
39773873	Industry_4.0	201405	6	0	0	0	2	1	0	0	44	20	0	28	13	0
39773873	Industry_4.0	201406	3	0	0	0	1	1	0	0	47	21	0	31	14	0
39773873	Industry_4.0	201407	1	1	0	0	1	1	1	0	48	22	1	32	15	1
39773873	Industry_4.0	201408	10	0	0	0	1	0	0	0	58	23	1	32	15	1
39773873	Industry_4.0	201409	1	0	0	0	1	0	0	0	59	24	1	32	15	1
39773873	Industry_4.0	201410	2	0	0	0	2	2	0	0	61	26	1	34	17	1
39773873	Industry_4.0	201411	2	0	0	0	2	1	0	0	63	28	1	35	18	1
39773873	Industry_4.0	201412	5	0	0	0	4	3	0	0	68	32	1	39	21	1
39773873	Industry_4.0	201501	11	0	0	0	3	2	0	0	79	35	1	42	23	1
39773873	Industry_4.0	201502	6	0	0	0	3	2	0	0	85	38	1	45	25	1
39773873	Industry_4.0	201503	18	1	0	0	12	4	1	0	103	49	2	52	28	1
39773873	Industry_4.0	201504	2	0	0	0	2	2	0	0	105	51	2	54	30	1
39773873	Industry_4.0	201505	2	0	0	0	1	1	0	0	107	52	2	56	31	1
39773873	Industry_4.0	201507	6	0	0	0	3	3	0	0	113	54	2	62	33	1
39773873	Industry_4.0	201508	2	0	0	0	2	1	0	0	115	56	2	63	34	1
39773873	Industry_4.0	201509	3	0	0	0	2	1	0	0	118	58	2	64	35	1
39773873	Industry_4.0	201510	10	0	0	0	6	2	0	0	128	62	2	67	35	1
39773873	Industry_4.0	201511	2	0	0	0	2	1	0	0	130	64	2	68	36	1
39773873	Industry_4.0	201512	6	0	0	0	4	3	0	0	136	68	2	71	39	1
39773873	Industry_4.0	201601	4	1	0	0	4	1	1	0	140	72	3	72	40	1
39773873	Industry_4.0	201602	5	0	0	0	5	4	0	0	145	76	3	76	43	1
39773873	Industry_4.0	201603	10	1	0	0	9	7	1	0	155	84	4	84	47	2
39773873	Industry_4.0	201604	4	0	0	0	2	2	0	0	159	85	4	88	48	2
39773873	Industry_4.0	201605	2	0	0	0	2	1	0	0	161	87	4	89	49	2
39773873	Industry_4.0	201606	7	2	0	0	7	4	2	0	168	93	6	93	51	3
39773873	Industry_4.0	201607	4	0	0	0	1	0	0	0	172	94	6	93	51	3
39773873	Industry_4.0	201608	9	0	0	0	4	3	0	0	181	98	6	101	54	3
39773873	Industry_4.0	201609	11	2	0	0	7	6	2	0	192	105	8	111	60	5
39773873	Industry_4.0	201610	9	0	0	0	4	2	0	0	201	108	8	113	61	5
39773873	Industry_4.0	201611	5	0	0	0	4	3	0	0	206	111	8	117	63	5
39773873	Industry_4.0	201612	14	0	0	0	10	9	0	0	220	120	8	130	71	5
39773873	Industry_4.0	201701	19	2	0	0	15	9	2	0	239	132	10	140	77	5
39773873	Industry_4.0	201702	1	0	0	0	1	0	0	0	240	133	10	140	77	5
39773873	Industry_4.0	201703	5	0	0	0	3	1	0	0	245	136	10	141	78	5
39773873	Industry_4.0	201704	7	0	0	0	6	5	0	0	252	141	10	146	81	5
39773873	Industry_4.0	201705	2	1	0	0	2	2	1	0	254	142	11	148	82	6
39773873	Industry_4.0	201706	14	2	0	0	10	4	1	0	268	151	13	154	84	6
39773873	Industry_4.0	201707	14	1	0	0	7	2	1	0	282	157	14	159	85	6
39773873	Industry_4.0	201709	3	0	0	0	3	1	0	0	285	160	14	160	86	6
39773873	Industry_4.0	201710	7	2	0	0	5	3	2	0	292	164	16	163	88	7
39773873	Industry_4.0	201711	2	0	0	0	2	2	0	0	294	166	16	165	90	7
39773873	Industry_4.0	201712	21	0	0	0	7	5	0	0	315	171	16	176	93	7
39773873	Industry_4.0	201801	6	1	0	0	4	2	1	0	321	174	17	180	93	7
39773873	Industry_4.0	201802	11	0	0	0	7	4	0	0	332	179	17	186	95	7
39773873	Industry_4.0	201803	8	2	0	0	7	4	2	0	340	186	19	190	99	7
39773873	Industry_4.0	201804	1	0	0	0	1	1	0	0	341	187	19	191	100	7
39773873	Industry_4.0	201805	3	1	0	0	3	3	1	0	344	189	20	194	102	8
39773873	Industry_4.0	201806	3	1	0	0	3	2	1	0	347	191	21	196	103	9
39773873	Industry_4.0	201807	14	0	0	0	2	1	0	0	361	193	21	209	104	9
1197962	Information_and_communications_technology	200503	1	0	0	0	1	1	0	0	1	1	0	1	1	0
1197962	Information_and_communications_technology	200807	1	0	0	0	1	1	0	0	2	2	0	2	2	0
1197962	Information_and_communications_technology	200902	2	0	0	0	1	1	0	0	4	3	0	4	3	0
1197962	Information_and_communications_technology	200903	1	0	0	0	1	1	0	0	5	4	0	5	4	0
1197962	Information_and_communications_technology	200904	1	0	0	0	1	1	0	0	6	4	0	6	4	0
1197962	Information_and_communications_technology	200905	21	6	0	0	13	6	5	0	27	16	6	18	9	0
1197962	Information_and_communications_technology	200906	11	2	0	0	7	4	2	0	38	22	8	24	12	0
1197962	Information_and_communications_technology	200907	11	1	0	0	8	3	1	0	49	30	9	28	15	0
1197962	Information_and_communications_technology	200908	5	1	0	0	5	3	1	0	54	35	10	31	18	0
1197962	Information_and_communications_technology	200909	7	0	0	0	7	6	0	0	61	42	10	37	24	0
1197962	Information_and_communications_technology	200910	20	6	0	0	15	7	4	0	81	57	16	46	31	0
1197962	Information_and_communications_technology	200911	20	6	0	0	18	9	6	0	101	75	22	55	40	1
1197962	Information_and_communications_technology	200912	19	2	0	0	16	8	2	0	120	91	24	63	48	2
1197962	Information_and_communications_technology	201001	21	4	0	0	18	10	3	0	141	108	28	76	57	5
1197962	Information_and_communications_technology	201002	13	3	0	0	12	4	2	0	154	120	31	81	61	5
1197962	Information_and_communications_technology	201003	14	4	0	0	11	8	4	0	168	129	35	89	67	7
1197962	Information_and_communications_technology	201004	16	5	0	0	13	7	5	0	184	140	40	96	72	8
1197962	Information_and_communications_technology	201005	6	1	0	0	6	4	1	0	190	146	41	100	76	8
1197962	Information_and_communications_technology	201006	28	4	0	0	17	6	4	0	218	161	45	106	80	8
1197962	Information_and_communications_technology	201007	9	1	0	0	5	2	1	0	227	166	46	108	82	8
1197962	Information_and_communications_technology	201008	17	1	0	0	14	8	1	0	244	178	47	117	88	9
1197962	Information_and_communications_technology	201009	13	4	0	0	10	6	4	0	257	184	51	125	90	10
1197962	Information_and_communications_technology	201011	30	3	0	0	15	8	3	0	287	195	54	144	94	10
1197962	Information_and_communications_technology	201012	12	4	0	0	10	7	4	0	299	203	58	152	99	10
1197962	Information_and_communications_technology	201101	9	2	0	0	8	3	2	0	308	208	60	155	100	10
1197962	Information_and_communications_technology	201102	9	1	0	0	6	3	1	0	317	213	61	161	102	10
1197962	Information_and_communications_technology	201103	8	4	0	0	7	5	3	0	325	220	65	167	107	12
1197962	Information_and_communications_technology	201104	10	3	0	0	9	7	3	0	335	226	68	175	111	13
1197962	Information_and_communications_technology	201105	4	1	0	0	4	4	1	0	339	228	69	179	113	14
1197962	Information_and_communications_technology	201106	4	1	0	0	4	3	1	0	343	231	70	182	115	14
1197962	Information_and_communications_technology	201107	14	6	0	0	12	8	5	0	357	243	76	192	123	17
1197962	Information_and_communications_technology	201108	41	4	0	0	22	11	3	0	398	263	80	215	132	17
1197962	Information_and_communications_technology	201109	21	4	0	0	14	8	4	0	419	273	84	229	136	17
1197962	Information_and_communications_technology	201110	30	7	0	0	18	11	5	0	449	288	91	245	144	19
1197962	Information_and_communications_technology	201111	12	2	0	0	8	4	2	0	461	295	93	249	147	19
1197962	Information_and_communications_technology	201112	8	1	0	0	8	3	1	0	469	303	94	252	150	19
1197962	Information_and_communications_technology	201201	7	0	0	0	6	1	0	0	476	309	94	253	151	19
1197962	Information_and_communications_technology	201202	26	7	0	0	9	5	4	0	502	317	101	261	155	19
1197962	Information_and_communications_technology	201203	13	5	0	0	12	6	5	0	515	328	106	267	160	19
1197962	Information_and_communications_technology	201204	10	2	0	0	9	7	2	0	525	335	108	274	165	19
1197962	Information_and_communications_technology	201205	16	7	0	0	12	5	5	0	541	345	115	281	168	19
1197962	Information_and_communications_technology	201206	20	7	0	0	11	6	5	0	561	354	122	289	172	19
1197962	Information_and_communications_technology	201207	19	3	0	0	14	6	3	0	580	367	125	295	177	19
1197962	Information_and_communications_technology	201208	7	1	0	0	6	5	1	0	587	370	126	301	179	19
1197962	Information_and_communications_technology	201209	40	4	0	0	8	5	1	0	627	377	130	337	183	20
1197962	Information_and_communications_technology	201210	21	10	0	0	14	6	6	0	648	389	140	347	187	20
1197962	Information_and_communications_technology	201211	15	6	0	0	13	6	5	0	663	398	146	354	189	20
1197962	Information_and_communications_technology	201212	2	1	0	0	2	1	1	0	665	399	147	355	189	20
1197962	Information_and_communications_technology	201301	11	3	0	0	7	4	3	0	676	405	150	363	192	20
1197962	Information_and_communications_technology	201302	4	1	0	0	4	2	1	0	680	408	151	365	193	20
1197962	Information_and_communications_technology	201303	14	3	0	0	10	6	3	0	694	416	154	373	197	20
1197962	Information_and_communications_technology	201304	10	4	0	0	9	6	4	0	704	422	158	379	200	20
1197962	Information_and_communications_technology	201305	4	1	0	0	3	1	1	0	708	425	159	380	201	20
1197962	Information_and_communications_technology	201306	9	4	0	0	8	4	4	0	717	433	163	384	205	20
1197962	Information_and_communications_technology	201307	13	4	0	0	10	6	4	0	730	442	167	390	210	20
1197962	Information_and_communications_technology	201308	12	2	0	0	8	4	2	0	742	449	169	396	213	20
1197962	Information_and_communications_technology	201310	8	4	1	0	6	4	4	1	750	454	173	401	216	21
1197962	Information_and_communications_technology	201311	19	5	0	0	15	6	4	0	769	467	178	408	220	21
1197962	Information_and_communications_technology	201312	4	1	0	0	4	3	1	0	773	470	179	411	222	22
1197962	Information_and_communications_technology	201401	12	6	1	0	7	4	5	1	785	475	185	416	224	23
1197962	Information_and_communications_technology	201402	11	3	0	0	6	4	3	0	796	480	188	420	227	24
1197962	Information_and_communications_technology	201403	28	12	0	0	19	12	9	0	824	495	200	437	235	26
1197962	Information_and_communications_technology	201404	11	5	0	0	8	3	2	0	835	501	205	443	236	26
1197962	Information_and_communications_technology	201405	12	4	0	0	11	6	4	0	847	511	209	449	241	26
1197962	Information_and_communications_technology	201406	10	4	1	0	7	5	4	1	857	516	213	456	244	27
1197962	Information_and_communications_technology	201407	5	0	0	0	4	2	0	0	862	519	213	458	245	27
1197962	Information_and_communications_technology	201408	6	2	0	0	5	3	1	0	868	522	215	462	246	27
1197962	Information_and_communications_technology	201409	13	4	0	0	9	5	2	0	881	529	219	469	249	28
1197962	Information_and_communications_technology	201410	15	5	0	0	11	6	4	0	896	538	224	477	253	29
1197962	Information_and_communications_technology	201411	13	2	0	0	13	7	2	0	909	549	226	484	258	30
1197962	Information_and_communications_technology	201412	14	3	0	0	11	6	2	0	923	556	229	492	260	30
1197962	Information_and_communications_technology	201501	10	4	0	0	8	4	4	0	933	562	233	496	262	30
1197962	Information_and_communications_technology	201502	9	2	0	0	7	5	2	0	942	568	235	501	266	31
1197962	Information_and_communications_technology	201503	9	3	0	0	7	2	3	0	951	574	238	503	267	31
1197962	Information_and_communications_technology	201504	15	5	0	0	10	7	4	0	966	581	243	512	271	34
1197962	Information_and_communications_technology	201505	5	2	0	0	5	3	2	0	971	585	245	515	273	34
1197962	Information_and_communications_technology	201506	7	3	0	0	7	3	3	0	978	589	248	518	273	34
1197962	Information_and_communications_technology	201507	3	1	0	0	3	1	1	0	981	591	249	519	273	34
1197962	Information_and_communications_technology	201508	20	6	0	0	10	3	4	0	1001	599	255	523	274	35
1197962	Information_and_communications_technology	201509	13	1	0	0	6	3	1	0	1014	604	256	532	276	35
1197962	Information_and_communications_technology	201510	23	2	0	0	9	6	2	0	1037	610	258	551	279	35
1197962	Information_and_communications_technology	201511	24	6	0	0	16	7	5	0	1061	621	264	560	281	36
1197962	Information_and_communications_technology	201512	17	5	0	0	11	4	4	0	1078	629	269	565	282	36
1197962	Information_and_communications_technology	201601	4	2	1	0	4	1	2	1	1082	632	271	566	282	37
1197962	Information_and_communications_technology	201602	14	5	1	0	10	5	5	1	1096	641	276	573	286	41
1197962	Information_and_communications_technology	201603	17	6	0	0	12	7	5	0	1113	651	282	582	291	41
1197962	Information_and_communications_technology	201604	12	3	0	0	9	5	3	0	1125	659	285	590	295	41
1197962	Information_and_communications_technology	201605	17	4	0	0	13	7	4	0	1142	667	289	597	298	42
1197962	Information_and_communications_technology	201606	10	4	0	0	9	6	3	0	1152	673	293	604	300	44
1197962	Information_and_communications_technology	201607	10	4	0	0	8	5	3	0	1162	680	297	611	304	46
1197962	Information_and_communications_technology	201608	6	0	0	0	4	3	0	0	1168	684	297	616	306	46
1197962	Information_and_communications_technology	201609	7	1	0	0	6	4	1	0	1175	688	298	620	308	46
1197962	Information_and_communications_technology	201610	3	1	0	0	3	2	1	0	1178	690	299	622	309	46
1197962	Information_and_communications_technology	201611	8	1	0	0	5	2	1	0	1186	694	300	625	310	46
1197962	Information_and_communications_technology	201612	17	6	0	0	10	7	4	0	1203	702	306	636	314	47
1197962	Information_and_communications_technology	201701	6	0	0	0	4	3	0	0	1209	705	306	641	316	47
1197962	Information_and_communications_technology	201702	9	5	1	0	6	3	4	1	1218	708	311	645	317	49
1197962	Information_and_communications_technology	201703	3	1	0	0	3	1	1	0	1221	710	312	646	317	49
1197962	Information_and_communications_technology	201704	15	4	0	0	9	6	3	0	1236	716	316	655	319	49
1197962	Information_and_communications_technology	201705	10	1	0	0	6	4	1	0	1246	722	317	659	323	49
1197962	Information_and_communications_technology	201706	20	6	0	0	14	10	6	0	1266	733	323	670	329	51
1197962	Information_and_communications_technology	201707	13	5	0	0	9	5	4	0	1279	742	328	677	333	51
1197962	Information_and_communications_technology	201708	12	3	0	0	10	3	3	0	1291	751	331	680	335	51
1197962	Information_and_communications_technology	201709	2	1	0	0	2	2	1	0	1293	752	332	682	336	52
1197962	Information_and_communications_technology	201710	23	4	0	0	13	7	3	0	1316	762	336	695	339	55
1197962	Information_and_communications_technology	201711	13	0	0	0	9	3	0	0	1329	769	336	698	340	55
1197962	Information_and_communications_technology	201712	18	7	0	0	13	8	5	0	1347	779	343	709	344	57
1197962	Information_and_communications_technology	201801	11	3	0	0	10	7	3	0	1358	788	346	716	350	58
1197962	Information_and_communications_technology	201802	9	2	0	0	8	3	2	0	1367	794	348	720	351	58
1197962	Information_and_communications_technology	201803	1	0	0	0	1	1	0	0	1368	795	348	721	352	58
1197962	Information_and_communications_technology	201804	2	0	0	0	2	2	0	0	1370	797	348	723	354	58
1197962	Information_and_communications_technology	201805	6	0	0	0	6	3	0	0	1376	803	348	726	357	58
1197962	Information_and_communications_technology	201806	11	1	0	0	5	3	1	0	1387	808	349	734	360	58
1197962	Information_and_communications_technology	201807	42	11	0	0	12	9	6	0	1429	818	360	757	368	63
56938	Institute_of_Electrical_and_Electronics_Engineers	200210	2	0	0	0	1	1	0	0	2	1	0	2	1	0
56938	Institute_of_Electrical_and_Electronics_Engineers	200304	2	0	0	0	2	1	0	0	4	3	0	3	2	0
56938	Institute_of_Electrical_and_Electronics_Engineers	200305	2	0	0	0	2	1	0	0	6	5	0	4	3	0
56938	Institute_of_Electrical_and_Electronics_Engineers	200307	1	0	0	0	1	1	0	0	7	6	0	5	4	0
56938	Institute_of_Electrical_and_Electronics_Engineers	200308	1	0	0	0	1	1	0	0	8	7	0	6	5	0
56938	Institute_of_Electrical_and_Electronics_Engineers	200309	1	0	0	0	1	1	0	0	9	8	0	7	6	0
56938	Institute_of_Electrical_and_Electronics_Engineers	200310	2	0	0	0	2	2	0	0	11	10	0	9	8	0
56938	Institute_of_Electrical_and_Electronics_Engineers	200311	4	0	0	0	3	3	0	0	15	13	0	13	11	0
56938	Institute_of_Electrical_and_Electronics_Engineers	200312	1	0	0	0	1	1	0	0	16	14	0	14	12	0
56938	Institute_of_Electrical_and_Electronics_Engineers	200401	1	0	0	0	1	1	0	0	17	15	0	15	13	0
56938	Institute_of_Electrical_and_Electronics_Engineers	200402	2	0	0	0	2	2	0	0	19	17	0	17	15	0
56938	Institute_of_Electrical_and_Electronics_Engineers	200403	2	0	0	0	2	2	0	0	21	18	0	19	16	0
56938	Institute_of_Electrical_and_Electronics_Engineers	200405	1	0	0	0	1	1	0	0	22	19	0	20	17	0
56938	Institute_of_Electrical_and_Electronics_Engineers	200406	1	0	0	0	1	1	0	0	23	20	0	21	18	0
56938	Institute_of_Electrical_and_Electronics_Engineers	200407	2	0	0	0	2	0	0	0	25	22	0	21	18	0
56938	Institute_of_Electrical_and_Electronics_Engineers	200408	2	0	0	0	2	2	0	0	27	24	0	23	20	0
56938	Institute_of_Electrical_and_Electronics_Engineers	200410	6	0	0	0	5	3	0	0	33	29	0	26	23	0
56938	Institute_of_Electrical_and_Electronics_Engineers	200411	5	0	0	0	5	3	0	0	38	33	0	29	25	0
56938	Institute_of_Electrical_and_Electronics_Engineers	200412	17	0	0	0	5	3	0	0	55	38	0	35	28	0
56938	Institute_of_Electrical_and_Electronics_Engineers	200501	4	0	0	0	4	3	0	0	59	42	0	38	31	0
56938	Institute_of_Electrical_and_Electronics_Engineers	200502	1	0	0	0	1	1	0	0	60	43	0	39	32	0
56938	Institute_of_Electrical_and_Electronics_Engineers	200503	2	0	0	0	2	2	0	0	62	45	0	41	34	0
56938	Institute_of_Electrical_and_Electronics_Engineers	200504	4	0	0	0	3	3	0	0	66	48	0	45	37	0
56938	Institute_of_Electrical_and_Electronics_Engineers	200505	3	0	0	0	3	2	0	0	69	51	0	47	39	0
56938	Institute_of_Electrical_and_Electronics_Engineers	200506	4	0	0	0	3	1	0	0	73	54	0	48	40	0
56938	Institute_of_Electrical_and_Electronics_Engineers	200507	3	0	0	0	3	1	0	0	76	57	0	49	41	0
56938	Institute_of_Electrical_and_Electronics_Engineers	200508	6	0	0	0	5	3	0	0	82	62	0	52	44	0
56938	Institute_of_Electrical_and_Electronics_Engineers	200509	19	0	0	0	12	9	0	0	101	73	0	67	52	0
56938	Institute_of_Electrical_and_Electronics_Engineers	200510	11	0	0	0	9	6	0	0	112	81	0	75	57	0
56938	Institute_of_Electrical_and_Electronics_Engineers	200511	9	0	0	0	9	5	0	0	121	90	0	80	62	0
56938	Institute_of_Electrical_and_Electronics_Engineers	200512	23	0	0	0	19	12	0	0	144	106	0	92	71	0
56938	Institute_of_Electrical_and_Electronics_Engineers	200601	9	0	0	0	8	5	0	0	153	111	0	98	73	0
56938	Institute_of_Electrical_and_Electronics_Engineers	200602	17	0	0	0	12	9	0	0	170	122	0	112	81	0
56938	Institute_of_Electrical_and_Electronics_Engineers	200603	13	0	0	0	9	6	0	0	183	130	0	119	86	0
56938	Institute_of_Electrical_and_Electronics_Engineers	200604	11	0	0	0	9	4	0	0	194	138	0	124	89	0
56938	Institute_of_Electrical_and_Electronics_Engineers	200605	6	0	0	0	4	4	0	0	200	141	0	130	92	0
56938	Institute_of_Electrical_and_Electronics_Engineers	200606	10	0	0	0	6	4	0	0	210	146	0	135	95	0
56938	Institute_of_Electrical_and_Electronics_Engineers	200607	4	0	0	0	4	4	0	0	214	150	0	139	99	0
56938	Institute_of_Electrical_and_Electronics_Engineers	200608	31	0	0	0	7	3	0	0	245	156	0	143	101	0
56938	Institute_of_Electrical_and_Electronics_Engineers	200609	5	0	0	0	4	3	0	0	250	160	0	147	104	0
56938	Institute_of_Electrical_and_Electronics_Engineers	200610	23	0	0	0	10	4	0	0	273	168	0	151	108	0
56938	Institute_of_Electrical_and_Electronics_Engineers	200611	15	0	0	0	14	8	0	0	288	181	0	159	115	0
56938	Institute_of_Electrical_and_Electronics_Engineers	200612	20	0	0	0	16	11	0	0	308	194	0	173	123	0
56938	Institute_of_Electrical_and_Electronics_Engineers	200701	7	0	0	0	7	4	0	0	315	201	0	177	127	0
56938	Institute_of_Electrical_and_Electronics_Engineers	200702	16	0	0	0	8	5	0	0	331	207	0	190	130	0
56938	Institute_of_Electrical_and_Electronics_Engineers	200703	24	0	0	0	16	11	0	0	355	222	0	205	140	0
56938	Institute_of_Electrical_and_Electronics_Engineers	200704	12	0	0	0	8	4	0	0	367	229	0	211	143	0
56938	Institute_of_Electrical_and_Electronics_Engineers	200705	21	0	0	0	13	8	0	0	388	240	0	226	149	0
56938	Institute_of_Electrical_and_Electronics_Engineers	200706	8	0	0	0	8	6	0	0	396	248	0	232	155	0
56938	Institute_of_Electrical_and_Electronics_Engineers	200707	11	0	0	0	9	1	0	0	407	257	0	233	156	0
56938	Institute_of_Electrical_and_Electronics_Engineers	200708	18	0	0	0	10	7	0	0	425	267	0	248	163	0
56938	Institute_of_Electrical_and_Electronics_Engineers	200709	28	0	0	0	22	14	0	0	453	286	0	267	174	0
56938	Institute_of_Electrical_and_Electronics_Engineers	200710	13	0	0	0	9	5	0	0	466	293	0	276	178	0
56938	Institute_of_Electrical_and_Electronics_Engineers	200711	21	0	0	0	16	7	0	0	487	308	0	283	184	0
56938	Institute_of_Electrical_and_Electronics_Engineers	200712	13	0	0	0	10	5	0	0	500	318	0	290	189	0
56938	Institute_of_Electrical_and_Electronics_Engineers	200801	11	0	0	0	10	8	0	0	511	326	0	298	195	0
56938	Institute_of_Electrical_and_Electronics_Engineers	200802	17	0	0	0	14	11	0	0	528	338	0	312	204	0
56938	Institute_of_Electrical_and_Electronics_Engineers	200803	14	0	0	0	10	8	0	0	542	347	0	322	211	0
56938	Institute_of_Electrical_and_Electronics_Engineers	200804	7	0	0	0	4	4	0	0	549	349	0	329	213	0
56938	Institute_of_Electrical_and_Electronics_Engineers	200805	51	0	0	0	23	19	0	0	600	367	0	375	227	0
56938	Institute_of_Electrical_and_Electronics_Engineers	200806	14	0	0	0	6	3	0	0	614	371	0	378	228	0
56938	Institute_of_Electrical_and_Electronics_Engineers	200807	14	0	0	0	10	8	0	0	628	377	0	389	232	0
56938	Institute_of_Electrical_and_Electronics_Engineers	200808	13	0	0	0	12	11	0	0	641	387	0	400	241	0
56938	Institute_of_Electrical_and_Electronics_Engineers	200809	15	0	0	0	11	7	0	0	656	394	0	411	244	0
56938	Institute_of_Electrical_and_Electronics_Engineers	200810	4	0	0	0	4	1	0	0	660	398	0	412	245	0
56938	Institute_of_Electrical_and_Electronics_Engineers	200811	3	0	0	0	3	3	0	0	663	400	0	415	247	0
56938	Institute_of_Electrical_and_Electronics_Engineers	200812	9	0	0	0	8	6	0	0	672	406	0	422	251	0
56938	Institute_of_Electrical_and_Electronics_Engineers	200901	14	0	0	0	9	6	0	0	686	414	0	432	256	0
56938	Institute_of_Electrical_and_Electronics_Engineers	200902	15	0	0	0	7	6	0	0	701	417	0	444	259	0
56938	Institute_of_Electrical_and_Electronics_Engineers	200903	1	0	0	0	1	0	0	0	702	418	0	444	259	0
56938	Institute_of_Electrical_and_Electronics_Engineers	200904	5	0	0	0	4	2	0	0	707	421	0	447	260	0
56938	Institute_of_Electrical_and_Electronics_Engineers	200905	1	0	0	0	1	1	0	0	708	422	0	448	261	0
56938	Institute_of_Electrical_and_Electronics_Engineers	200906	22	0	0	0	5	4	0	0	730	426	0	452	265	0
56938	Institute_of_Electrical_and_Electronics_Engineers	200907	18	0	0	0	13	9	0	0	748	436	0	464	271	0
56938	Institute_of_Electrical_and_Electronics_Engineers	200908	7	0	0	0	7	3	0	0	755	440	0	467	272	0
56938	Institute_of_Electrical_and_Electronics_Engineers	200909	7	0	0	0	4	3	0	0	762	442	0	473	273	0
56938	Institute_of_Electrical_and_Electronics_Engineers	200910	6	0	0	0	6	3	0	0	768	446	0	476	274	0
56938	Institute_of_Electrical_and_Electronics_Engineers	200911	13	0	0	0	11	7	0	0	781	456	0	484	280	0
56938	Institute_of_Electrical_and_Electronics_Engineers	200912	4	0	0	0	4	3	0	0	785	459	0	487	282	0
56938	Institute_of_Electrical_and_Electronics_Engineers	201001	20	0	0	0	13	8	0	0	805	468	0	502	286	0
56938	Institute_of_Electrical_and_Electronics_Engineers	201002	7	0	0	0	4	3	0	0	812	470	0	508	287	0
56938	Institute_of_Electrical_and_Electronics_Engineers	201003	10	0	0	0	7	4	0	0	822	476	0	512	291	0
56938	Institute_of_Electrical_and_Electronics_Engineers	201004	13	0	0	0	9	4	0	0	835	484	0	520	294	0
56938	Institute_of_Electrical_and_Electronics_Engineers	201005	7	0	0	0	5	3	0	0	842	488	0	525	296	0
56938	Institute_of_Electrical_and_Electronics_Engineers	201006	8	0	0	0	6	1	0	0	850	493	0	526	296	0
56938	Institute_of_Electrical_and_Electronics_Engineers	201007	1	0	0	0	1	0	0	0	851	494	0	526	296	0
56938	Institute_of_Electrical_and_Electronics_Engineers	201008	6	0	0	0	2	1	0	0	857	494	0	527	296	0
56938	Institute_of_Electrical_and_Electronics_Engineers	201009	1	0	0	0	1	1	0	0	858	495	0	528	297	0
56938	Institute_of_Electrical_and_Electronics_Engineers	201010	9	0	0	0	7	4	0	0	867	502	0	534	301	0
56938	Institute_of_Electrical_and_Electronics_Engineers	201011	6	0	0	0	4	2	0	0	873	506	0	536	303	0
56938	Institute_of_Electrical_and_Electronics_Engineers	201012	32	0	0	0	7	7	0	0	905	511	0	568	308	0
56938	Institute_of_Electrical_and_Electronics_Engineers	201101	14	0	0	0	11	8	0	0	919	518	0	578	312	0
56938	Institute_of_Electrical_and_Electronics_Engineers	201102	29	0	0	0	18	11	0	0	948	532	0	596	319	0
56938	Institute_of_Electrical_and_Electronics_Engineers	201103	10	0	0	0	7	5	0	0	958	536	0	603	321	0
56938	Institute_of_Electrical_and_Electronics_Engineers	201104	6	0	0	0	6	5	0	0	964	538	0	608	323	0
56938	Institute_of_Electrical_and_Electronics_Engineers	201105	31	0	0	0	15	11	0	0	995	548	0	634	329	0
56938	Institute_of_Electrical_and_Electronics_Engineers	201106	4	0	0	0	4	3	0	0	999	550	0	637	330	0
56938	Institute_of_Electrical_and_Electronics_Engineers	201107	6	0	0	0	5	4	0	0	1005	553	0	642	332	0
56938	Institute_of_Electrical_and_Electronics_Engineers	201108	3	0	0	0	2	2	0	0	1008	555	0	645	334	0
56938	Institute_of_Electrical_and_Electronics_Engineers	201109	6	0	0	0	6	4	0	0	1014	560	0	649	337	0
56938	Institute_of_Electrical_and_Electronics_Engineers	201110	29	0	0	0	6	6	0	0	1043	566	0	678	343	0
56938	Institute_of_Electrical_and_Electronics_Engineers	201111	22	0	0	0	11	7	0	0	1065	572	0	695	345	0
56938	Institute_of_Electrical_and_Electronics_Engineers	201112	9	0	0	0	8	6	0	0	1074	578	0	702	349	0
56938	Institute_of_Electrical_and_Electronics_Engineers	201201	7	0	0	0	6	5	0	0	1081	582	0	708	352	0
56938	Institute_of_Electrical_and_Electronics_Engineers	201202	13	0	0	0	8	7	0	0	1094	587	0	715	356	0
56938	Institute_of_Electrical_and_Electronics_Engineers	201203	5	0	0	0	5	4	0	0	1099	589	0	719	357	0
56938	Institute_of_Electrical_and_Electronics_Engineers	201204	3	0	0	0	3	2	0	0	1102	590	0	721	357	0
56938	Institute_of_Electrical_and_Electronics_Engineers	201205	1	0	0	0	1	1	0	0	1103	591	0	722	358	0
56938	Institute_of_Electrical_and_Electronics_Engineers	201206	10	0	0	0	6	5	0	0	1113	594	0	729	360	0
56938	Institute_of_Electrical_and_Electronics_Engineers	201207	3	0	0	0	2	1	0	0	1116	596	0	730	361	0
56938	Institute_of_Electrical_and_Electronics_Engineers	201208	10	0	0	0	8	4	0	0	1126	602	0	734	363	0
56938	Institute_of_Electrical_and_Electronics_Engineers	201209	1	0	0	0	1	1	0	0	1127	603	0	735	364	0
56938	Institute_of_Electrical_and_Electronics_Engineers	201210	7	0	0	0	5	3	0	0	1134	606	0	740	365	0
56938	Institute_of_Electrical_and_Electronics_Engineers	201211	3	0	0	0	3	3	0	0	1137	609	0	743	368	0
56938	Institute_of_Electrical_and_Electronics_Engineers	201212	5	0	0	0	4	2	0	0	1142	612	0	746	369	0
56938	Institute_of_Electrical_and_Electronics_Engineers	201301	7	0	0	0	6	2	0	0	1149	617	0	748	370	0
56938	Institute_of_Electrical_and_Electronics_Engineers	201302	3	0	0	0	3	2	0	0	1152	620	0	750	372	0
56938	Institute_of_Electrical_and_Electronics_Engineers	201303	6	0	0	0	6	4	0	0	1158	623	0	754	373	0
56938	Institute_of_Electrical_and_Electronics_Engineers	201304	2	0	0	0	2	2	0	0	1160	624	0	756	374	0
56938	Institute_of_Electrical_and_Electronics_Engineers	201305	2	0	0	0	2	1	0	0	1162	626	0	757	375	0
56938	Institute_of_Electrical_and_Electronics_Engineers	201306	4	0	0	0	3	2	0	0	1166	629	0	760	377	0
56938	Institute_of_Electrical_and_Electronics_Engineers	201307	11	0	0	0	11	9	0	0	1177	638	0	769	385	0
56938	Institute_of_Electrical_and_Electronics_Engineers	201308	2	0	0	0	2	2	0	0	1179	640	0	771	387	0
56938	Institute_of_Electrical_and_Electronics_Engineers	201309	2	0	0	0	2	2	0	0	1181	641	0	773	388	0
56938	Institute_of_Electrical_and_Electronics_Engineers	201310	4	0	0	0	4	2	0	0	1185	645	0	775	390	0
56938	Institute_of_Electrical_and_Electronics_Engineers	201311	8	0	0	0	6	5	0	0	1193	650	0	781	394	0
56938	Institute_of_Electrical_and_Electronics_Engineers	201312	6	0	0	0	6	4	0	0	1199	655	0	785	397	0
56938	Institute_of_Electrical_and_Electronics_Engineers	201401	3	0	0	0	3	2	0	0	1202	658	0	787	399	0
56938	Institute_of_Electrical_and_Electronics_Engineers	201402	4	0	0	0	4	4	0	0	1206	660	0	791	401	0
56938	Institute_of_Electrical_and_Electronics_Engineers	201403	4	0	0	0	3	1	0	0	1210	662	0	792	402	0
56938	Institute_of_Electrical_and_Electronics_Engineers	201404	8	0	0	0	6	5	0	0	1218	666	0	798	405	0
56938	Institute_of_Electrical_and_Electronics_Engineers	201405	11	0	0	0	8	6	0	0	1229	673	0	806	410	0
56938	Institute_of_Electrical_and_Electronics_Engineers	201406	6	0	0	0	4	1	0	0	1235	674	0	807	410	0
56938	Institute_of_Electrical_and_Electronics_Engineers	201407	8	0	0	0	5	3	0	0	1243	677	0	813	411	0
56938	Institute_of_Electrical_and_Electronics_Engineers	201408	11	0	0	0	7	4	0	0	1254	682	0	821	413	0
56938	Institute_of_Electrical_and_Electronics_Engineers	201409	10	0	0	0	8	6	0	0	1264	686	0	827	415	0
56938	Institute_of_Electrical_and_Electronics_Engineers	201410	12	0	0	0	10	4	0	0	1276	694	0	831	417	0
56938	Institute_of_Electrical_and_Electronics_Engineers	201411	2	0	0	0	2	2	0	0	1278	695	0	833	418	0
56938	Institute_of_Electrical_and_Electronics_Engineers	201412	8	0	0	0	7	5	0	0	1286	699	0	839	420	0
56938	Institute_of_Electrical_and_Electronics_Engineers	201501	2	0	0	0	2	2	0	0	1288	701	0	841	422	0
56938	Institute_of_Electrical_and_Electronics_Engineers	201502	5	0	0	0	5	3	0	0	1293	704	0	844	423	0
56938	Institute_of_Electrical_and_Electronics_Engineers	201503	2	0	0	0	2	1	0	0	1295	705	0	845	423	0
56938	Institute_of_Electrical_and_Electronics_Engineers	201504	5	0	0	0	4	3	0	0	1300	707	0	849	424	0
56938	Institute_of_Electrical_and_Electronics_Engineers	201505	6	0	0	0	4	1	0	0	1306	710	0	850	424	0
56938	Institute_of_Electrical_and_Electronics_Engineers	201506	4	0	0	0	4	3	0	0	1310	713	0	853	427	0
56938	Institute_of_Electrical_and_Electronics_Engineers	201507	4	0	0	0	4	3	0	0	1314	717	0	856	430	0
56938	Institute_of_Electrical_and_Electronics_Engineers	201508	3	0	0	0	2	1	0	0	1317	718	0	857	430	0
56938	Institute_of_Electrical_and_Electronics_Engineers	201509	17	0	0	0	13	9	0	0	1334	728	0	870	436	0
56938	Institute_of_Electrical_and_Electronics_Engineers	201510	11	0	0	0	6	4	0	0	1345	732	0	875	438	0
56938	Institute_of_Electrical_and_Electronics_Engineers	201511	1	0	0	0	1	0	0	0	1346	733	0	875	438	0
56938	Institute_of_Electrical_and_Electronics_Engineers	201512	4	0	0	0	4	3	0	0	1350	735	0	878	440	0
56938	Institute_of_Electrical_and_Electronics_Engineers	201601	7	0	0	0	2	1	0	0	1357	737	0	884	441	0
56938	Institute_of_Electrical_and_Electronics_Engineers	201603	8	0	0	0	5	4	0	0	1365	740	0	891	443	0
56938	Institute_of_Electrical_and_Electronics_Engineers	201604	5	0	0	0	4	2	0	0	1370	744	0	893	445	0
56938	Institute_of_Electrical_and_Electronics_Engineers	201605	3	0	0	0	2	2	0	0	1373	745	0	896	446	0
56938	Institute_of_Electrical_and_Electronics_Engineers	201606	1	0	0	0	1	0	0	0	1374	746	0	896	446	0
56938	Institute_of_Electrical_and_Electronics_Engineers	201607	7	0	0	0	4	3	0	0	1381	749	0	900	448	0
56938	Institute_of_Electrical_and_Electronics_Engineers	201608	4	0	0	0	4	3	0	0	1385	752	0	903	450	0
56938	Institute_of_Electrical_and_Electronics_Engineers	201609	3	0	0	0	3	3	0	0	1388	755	0	906	453	0
56938	Institute_of_Electrical_and_Electronics_Engineers	201610	8	0	0	0	7	4	0	0	1396	761	0	911	456	0
56938	Institute_of_Electrical_and_Electronics_Engineers	201611	2	0	0	0	2	2	0	0	1398	762	0	913	457	0
56938	Institute_of_Electrical_and_Electronics_Engineers	201612	3	0	0	0	3	2	0	0	1401	764	0	915	458	0
56938	Institute_of_Electrical_and_Electronics_Engineers	201701	9	0	0	0	6	3	0	0	1410	769	0	918	460	0
56938	Institute_of_Electrical_and_Electronics_Engineers	201702	3	0	0	0	3	3	0	0	1413	771	0	921	462	0
56938	Institute_of_Electrical_and_Electronics_Engineers	201703	4	0	0	0	3	1	0	0	1417	773	0	922	462	0
56938	Institute_of_Electrical_and_Electronics_Engineers	201704	28	0	0	0	15	9	0	0	1445	784	0	943	467	0
56938	Institute_of_Electrical_and_Electronics_Engineers	201705	3	0	0	0	3	3	0	0	1448	786	0	946	469	0
56938	Institute_of_Electrical_and_Electronics_Engineers	201707	3	0	0	0	2	2	0	0	1451	788	0	949	470	0
56938	Institute_of_Electrical_and_Electronics_Engineers	201708	3	0	0	0	2	2	0	0	1454	790	0	952	472	0
56938	Institute_of_Electrical_and_Electronics_Engineers	201709	2	0	0	0	2	2	0	0	1456	791	0	954	472	0
56938	Institute_of_Electrical_and_Electronics_Engineers	201710	9	0	0	0	7	4	0	0	1465	796	0	958	473	0
56938	Institute_of_Electrical_and_Electronics_Engineers	201711	7	0	0	0	5	2	0	0	1472	800	0	961	474	0
56938	Institute_of_Electrical_and_Electronics_Engineers	201712	14	0	0	0	9	4	0	0	1486	807	0	969	476	0
56938	Institute_of_Electrical_and_Electronics_Engineers	201801	2	0	0	0	2	2	0	0	1488	808	0	971	477	0
56938	Institute_of_Electrical_and_Electronics_Engineers	201803	16	3	0	0	7	5	3	0	1504	813	3	981	480	1
56938	Institute_of_Electrical_and_Electronics_Engineers	201805	1	0	0	0	1	0	0	0	1505	814	3	981	480	1
56938	Institute_of_Electrical_and_Electronics_Engineers	201806	6	2	0	0	6	5	2	0	1511	819	5	986	484	2
56938	Institute_of_Electrical_and_Electronics_Engineers	201807	2	0	0	0	1	1	0	0	1513	820	5	988	485	2
15231	Integrated_Services_Digital_Network	200202	1	0	0	0	1	1	0	0	1	1	0	1	1	0
15231	Integrated_Services_Digital_Network	200209	2	0	0	0	2	1	0	0	3	3	0	2	2	0
15231	Integrated_Services_Digital_Network	200210	4	0	0	0	4	3	0	0	7	7	0	5	5	0
15231	Integrated_Services_Digital_Network	200211	1	0	0	0	1	1	0	0	8	8	0	6	6	0
15231	Integrated_Services_Digital_Network	200212	1	0	0	0	1	0	0	0	9	9	0	6	6	0
15231	Integrated_Services_Digital_Network	200303	1	0	0	0	1	0	0	0	10	10	0	6	6	0
15231	Integrated_Services_Digital_Network	200304	5	0	0	0	3	2	0	0	15	13	0	10	8	0
15231	Integrated_Services_Digital_Network	200305	2	0	0	0	2	2	0	0	17	14	0	12	9	0
15231	Integrated_Services_Digital_Network	200306	3	0	0	0	3	0	0	0	20	17	0	12	9	0
15231	Integrated_Services_Digital_Network	200307	6	0	0	0	2	1	0	0	26	19	0	16	10	0
15231	Integrated_Services_Digital_Network	200308	1	0	0	0	1	1	0	0	27	20	0	17	11	0
15231	Integrated_Services_Digital_Network	200309	2	0	0	0	2	1	0	0	29	22	0	18	12	0
15231	Integrated_Services_Digital_Network	200310	5	0	0	0	2	1	0	0	34	24	0	20	13	0
15231	Integrated_Services_Digital_Network	200311	1	0	0	0	1	1	0	0	35	24	0	21	13	0
15231	Integrated_Services_Digital_Network	200312	1	0	0	0	1	0	0	0	36	25	0	21	13	0
15231	Integrated_Services_Digital_Network	200402	1	0	0	0	1	0	0	0	37	26	0	21	13	0
15231	Integrated_Services_Digital_Network	200403	3	0	0	0	2	2	0	0	40	28	0	24	15	0
15231	Integrated_Services_Digital_Network	200404	4	0	0	0	3	3	0	0	44	30	0	28	17	0
15231	Integrated_Services_Digital_Network	200405	4	0	0	0	4	2	0	0	48	34	0	30	19	0
15231	Integrated_Services_Digital_Network	200406	6	0	0	0	2	1	0	0	54	36	0	33	20	0
15231	Integrated_Services_Digital_Network	200407	4	0	0	0	3	1	0	0	58	39	0	34	21	0
15231	Integrated_Services_Digital_Network	200408	8	1	0	0	7	5	1	0	66	45	1	40	25	0
15231	Integrated_Services_Digital_Network	200409	3	0	0	0	3	2	0	0	69	48	1	42	27	0
15231	Integrated_Services_Digital_Network	200410	2	0	0	0	2	1	0	0	71	50	1	43	28	0
15231	Integrated_Services_Digital_Network	200411	6	1	0	0	4	3	1	0	77	53	2	46	30	0
15231	Integrated_Services_Digital_Network	200412	6	1	0	0	6	2	1	0	83	59	3	48	32	0
15231	Integrated_Services_Digital_Network	200501	10	0	0	0	7	3	0	0	93	66	3	51	35	0
15231	Integrated_Services_Digital_Network	200502	10	2	0	0	8	4	2	0	103	74	5	57	39	0
15231	Integrated_Services_Digital_Network	200504	6	0	0	0	3	0	0	0	109	77	5	57	39	0
15231	Integrated_Services_Digital_Network	200505	10	0	0	0	7	5	0	0	119	84	5	63	44	0
15231	Integrated_Services_Digital_Network	200506	5	0	0	0	5	2	0	0	124	89	5	65	46	0
15231	Integrated_Services_Digital_Network	200507	3	0	0	0	3	3	0	0	127	92	5	68	49	0
15231	Integrated_Services_Digital_Network	200508	6	0	0	0	5	3	0	0	133	97	5	72	52	0
15231	Integrated_Services_Digital_Network	200509	6	1	0	0	6	2	1	0	139	103	6	74	54	0
15231	Integrated_Services_Digital_Network	200510	10	0	0	0	9	5	0	0	149	111	6	80	58	0
15231	Integrated_Services_Digital_Network	200511	16	1	0	0	12	2	1	0	165	122	7	82	59	0
15231	Integrated_Services_Digital_Network	200512	14	1	0	0	11	3	1	0	179	133	8	86	62	0
15231	Integrated_Services_Digital_Network	200601	7	1	0	0	6	2	1	0	186	139	9	88	64	0
15231	Integrated_Services_Digital_Network	200602	15	3	0	0	12	5	2	0	201	150	12	94	68	0
15231	Integrated_Services_Digital_Network	200603	4	0	0	0	4	2	0	0	205	154	12	96	70	0
15231	Integrated_Services_Digital_Network	200604	20	2	0	0	9	7	2	0	225	161	14	104	75	0
15231	Integrated_Services_Digital_Network	200605	28	9	0	0	22	9	8	0	253	181	23	116	82	0
15231	Integrated_Services_Digital_Network	200606	46	5	0	0	25	8	3	0	299	206	28	132	90	0
15231	Integrated_Services_Digital_Network	200607	9	2	0	0	8	5	2	0	308	214	30	138	95	1
15231	Integrated_Services_Digital_Network	200608	15	4	0	0	11	5	3	0	323	223	34	144	99	1
15231	Integrated_Services_Digital_Network	200609	15	4	0	0	9	4	2	0	338	231	38	151	102	1
15231	Integrated_Services_Digital_Network	200610	11	1	0	0	8	4	1	0	349	237	39	157	104	1
15231	Integrated_Services_Digital_Network	200611	26	7	4	3	19	11	4	2	375	256	46	172	115	3
15231	Integrated_Services_Digital_Network	200612	14	5	0	0	13	8	4	0	389	266	51	181	120	5
15231	Integrated_Services_Digital_Network	200701	18	1	0	0	12	9	1	0	407	276	52	195	127	5
15231	Integrated_Services_Digital_Network	200702	14	1	0	0	11	5	1	0	421	286	53	201	131	5
15231	Integrated_Services_Digital_Network	200703	17	6	0	0	13	5	4	0	438	298	59	208	135	5
15231	Integrated_Services_Digital_Network	200704	27	9	0	0	16	10	7	0	465	312	68	221	143	5
15231	Integrated_Services_Digital_Network	200705	9	2	0	0	8	4	2	0	474	319	70	226	146	5
15231	Integrated_Services_Digital_Network	200706	9	3	0	0	8	4	2	0	483	326	73	231	149	5
15231	Integrated_Services_Digital_Network	200707	10	2	0	0	9	7	2	0	493	334	75	238	156	5
15231	Integrated_Services_Digital_Network	200708	18	1	0	0	10	4	1	0	511	344	76	242	160	5
15231	Integrated_Services_Digital_Network	200709	7	0	0	0	5	4	0	0	518	348	76	248	163	5
15231	Integrated_Services_Digital_Network	200710	27	3	0	0	14	5	3	0	545	358	79	258	164	5
15231	Integrated_Services_Digital_Network	200711	7	0	0	0	6	2	0	0	552	363	79	260	165	5
15231	Integrated_Services_Digital_Network	200712	8	1	0	0	8	2	1	0	560	369	80	262	166	5
15231	Integrated_Services_Digital_Network	200801	8	0	0	0	7	5	0	0	568	373	80	268	168	5
15231	Integrated_Services_Digital_Network	200802	9	2	0	0	5	3	2	0	577	377	82	271	170	5
15231	Integrated_Services_Digital_Network	200803	19	6	0	0	12	5	4	0	596	389	88	280	175	9
15231	Integrated_Services_Digital_Network	200804	9	3	0	0	8	5	3	0	605	396	91	285	179	9
15231	Integrated_Services_Digital_Network	200805	21	3	0	0	19	5	3	0	626	414	94	290	183	9
15231	Integrated_Services_Digital_Network	200806	33	6	0	0	29	14	6	0	659	442	100	306	196	9
15231	Integrated_Services_Digital_Network	200807	18	0	0	0	5	3	0	0	677	447	100	311	199	9
15231	Integrated_Services_Digital_Network	200808	27	3	0	0	12	10	2	0	704	458	103	336	208	10
15231	Integrated_Services_Digital_Network	200809	23	1	0	0	18	9	1	0	727	475	104	348	216	10
15231	Integrated_Services_Digital_Network	200810	10	2	0	0	9	5	2	0	737	483	106	354	220	10
15231	Integrated_Services_Digital_Network	200811	18	4	0	0	14	5	4	0	755	496	110	359	224	10
15231	Integrated_Services_Digital_Network	200812	11	4	0	0	9	4	3	0	766	502	114	365	225	11
15231	Integrated_Services_Digital_Network	200901	10	3	0	0	8	6	2	0	776	508	117	372	229	12
15231	Integrated_Services_Digital_Network	200902	9	1	0	0	6	3	1	0	785	512	118	375	230	12
15231	Integrated_Services_Digital_Network	200903	17	1	0	0	12	3	1	0	802	523	119	379	232	12
15231	Integrated_Services_Digital_Network	200904	16	2	0	0	11	5	2	0	818	533	121	384	236	12
15231	Integrated_Services_Digital_Network	200905	5	1	0	0	3	1	1	0	823	535	122	385	236	12
15231	Integrated_Services_Digital_Network	200906	15	2	0	0	10	5	1	0	838	544	124	395	240	12
15231	Integrated_Services_Digital_Network	200907	20	3	0	0	12	5	3	0	858	552	127	406	241	13
15231	Integrated_Services_Digital_Network	200908	8	2	0	0	6	3	1	0	866	557	129	410	243	13
15231	Integrated_Services_Digital_Network	200909	14	1	0	0	4	2	1	0	880	561	130	413	245	13
15231	Integrated_Services_Digital_Network	200910	16	2	0	0	9	3	2	0	896	570	132	420	248	13
15231	Integrated_Services_Digital_Network	200911	5	2	0	0	5	3	2	0	901	574	134	423	250	14
15231	Integrated_Services_Digital_Network	200912	6	0	0	0	6	2	0	0	907	579	134	425	251	14
15231	Integrated_Services_Digital_Network	201001	8	1	0	0	6	4	1	0	915	583	135	431	253	14
15231	Integrated_Services_Digital_Network	201002	20	8	4	2	10	6	5	3	935	590	143	446	256	20
15231	Integrated_Services_Digital_Network	201003	12	3	0	0	8	5	2	0	947	595	146	455	258	20
15231	Integrated_Services_Digital_Network	201004	17	7	1	0	15	11	7	1	964	607	153	466	266	21
15231	Integrated_Services_Digital_Network	201005	6	1	0	0	6	4	1	0	970	613	154	470	270	21
15231	Integrated_Services_Digital_Network	201006	18	3	0	0	15	8	3	0	988	626	157	480	276	22
15231	Integrated_Services_Digital_Network	201007	18	5	0	0	16	9	5	0	1006	642	162	490	285	24
15231	Integrated_Services_Digital_Network	201008	17	2	0	0	11	7	2	0	1023	650	164	498	289	24
15231	Integrated_Services_Digital_Network	201009	8	0	0	0	7	3	0	0	1031	656	164	501	291	24
15231	Integrated_Services_Digital_Network	201010	15	4	0	0	13	5	4	0	1046	666	168	507	293	24
15231	Integrated_Services_Digital_Network	201011	14	4	0	0	11	7	4	0	1060	677	172	514	300	25
15231	Integrated_Services_Digital_Network	201012	24	3	0	0	12	2	2	0	1084	688	175	523	301	25
15231	Integrated_Services_Digital_Network	201101	10	1	0	0	7	2	1	0	1094	694	176	525	302	25
15231	Integrated_Services_Digital_Network	201102	16	4	0	0	15	7	4	0	1110	704	180	533	304	25
15231	Integrated_Services_Digital_Network	201103	10	1	0	0	6	3	1	0	1120	708	181	538	305	25
15231	Integrated_Services_Digital_Network	201104	14	4	0	0	10	4	4	0	1134	717	185	544	308	25
15231	Integrated_Services_Digital_Network	201105	19	3	0	0	15	9	3	0	1153	728	188	557	313	26
15231	Integrated_Services_Digital_Network	201106	2	1	0	0	2	1	1	0	1155	729	189	558	313	26
15231	Integrated_Services_Digital_Network	201107	6	2	0	0	5	3	2	0	1161	732	191	562	314	26
15231	Integrated_Services_Digital_Network	201108	8	1	0	0	8	6	1	0	1169	735	192	568	315	26
15231	Integrated_Services_Digital_Network	201109	11	3	0	0	9	5	3	0	1180	741	195	575	317	27
15231	Integrated_Services_Digital_Network	201110	1	0	0	0	1	1	0	0	1181	742	195	576	318	27
15231	Integrated_Services_Digital_Network	201111	7	0	0	0	6	3	0	0	1188	746	195	580	319	27
15231	Integrated_Services_Digital_Network	201112	2	1	0	0	2	1	1	0	1190	748	196	581	320	27
15231	Integrated_Services_Digital_Network	201201	5	1	0	0	4	2	1	0	1195	750	197	583	320	27
15231	Integrated_Services_Digital_Network	201202	1	0	0	0	1	1	0	0	1196	751	197	584	321	27
15231	Integrated_Services_Digital_Network	201204	15	4	0	0	9	4	2	0	1211	757	201	593	322	28
15231	Integrated_Services_Digital_Network	201205	1	0	0	0	1	1	0	0	1212	757	201	594	322	28
15231	Integrated_Services_Digital_Network	201206	6	0	0	0	4	2	0	0	1218	761	201	597	324	28
15231	Integrated_Services_Digital_Network	201207	12	1	0	0	9	7	1	0	1230	767	202	607	329	28
15231	Integrated_Services_Digital_Network	201208	9	2	0	0	7	4	2	0	1239	772	204	612	331	28
15231	Integrated_Services_Digital_Network	201209	3	1	0	0	3	1	1	0	1242	775	205	613	332	28
15231	Integrated_Services_Digital_Network	201210	1	0	0	0	1	1	0	0	1243	776	205	614	333	28
15231	Integrated_Services_Digital_Network	201212	6	2	0	0	6	2	2	0	1249	780	207	616	333	28
15231	Integrated_Services_Digital_Network	201301	15	1	0	0	4	4	1	0	1264	783	208	631	336	29
15231	Integrated_Services_Digital_Network	201302	5	2	0	0	5	2	2	0	1269	786	210	633	336	29
15231	Integrated_Services_Digital_Network	201303	1	0	0	0	1	1	0	0	1270	787	210	634	337	29
15231	Integrated_Services_Digital_Network	201304	3	1	0	0	3	0	1	0	1273	790	211	634	337	29
15231	Integrated_Services_Digital_Network	201305	7	0	0	0	4	3	0	0	1280	794	211	640	340	29
15231	Integrated_Services_Digital_Network	201306	6	0	0	0	4	3	0	0	1286	798	211	644	343	29
15231	Integrated_Services_Digital_Network	201307	8	2	0	0	8	4	2	0	1294	804	213	648	346	29
15231	Integrated_Services_Digital_Network	201308	3	1	0	0	3	2	1	0	1297	807	214	650	348	29
15231	Integrated_Services_Digital_Network	201309	2	0	0	0	2	0	0	0	1299	809	214	650	348	29
15231	Integrated_Services_Digital_Network	201310	2	0	0	0	2	0	0	0	1301	811	214	650	348	29
15231	Integrated_Services_Digital_Network	201311	6	3	0	0	5	3	3	0	1307	816	217	654	351	29
15231	Integrated_Services_Digital_Network	201312	11	4	1	0	10	7	4	1	1318	825	221	661	357	30
15231	Integrated_Services_Digital_Network	201401	6	2	0	0	5	3	2	0	1324	829	223	664	359	30
15231	Integrated_Services_Digital_Network	201402	7	1	0	0	6	3	1	0	1331	834	224	668	361	30
15231	Integrated_Services_Digital_Network	201403	1	0	0	0	1	0	0	0	1332	835	224	668	361	30
15231	Integrated_Services_Digital_Network	201404	1	0	0	0	1	1	0	0	1333	836	224	669	362	30
15231	Integrated_Services_Digital_Network	201406	1	0	0	0	1	0	0	0	1334	837	224	669	362	30
15231	Integrated_Services_Digital_Network	201407	52	24	7	2	17	10	10	3	1386	852	248	684	370	37
15231	Integrated_Services_Digital_Network	201408	2	0	0	0	1	1	0	0	1388	853	248	686	371	37
15231	Integrated_Services_Digital_Network	201409	2	0	0	0	1	0	0	0	1390	854	248	686	371	37
15231	Integrated_Services_Digital_Network	201410	7	1	0	0	6	3	1	0	1397	859	249	689	373	37
15231	Integrated_Services_Digital_Network	201411	1	1	0	0	1	1	1	0	1398	859	250	690	373	37
15231	Integrated_Services_Digital_Network	201502	1	0	0	0	1	0	0	0	1399	860	250	690	373	37
15231	Integrated_Services_Digital_Network	201503	8	2	0	0	6	3	2	0	1407	866	252	693	376	37
15231	Integrated_Services_Digital_Network	201504	1	0	0	0	1	1	0	0	1408	867	252	694	377	37
15231	Integrated_Services_Digital_Network	201505	2	0	0	0	2	2	0	0	1410	868	252	696	378	37
15231	Integrated_Services_Digital_Network	201506	16	4	0	0	10	6	4	0	1426	877	256	704	383	37
15231	Integrated_Services_Digital_Network	201508	4	1	0	0	4	2	1	0	1430	879	257	706	383	37
15231	Integrated_Services_Digital_Network	201510	1	0	0	0	1	1	0	0	1431	879	257	707	383	37
15231	Integrated_Services_Digital_Network	201511	5	1	0	0	4	2	1	0	1436	882	258	709	384	37
15231	Integrated_Services_Digital_Network	201512	2	0	0	0	1	0	0	0	1438	883	258	709	384	37
15231	Integrated_Services_Digital_Network	201602	1	0	0	0	1	0	0	0	1439	884	258	709	384	37
15231	Integrated_Services_Digital_Network	201603	3	1	0	0	3	3	1	0	1442	886	259	712	386	38
15231	Integrated_Services_Digital_Network	201604	3	0	0	0	2	2	0	0	1445	887	259	715	387	38
15231	Integrated_Services_Digital_Network	201605	1	0	0	0	1	0	0	0	1446	888	259	715	387	38
15231	Integrated_Services_Digital_Network	201606	2	0	0	0	1	0	0	0	1448	889	259	715	387	38
15231	Integrated_Services_Digital_Network	201607	3	0	0	0	2	1	0	0	1451	891	259	717	388	38
15231	Integrated_Services_Digital_Network	201608	3	0	0	0	2	1	0	0	1454	893	259	718	389	38
15231	Integrated_Services_Digital_Network	201609	1	0	0	0	1	1	0	0	1455	894	259	719	390	38
15231	Integrated_Services_Digital_Network	201610	4	1	0	0	3	1	1	0	1459	897	260	720	391	38
15231	Integrated_Services_Digital_Network	201611	9	3	0	0	5	4	3	0	1468	901	263	724	394	38
15231	Integrated_Services_Digital_Network	201701	1	0	0	0	1	1	0	0	1469	902	263	725	395	38
15231	Integrated_Services_Digital_Network	201703	2	1	0	0	2	2	1	0	1471	903	264	727	396	39
15231	Integrated_Services_Digital_Network	201704	4	1	0	0	3	3	1	0	1475	906	265	731	399	40
15231	Integrated_Services_Digital_Network	201705	6	2	0	0	6	3	2	0	1481	910	267	734	400	40
15231	Integrated_Services_Digital_Network	201706	1	0	0	0	1	1	0	0	1482	910	267	735	400	40
15231	Integrated_Services_Digital_Network	201707	1	0	0	0	1	1	0	0	1483	911	267	736	401	40
15231	Integrated_Services_Digital_Network	201709	1	0	0	0	1	1	0	0	1484	912	267	737	402	40
15231	Integrated_Services_Digital_Network	201710	2	0	0	0	2	1	0	0	1486	914	267	738	403	40
15231	Integrated_Services_Digital_Network	201711	5	0	0	0	1	1	0	0	1491	915	267	743	404	40
15231	Integrated_Services_Digital_Network	201712	4	1	0	0	3	1	1	0	1495	917	268	744	404	40
15231	Integrated_Services_Digital_Network	201801	2	0	0	0	2	2	0	0	1497	918	268	746	405	40
15231	Integrated_Services_Digital_Network	201803	1	0	0	0	1	0	0	0	1498	919	268	746	405	40
15231	Integrated_Services_Digital_Network	201804	1	0	0	0	1	1	0	0	1499	920	268	747	406	40
15231	Integrated_Services_Digital_Network	201805	6	3	0	0	5	3	3	0	1505	924	271	750	407	41
15231	Integrated_Services_Digital_Network	201806	4	0	0	0	3	1	0	0	1509	927	271	751	408	41
5175523	Intelligent_environment	200609	7	0	0	0	4	3	0	0	7	4	0	6	3	0
5175523	Intelligent_environment	200610	1	0	0	0	1	0	0	0	8	5	0	6	3	0
5175523	Intelligent_environment	200701	1	0	0	0	1	1	0	0	9	6	0	7	4	0
5175523	Intelligent_environment	200704	1	0	0	0	1	1	0	0	10	7	0	8	5	0
5175523	Intelligent_environment	200705	1	0	0	0	1	1	0	0	11	7	0	9	5	0
5175523	Intelligent_environment	200706	2	0	0	0	2	2	0	0	13	8	0	11	6	0
5175523	Intelligent_environment	200708	3	1	0	0	2	2	1	0	16	10	1	14	8	1
5175523	Intelligent_environment	200709	14	0	0	0	5	4	0	0	30	15	1	25	12	1
5175523	Intelligent_environment	200710	5	0	0	0	3	1	0	0	35	17	1	26	13	1
5175523	Intelligent_environment	200711	2	0	0	0	1	1	0	0	37	18	1	28	14	1
5175523	Intelligent_environment	200805	2	1	0	0	2	1	1	0	39	20	2	29	15	1
5175523	Intelligent_environment	200810	1	0	0	0	1	1	0	0	40	21	2	30	16	1
5175523	Intelligent_environment	200906	1	0	0	0	1	1	0	0	41	22	2	31	17	1
5175523	Intelligent_environment	200907	1	0	0	0	1	0	0	0	42	23	2	31	17	1
5175523	Intelligent_environment	201001	1	0	0	0	1	0	0	0	43	24	2	31	17	1
5175523	Intelligent_environment	201010	1	0	0	0	1	0	0	0	44	25	2	31	17	1
5175523	Intelligent_environment	201106	1	0	0	0	1	1	0	0	45	26	2	32	18	1
5175523	Intelligent_environment	201110	1	0	0	0	1	1	0	0	46	27	2	33	19	1
5175523	Intelligent_environment	201111	1	1	0	0	1	1	1	0	47	28	3	34	20	2
5175523	Intelligent_environment	201212	2	0	0	0	2	1	0	0	49	30	3	35	21	2
5175523	Intelligent_environment	201303	4	0	0	0	3	3	0	0	53	33	3	39	24	2
5175523	Intelligent_environment	201304	1	0	0	0	1	1	0	0	54	34	3	40	25	2
5175523	Intelligent_environment	201307	2	0	0	0	1	1	0	0	56	35	3	42	26	2
5175523	Intelligent_environment	201308	1	0	0	0	1	1	0	0	57	36	3	43	27	2
5175523	Intelligent_environment	201309	1	0	0	0	1	1	0	0	58	37	3	44	28	2
5175523	Intelligent_environment	201502	2	1	0	0	2	2	1	0	60	39	4	46	30	3
5175523	Intelligent_environment	201503	1	0	0	0	1	1	0	0	61	40	4	47	31	3
5175523	Intelligent_environment	201505	4	0	0	0	3	3	0	0	65	41	4	51	32	3
5175523	Intelligent_environment	201601	1	0	0	0	1	1	0	0	66	42	4	52	33	3
5175523	Intelligent_environment	201604	1	0	0	0	1	1	0	0	67	43	4	53	34	3
5175523	Intelligent_environment	201709	1	0	0	0	1	1	0	0	68	44	4	54	35	3
5175523	Intelligent_environment	201711	1	0	0	0	1	1	0	0	69	45	4	55	36	3
14539	Internet	200112	2	0	0	0	2	2	0	0	2	2	0	2	2	0
14539	Internet	200201	10	0	0	0	6	6	0	0	12	8	0	12	7	0
14539	Internet	200202	1	0	0	0	1	1	0	0	13	9	0	13	8	0
14539	Internet	200204	3	0	0	0	3	3	0	0	16	11	0	16	9	0
14539	Internet	200205	10	1	0	0	7	4	1	0	26	17	1	21	12	0
14539	Internet	200207	1	0	0	0	1	1	0	0	27	18	1	22	13	0
14539	Internet	200208	4	0	0	0	3	2	0	0	31	21	1	25	15	0
14539	Internet	200209	1	0	0	0	1	1	0	0	32	22	1	26	16	0
14539	Internet	200210	6	0	0	0	2	2	0	0	38	24	1	32	18	0
14539	Internet	200211	1	0	0	0	1	1	0	0	39	25	1	33	19	0
14539	Internet	200212	3	0	0	0	3	3	0	0	42	27	1	36	21	0
14539	Internet	200301	5	1	0	0	5	3	1	0	47	31	2	39	23	0
14539	Internet	200302	7	0	0	0	3	1	0	0	54	34	2	43	24	0
14539	Internet	200303	3	0	0	0	3	2	0	0	57	37	2	45	26	0
14539	Internet	200304	11	1	0	0	9	6	1	0	68	46	3	52	32	0
14539	Internet	200305	3	0	0	0	3	3	0	0	71	49	3	55	35	0
14539	Internet	200306	13	3	0	0	10	7	3	0	84	59	6	64	42	1
14539	Internet	200307	4	1	0	0	4	3	1	0	88	62	7	67	44	2
14539	Internet	200308	2	0	0	0	2	1	0	0	90	64	7	68	45	2
14539	Internet	200309	22	2	0	0	15	10	2	0	112	77	9	81	54	3
14539	Internet	200310	13	1	0	0	9	6	1	0	125	85	10	91	59	3
14539	Internet	200311	21	2	0	0	9	5	1	0	146	91	12	104	61	3
14539	Internet	200312	34	1	0	0	12	7	1	0	180	97	13	133	62	3
14539	Internet	200401	9	1	0	0	7	3	1	0	189	103	14	136	64	3
14539	Internet	200402	5	0	0	0	5	4	0	0	194	107	14	140	67	3
14539	Internet	200403	25	1	0	0	16	9	1	0	219	122	15	156	75	4
14539	Internet	200404	28	1	0	0	21	14	1	0	247	142	16	176	88	4
14539	Internet	200405	17	5	0	0	17	10	5	0	264	157	21	186	96	5
14539	Internet	200406	45	16	1	0	32	17	12	1	309	184	37	210	108	7
14539	Internet	200407	29	5	0	0	25	16	5	0	338	206	42	229	121	8
14539	Internet	200408	23	3	0	0	17	7	3	0	361	221	45	238	126	8
14539	Internet	200409	55	17	1	0	40	22	15	1	416	256	62	268	143	12
14539	Internet	200410	67	9	0	0	40	24	7	0	483	288	71	318	159	12
14539	Internet	200411	52	15	0	0	36	19	12	0	535	314	86	348	169	13
14539	Internet	200412	42	9	0	0	33	22	8	0	577	338	95	377	182	17
14539	Internet	200501	72	12	0	0	45	26	10	0	649	372	107	423	197	18
14539	Internet	200502	36	7	0	0	33	17	6	0	685	402	114	442	211	19
14539	Internet	200503	57	12	0	0	41	14	8	0	742	436	126	463	218	19
14539	Internet	200504	60	13	0	0	43	19	10	0	802	473	139	491	231	19
14539	Internet	200505	79	22	0	0	49	25	13	0	881	513	161	534	249	24
14539	Internet	200506	61	16	0	0	43	22	12	0	942	545	177	570	260	25
14539	Internet	200507	55	17	0	0	39	18	13	0	997	577	194	595	272	28
14539	Internet	200508	89	25	2	1	58	29	19	2	1086	624	219	650	291	35
14539	Internet	200509	116	25	0	0	86	39	18	0	1202	697	244	699	319	38
14539	Internet	200510	97	19	0	0	61	25	13	0	1299	748	263	741	336	41
14539	Internet	200511	155	46	0	0	92	44	28	0	1454	826	309	823	367	51
14539	Internet	200512	172	57	0	0	106	48	37	0	1626	916	366	904	399	61
14539	Internet	200601	197	61	3	1	131	61	43	2	1823	1023	427	1001	437	68
14539	Internet	200602	221	66	2	1	139	66	41	2	2044	1143	493	1127	484	77
14539	Internet	200603	157	45	1	0	101	47	28	1	2201	1226	538	1208	515	84
14539	Internet	200604	182	64	2	1	126	66	44	2	2383	1330	602	1307	560	99
14539	Internet	200605	190	62	0	0	120	61	35	0	2573	1425	664	1420	597	107
14539	Internet	200606	299	99	1	0	166	76	41	1	2872	1565	763	1580	650	115
14539	Internet	200607	224	71	0	0	129	67	40	0	3096	1669	834	1710	693	126
14539	Internet	200608	202	84	8	4	133	69	52	5	3298	1774	918	1820	736	144
14539	Internet	200609	215	81	3	1	134	73	48	3	3513	1875	999	1937	776	157
14539	Internet	200610	148	54	0	0	104	55	37	0	3661	1959	1053	2017	811	167
14539	Internet	200611	148	50	0	0	91	49	27	0	3809	2034	1103	2106	844	179
14539	Internet	200612	141	48	2	0	89	54	32	2	3950	2100	1151	2201	875	193
14539	Internet	200701	75	23	3	2	44	39	14	2	4025	2132	1174	2269	902	210
14539	Internet	200702	62	16	1	0	42	35	14	1	4087	2165	1190	2314	928	216
14539	Internet	200703	48	7	0	0	34	34	7	0	4135	2194	1197	2362	957	223
14539	Internet	200704	170	51	2	0	113	70	35	2	4305	2290	1248	2473	1011	240
14539	Internet	200705	395	147	4	1	249	109	82	4	4700	2501	1395	2665	1082	259
14539	Internet	200706	345	128	14	8	206	107	67	6	5045	2669	1523	2848	1152	287
14539	Internet	200707	112	33	2	1	67	45	21	2	5157	2723	1556	2912	1184	299
14539	Internet	200708	129	47	0	0	95	48	27	0	5286	2801	1603	2982	1216	307
14539	Internet	200709	262	96	1	0	162	80	52	1	5548	2941	1699	3112	1275	323
14539	Internet	200710	419	173	4	0	216	104	79	4	5967	3119	1872	3340	1342	362
14539	Internet	200711	125	38	0	0	75	52	18	0	6092	3179	1910	3436	1379	387
14539	Internet	200712	314	122	2	1	194	83	59	2	6406	3338	2032	3595	1427	411
14539	Internet	200801	250	96	3	1	154	69	48	2	6656	3461	2128	3730	1465	432
14539	Internet	200802	144	48	0	0	93	58	31	0	6800	3530	2176	3817	1499	440
14539	Internet	200803	72	18	2	0	43	43	13	2	6872	3559	2194	3889	1528	458
14539	Internet	200804	24	6	0	0	18	18	6	0	6896	3572	2200	3913	1541	464
14539	Internet	200805	47	7	0	0	33	33	6	0	6943	3594	2207	3960	1563	471
14539	Internet	200806	23	4	0	0	18	18	4	0	6966	3605	2211	3983	1574	475
14539	Internet	200807	18	2	0	0	8	8	1	0	6984	3610	2213	4001	1579	477
14539	Internet	200808	31	1	0	0	19	19	1	0	7015	3620	2214	4032	1589	478
14539	Internet	200809	32	7	1	0	17	16	6	1	7047	3629	2221	4063	1597	484
14539	Internet	200810	22	6	0	0	19	19	5	0	7069	3643	2227	4085	1611	490
14539	Internet	200811	21	4	0	0	15	15	4	0	7090	3653	2231	4106	1621	494
14539	Internet	200812	18	3	0	0	14	14	3	0	7108	3663	2234	4124	1631	497
14539	Internet	200901	18	2	0	0	14	14	2	0	7126	3672	2236	4142	1640	499
14539	Internet	200902	60	7	1	0	42	39	6	1	7186	3699	2243	4199	1664	504
14539	Internet	200903	101	32	4	3	56	34	18	2	7287	3743	2275	4256	1687	513
14539	Internet	200904	22	2	0	0	18	18	2	0	7309	3753	2277	4278	1697	515
14539	Internet	200905	18	4	0	0	14	14	4	0	7327	3761	2281	4296	1705	519
14539	Internet	200906	25	2	0	0	15	15	2	0	7352	3771	2283	4321	1715	521
14539	Internet	200907	44	2	1	0	18	18	2	1	7396	3783	2285	4365	1727	523
14539	Internet	200908	7	0	0	0	5	5	0	0	7403	3787	2285	4372	1731	523
14539	Internet	200909	57	2	0	0	13	13	2	0	7460	3793	2287	4429	1737	525
14539	Internet	200910	65	5	1	0	18	18	4	1	7525	3801	2292	4494	1745	530
14539	Internet	200911	15	3	0	0	10	10	3	0	7540	3807	2295	4509	1751	533
14539	Internet	200912	16	1	0	0	7	7	1	0	7556	3811	2296	4525	1755	534
14539	Internet	201001	32	7	1	1	18	18	6	1	7588	3824	2303	4557	1768	541
14539	Internet	201002	16	3	0	0	15	15	3	0	7604	3834	2306	4573	1778	544
14539	Internet	201003	13	5	0	0	11	11	3	0	7617	3839	2311	4586	1783	549
14539	Internet	201004	11	0	0	0	8	8	0	0	7628	3841	2311	4597	1785	549
14539	Internet	201005	6	0	0	0	5	5	0	0	7634	3842	2311	4603	1786	549
14539	Internet	201006	27	2	0	0	15	15	2	0	7661	3852	2313	4630	1796	551
14539	Internet	201007	6	0	0	0	6	6	0	0	7667	3856	2313	4636	1800	551
14539	Internet	201008	29	0	0	0	17	17	0	0	7696	3867	2313	4665	1811	551
14539	Internet	201009	55	7	0	0	18	18	4	0	7751	3878	2320	4720	1822	558
14539	Internet	201010	10	0	0	0	7	7	0	0	7761	3883	2320	4730	1827	558
14539	Internet	201011	24	4	1	0	13	13	4	1	7785	3891	2324	4754	1835	562
14539	Internet	201012	15	3	1	0	10	10	3	1	7800	3895	2327	4769	1839	565
14539	Internet	201101	9	0	0	0	8	8	0	0	7809	3899	2327	4778	1843	565
14539	Internet	201102	29	5	0	0	17	17	3	0	7838	3908	2332	4807	1852	570
14539	Internet	201103	18	2	0	0	13	13	2	0	7856	3913	2334	4825	1857	572
14539	Internet	201104	23	1	0	0	18	18	1	0	7879	3922	2335	4848	1866	573
14539	Internet	201105	14	2	0	0	12	12	2	0	7893	3929	2337	4862	1873	575
14539	Internet	201106	12	1	0	0	10	10	1	0	7905	3934	2338	4874	1878	576
14539	Internet	201107	12	2	0	0	10	10	2	0	7917	3940	2340	4886	1884	578
14539	Internet	201108	15	1	0	0	9	9	1	0	7932	3946	2341	4901	1890	579
14539	Internet	201109	9	0	0	0	6	6	0	0	7941	3950	2341	4910	1894	579
14539	Internet	201110	26	1	0	0	13	13	1	0	7967	3956	2342	4936	1900	580
14539	Internet	201111	29	2	0	0	17	17	1	0	7996	3966	2344	4965	1910	582
14539	Internet	201112	9	0	0	0	7	7	0	0	8005	3969	2344	4974	1913	582
14539	Internet	201201	13	0	0	0	10	10	0	0	8018	3975	2344	4987	1919	582
14539	Internet	201202	14	1	0	0	13	13	1	0	8032	3983	2345	5001	1927	583
14539	Internet	201203	5	1	0	0	5	5	1	0	8037	3987	2346	5006	1931	584
14539	Internet	201204	9	0	0	0	9	9	0	0	8046	3994	2346	5015	1938	584
14539	Internet	201205	23	0	0	0	10	10	0	0	8069	4000	2346	5038	1944	584
14539	Internet	201206	13	1	0	0	12	12	1	0	8082	4009	2347	5051	1953	585
14539	Internet	201207	7	1	0	0	6	6	1	0	8089	4014	2348	5058	1958	586
14539	Internet	201208	12	0	0	0	7	7	0	0	8101	4019	2348	5070	1963	586
14539	Internet	201209	5	0	0	0	5	5	0	0	8106	4022	2348	5075	1966	586
14539	Internet	201210	18	3	0	0	14	14	3	0	8124	4031	2351	5093	1975	589
14539	Internet	201211	12	0	0	0	5	5	0	0	8136	4035	2351	5105	1979	589
14539	Internet	201212	21	5	0	0	12	12	5	0	8157	4039	2356	5126	1983	594
14539	Internet	201301	16	0	0	0	11	11	0	0	8173	4048	2356	5142	1992	594
14539	Internet	201302	9	0	0	0	8	8	0	0	8182	4053	2356	5151	1997	594
14539	Internet	201303	26	0	0	0	11	11	0	0	8208	4059	2356	5177	2003	594
14539	Internet	201304	5	0	0	0	5	5	0	0	8213	4064	2356	5182	2008	594
14539	Internet	201305	11	0	0	0	9	9	0	0	8224	4070	2356	5193	2014	594
14539	Internet	201306	9	0	0	0	6	6	0	0	8233	4073	2356	5202	2017	594
14539	Internet	201307	22	1	0	0	9	9	1	0	8255	4078	2357	5224	2022	595
14539	Internet	201308	6	0	0	0	5	5	0	0	8261	4082	2357	5230	2026	595
14539	Internet	201309	4	0	0	0	2	2	0	0	8265	4084	2357	5234	2028	595
14539	Internet	201310	4	0	0	0	3	3	0	0	8269	4086	2357	5238	2030	595
14539	Internet	201311	2	0	0	0	2	2	0	0	8271	4087	2357	5240	2031	595
14539	Internet	201312	6	1	0	0	5	5	1	0	8277	4089	2358	5246	2033	596
14539	Internet	201401	7	0	0	0	5	5	0	0	8284	4092	2358	5253	2036	596
14539	Internet	201402	14	1	0	0	10	10	1	0	8298	4097	2359	5267	2041	597
14539	Internet	201403	6	1	0	0	6	6	1	0	8304	4103	2360	5273	2047	598
14539	Internet	201404	14	5	3	2	11	11	3	2	8318	4112	2365	5287	2056	603
14539	Internet	201405	15	1	0	0	7	7	1	0	8333	4115	2366	5302	2059	604
14539	Internet	201406	9	0	0	0	6	6	0	0	8342	4118	2366	5311	2062	604
14539	Internet	201407	15	0	0	0	5	5	0	0	8357	4119	2366	5326	2063	604
14539	Internet	201408	31	3	1	0	10	10	3	1	8388	4122	2369	5357	2066	607
14539	Internet	201409	11	0	0	0	7	7	0	0	8399	4126	2369	5368	2070	607
14539	Internet	201410	5	0	0	0	4	4	0	0	8404	4129	2369	5373	2073	607
14539	Internet	201411	5	1	0	0	4	4	1	0	8409	4132	2370	5378	2076	608
14539	Internet	201412	11	1	0	0	7	7	1	0	8420	4136	2371	5389	2080	609
14539	Internet	201501	15	1	0	0	8	8	1	0	8435	4144	2372	5404	2088	610
14539	Internet	201502	29	1	0	0	10	10	1	0	8464	4152	2373	5433	2096	611
14539	Internet	201503	42	3	0	0	13	13	1	0	8506	4159	2376	5475	2103	614
14539	Internet	201504	15	0	0	0	12	12	0	0	8521	4165	2376	5490	2109	614
14539	Internet	201505	8	2	0	0	6	6	2	0	8529	4168	2378	5498	2112	616
14539	Internet	201506	16	1	0	0	8	8	1	0	8545	4171	2379	5514	2115	617
14539	Internet	201507	23	1	0	0	11	11	1	0	8568	4176	2380	5537	2120	618
14539	Internet	201508	23	1	0	0	9	9	1	0	8591	4179	2381	5560	2123	619
14539	Internet	201509	42	3	0	0	12	12	2	0	8633	4183	2384	5602	2127	622
14539	Internet	201510	13	1	0	0	10	10	1	0	8646	4188	2385	5615	2132	623
14539	Internet	201511	12	0	0	0	5	5	0	0	8658	4191	2385	5627	2135	623
14539	Internet	201512	28	2	0	0	7	7	2	0	8686	4193	2387	5655	2137	625
14539	Internet	201601	14	2	0	0	8	8	2	0	8700	4199	2389	5669	2143	627
14539	Internet	201602	6	0	0	0	5	5	0	0	8706	4201	2389	5675	2145	627
14539	Internet	201603	10	0	0	0	4	4	0	0	8716	4205	2389	5685	2149	627
14539	Internet	201604	3	0	0	0	3	3	0	0	8719	4207	2389	5688	2151	627
14539	Internet	201605	26	1	0	0	4	4	1	0	8745	4209	2390	5714	2153	628
14539	Internet	201606	12	1	0	0	8	8	1	0	8757	4214	2391	5726	2158	629
14539	Internet	201607	11	0	0	0	7	7	0	0	8768	4218	2391	5737	2162	629
14539	Internet	201608	5	0	0	0	3	3	0	0	8773	4220	2391	5742	2164	629
14539	Internet	201609	24	0	0	0	6	6	0	0	8797	4223	2391	5766	2167	629
14539	Internet	201610	16	1	0	0	6	6	1	0	8813	4225	2392	5782	2169	630
14539	Internet	201611	17	3	0	0	6	6	3	0	8830	4227	2395	5799	2171	633
14539	Internet	201612	4	0	0	0	3	3	0	0	8834	4228	2395	5803	2172	633
14539	Internet	201701	20	1	0	0	8	8	1	0	8854	4233	2396	5823	2177	634
14539	Internet	201702	8	0	0	0	5	5	0	0	8862	4233	2396	5831	2177	634
14539	Internet	201703	3	0	0	0	3	3	0	0	8865	4235	2396	5834	2179	634
14539	Internet	201704	5	0	0	0	5	5	0	0	8870	4238	2396	5839	2182	634
14539	Internet	201705	5	1	0	0	5	5	1	0	8875	4243	2397	5844	2187	635
14539	Internet	201706	11	1	0	0	10	10	1	0	8886	4250	2398	5855	2194	636
14539	Internet	201707	12	0	0	0	8	8	0	0	8898	4255	2398	5867	2199	636
14539	Internet	201708	12	1	0	0	7	7	1	0	8910	4259	2399	5879	2203	637
14539	Internet	201709	12	1	0	0	11	11	1	0	8922	4265	2400	5891	2209	638
14539	Internet	201710	14	0	0	0	6	6	0	0	8936	4268	2400	5905	2212	638
14539	Internet	201711	4	1	0	0	4	4	1	0	8940	4272	2401	5909	2216	639
14539	Internet	201712	3	0	0	0	2	2	0	0	8943	4272	2401	5912	2216	639
14539	Internet	201801	5	2	0	0	4	4	2	0	8948	4273	2403	5917	2217	641
14539	Internet	201803	4	0	0	0	4	4	0	0	8952	4277	2403	5921	2221	641
14539	Internet	201804	11	0	0	0	5	5	0	0	8963	4279	2403	5932	2223	641
14539	Internet	201805	7	0	0	0	7	7	0	0	8970	4283	2403	5939	2227	641
14539	Internet	201806	5	0	0	0	5	5	0	0	8975	4287	2403	5944	2231	641
14539	Internet	201807	4	0	0	0	4	4	0	0	8979	4289	2403	5948	2233	641
15285	Internet_Engineering_Task_Force	200111	1	0	0	0	1	1	0	0	1	1	0	1	1	0
15285	Internet_Engineering_Task_Force	200202	5	0	0	0	3	3	0	0	6	4	0	6	4	0
15285	Internet_Engineering_Task_Force	200212	1	0	0	0	1	1	0	0	7	5	0	7	5	0
15285	Internet_Engineering_Task_Force	200301	1	0	0	0	1	1	0	0	8	6	0	8	6	0
15285	Internet_Engineering_Task_Force	200303	1	0	0	0	1	1	0	0	9	7	0	9	7	0
15285	Internet_Engineering_Task_Force	200308	1	0	0	0	1	1	0	0	10	8	0	10	8	0
15285	Internet_Engineering_Task_Force	200310	3	0	0	0	2	2	0	0	13	10	0	13	10	0
15285	Internet_Engineering_Task_Force	200312	1	0	0	0	1	0	0	0	14	11	0	13	10	0
15285	Internet_Engineering_Task_Force	200402	1	0	0	0	1	1	0	0	15	12	0	14	11	0
15285	Internet_Engineering_Task_Force	200403	2	0	0	0	2	2	0	0	17	14	0	16	13	0
15285	Internet_Engineering_Task_Force	200404	2	0	0	0	1	1	0	0	19	15	0	18	14	0
15285	Internet_Engineering_Task_Force	200406	1	0	0	0	1	0	0	0	20	16	0	18	14	0
15285	Internet_Engineering_Task_Force	200407	1	0	0	0	1	1	0	0	21	17	0	19	15	0
15285	Internet_Engineering_Task_Force	200409	8	0	0	0	6	4	0	0	29	23	0	25	19	0
15285	Internet_Engineering_Task_Force	200410	2	0	0	0	2	2	0	0	31	25	0	27	21	0
15285	Internet_Engineering_Task_Force	200411	5	0	0	0	4	2	0	0	36	28	0	30	22	0
15285	Internet_Engineering_Task_Force	200412	1	0	0	0	1	1	0	0	37	29	0	31	23	0
15285	Internet_Engineering_Task_Force	200501	3	1	0	0	3	3	1	0	40	31	1	34	25	1
15285	Internet_Engineering_Task_Force	200502	1	0	0	0	1	1	0	0	41	31	1	35	25	1
15285	Internet_Engineering_Task_Force	200503	1	0	0	0	1	1	0	0	42	32	1	36	26	1
15285	Internet_Engineering_Task_Force	200504	4	0	0	0	2	1	0	0	46	34	1	38	27	1
15285	Internet_Engineering_Task_Force	200507	5	1	0	0	4	2	1	0	51	37	2	41	28	1
15285	Internet_Engineering_Task_Force	200508	5	0	0	0	4	1	0	0	56	41	2	42	29	1
15285	Internet_Engineering_Task_Force	200509	2	0	0	0	1	1	0	0	58	42	2	44	30	1
15285	Internet_Engineering_Task_Force	200510	5	0	0	0	5	4	0	0	63	45	2	48	32	1
15285	Internet_Engineering_Task_Force	200511	3	0	0	0	3	3	0	0	66	48	2	51	35	1
15285	Internet_Engineering_Task_Force	200512	5	0	0	0	4	3	0	0	71	52	2	55	38	1
15285	Internet_Engineering_Task_Force	200601	3	0	0	0	3	2	0	0	74	53	2	57	38	1
15285	Internet_Engineering_Task_Force	200602	5	0	0	0	2	1	0	0	79	54	2	61	38	1
15285	Internet_Engineering_Task_Force	200603	8	2	0	0	3	1	1	0	87	56	4	63	38	1
15285	Internet_Engineering_Task_Force	200604	3	0	0	0	3	3	0	0	90	58	4	66	40	1
15285	Internet_Engineering_Task_Force	200605	2	0	0	0	2	1	0	0	92	60	4	67	41	1
15285	Internet_Engineering_Task_Force	200606	2	0	0	0	2	2	0	0	94	61	4	69	42	1
15285	Internet_Engineering_Task_Force	200607	2	0	0	0	2	2	0	0	96	61	4	71	42	1
15285	Internet_Engineering_Task_Force	200609	2	0	0	0	1	1	0	0	98	62	4	73	43	1
15285	Internet_Engineering_Task_Force	200610	3	0	0	0	3	1	0	0	101	65	4	74	44	1
15285	Internet_Engineering_Task_Force	200611	3	1	0	0	3	2	1	0	104	67	5	76	45	1
15285	Internet_Engineering_Task_Force	200612	4	0	0	0	3	0	0	0	108	70	5	76	45	1
15285	Internet_Engineering_Task_Force	200702	3	0	0	0	2	2	0	0	111	71	5	79	46	1
15285	Internet_Engineering_Task_Force	200703	5	0	0	0	5	2	0	0	116	75	5	81	47	1
15285	Internet_Engineering_Task_Force	200704	3	0	0	0	2	2	0	0	119	77	5	84	49	1
15285	Internet_Engineering_Task_Force	200705	7	1	0	0	5	2	1	0	126	81	6	87	50	1
15285	Internet_Engineering_Task_Force	200706	6	0	0	0	4	2	0	0	132	84	6	91	51	1
15285	Internet_Engineering_Task_Force	200707	5	1	0	0	5	4	1	0	137	88	7	95	54	2
15285	Internet_Engineering_Task_Force	200708	5	0	0	0	4	4	0	0	142	91	7	100	57	2
15285	Internet_Engineering_Task_Force	200709	1	0	0	0	1	0	0	0	143	92	7	100	57	2
15285	Internet_Engineering_Task_Force	200711	3	1	0	0	3	2	1	0	146	95	8	102	59	3
15285	Internet_Engineering_Task_Force	200712	3	0	0	0	3	3	0	0	149	98	8	105	62	3
15285	Internet_Engineering_Task_Force	200801	18	1	0	0	8	5	1	0	167	104	9	120	65	4
15285	Internet_Engineering_Task_Force	200802	4	0	0	0	4	3	0	0	171	107	9	123	67	4
15285	Internet_Engineering_Task_Force	200803	4	1	0	0	4	2	1	0	175	110	10	125	68	4
15285	Internet_Engineering_Task_Force	200804	6	1	0	0	3	2	1	0	181	112	11	130	69	4
15285	Internet_Engineering_Task_Force	200805	5	0	0	0	2	1	0	0	186	113	11	134	69	4
15285	Internet_Engineering_Task_Force	200806	5	0	0	0	5	4	0	0	191	116	11	138	71	4
15285	Internet_Engineering_Task_Force	200807	4	0	0	0	3	2	0	0	195	117	11	140	71	4
15285	Internet_Engineering_Task_Force	200808	2	0	0	0	2	2	0	0	197	119	11	142	73	4
15285	Internet_Engineering_Task_Force	200810	11	0	0	0	3	2	0	0	208	121	11	144	74	4
15285	Internet_Engineering_Task_Force	200811	2	1	0	0	2	1	1	0	210	122	12	145	74	4
15285	Internet_Engineering_Task_Force	200812	4	1	0	0	4	4	1	0	214	125	13	149	77	5
15285	Internet_Engineering_Task_Force	200901	3	0	0	0	1	1	0	0	217	126	13	152	78	5
15285	Internet_Engineering_Task_Force	200902	1	0	0	0	1	1	0	0	218	127	13	153	79	5
15285	Internet_Engineering_Task_Force	200903	6	1	0	0	4	3	1	0	224	129	14	158	80	5
15285	Internet_Engineering_Task_Force	200906	2	0	0	0	2	2	0	0	226	130	14	160	81	5
15285	Internet_Engineering_Task_Force	200908	2	0	0	0	2	2	0	0	228	131	14	162	82	5
15285	Internet_Engineering_Task_Force	200909	2	0	0	0	2	0	0	0	230	133	14	162	82	5
15285	Internet_Engineering_Task_Force	200910	2	0	0	0	2	2	0	0	232	134	14	164	83	5
15285	Internet_Engineering_Task_Force	200911	1	0	0	0	1	1	0	0	233	135	14	165	84	5
15285	Internet_Engineering_Task_Force	200912	2	0	0	0	2	2	0	0	235	137	14	167	86	5
15285	Internet_Engineering_Task_Force	201001	2	0	0	0	2	2	0	0	237	139	14	169	88	5
15285	Internet_Engineering_Task_Force	201002	7	1	0	0	4	2	1	0	244	143	15	171	90	5
15285	Internet_Engineering_Task_Force	201003	2	0	0	0	2	2	0	0	246	145	15	173	92	5
15285	Internet_Engineering_Task_Force	201004	1	0	0	0	1	1	0	0	247	146	15	174	93	5
15285	Internet_Engineering_Task_Force	201005	3	0	0	0	3	2	0	0	250	149	15	176	95	5
15285	Internet_Engineering_Task_Force	201006	1	0	0	0	1	1	0	0	251	149	15	177	95	5
15285	Internet_Engineering_Task_Force	201007	1	0	0	0	1	1	0	0	252	150	15	178	96	5
15285	Internet_Engineering_Task_Force	201009	4	2	0	0	3	2	2	0	256	152	17	180	97	6
15285	Internet_Engineering_Task_Force	201010	5	0	0	0	3	3	0	0	261	155	17	185	100	6
15285	Internet_Engineering_Task_Force	201101	6	3	0	0	5	3	3	0	267	160	20	188	103	6
15285	Internet_Engineering_Task_Force	201102	7	1	0	0	7	6	1	0	274	166	21	194	108	6
15285	Internet_Engineering_Task_Force	201103	1	0	0	0	1	1	0	0	275	167	21	195	109	6
15285	Internet_Engineering_Task_Force	201104	3	1	0	0	3	2	1	0	278	170	22	197	111	6
15285	Internet_Engineering_Task_Force	201105	1	0	0	0	1	1	0	0	279	171	22	198	112	6
15285	Internet_Engineering_Task_Force	201106	2	0	0	0	2	2	0	0	281	173	22	200	114	6
15285	Internet_Engineering_Task_Force	201109	1	0	0	0	1	1	0	0	282	174	22	201	115	6
15285	Internet_Engineering_Task_Force	201110	5	1	0	0	5	4	1	0	287	179	23	205	119	6
15285	Internet_Engineering_Task_Force	201111	1	0	0	0	1	1	0	0	288	180	23	206	120	6
15285	Internet_Engineering_Task_Force	201201	1	0	0	0	1	1	0	0	289	181	23	207	121	6
15285	Internet_Engineering_Task_Force	201202	2	0	0	0	1	1	0	0	291	181	23	209	121	6
15285	Internet_Engineering_Task_Force	201203	4	0	0	0	4	3	0	0	295	183	23	212	122	6
15285	Internet_Engineering_Task_Force	201204	2	1	0	0	2	1	1	0	297	184	24	213	122	6
15285	Internet_Engineering_Task_Force	201205	2	0	0	0	2	0	0	0	299	186	24	213	122	6
15285	Internet_Engineering_Task_Force	201206	1	0	0	0	1	1	0	0	300	187	24	214	123	6
15285	Internet_Engineering_Task_Force	201208	4	0	0	0	4	3	0	0	304	191	24	217	126	6
15285	Internet_Engineering_Task_Force	201209	2	0	0	0	1	0	0	0	306	192	24	217	126	6
15285	Internet_Engineering_Task_Force	201210	10	4	0	0	2	2	1	0	316	193	28	227	127	10
15285	Internet_Engineering_Task_Force	201211	11	5	1	0	6	5	3	1	327	196	33	237	129	14
15285	Internet_Engineering_Task_Force	201212	1	0	0	0	1	1	0	0	328	197	33	238	130	14
15285	Internet_Engineering_Task_Force	201301	4	0	0	0	3	2	0	0	332	199	33	241	131	14
15285	Internet_Engineering_Task_Force	201302	6	0	0	0	6	5	0	0	338	204	33	246	135	14
15285	Internet_Engineering_Task_Force	201303	4	1	0	0	4	3	1	0	342	207	34	249	137	14
15285	Internet_Engineering_Task_Force	201304	1	0	0	0	1	1	0	0	343	208	34	250	138	14
15285	Internet_Engineering_Task_Force	201305	3	0	0	0	2	1	0	0	346	210	34	251	139	14
15285	Internet_Engineering_Task_Force	201306	3	0	0	0	2	1	0	0	349	212	34	253	140	14
15285	Internet_Engineering_Task_Force	201308	1	0	0	0	1	0	0	0	350	213	34	253	140	14
15285	Internet_Engineering_Task_Force	201309	6	1	0	0	5	4	1	0	356	217	35	257	143	15
15285	Internet_Engineering_Task_Force	201310	14	1	0	0	8	6	1	0	370	223	36	263	147	16
15285	Internet_Engineering_Task_Force	201311	2	0	0	0	2	1	0	0	372	225	36	264	148	16
15285	Internet_Engineering_Task_Force	201401	2	1	0	0	2	1	1	0	374	227	37	265	149	16
15285	Internet_Engineering_Task_Force	201402	4	1	0	0	3	2	1	0	378	229	38	267	150	16
15285	Internet_Engineering_Task_Force	201403	3	0	0	0	3	3	0	0	381	232	38	270	153	16
15285	Internet_Engineering_Task_Force	201404	1	0	0	0	1	1	0	0	382	233	38	271	154	16
15285	Internet_Engineering_Task_Force	201406	1	0	0	0	1	1	0	0	383	234	38	272	155	16
15285	Internet_Engineering_Task_Force	201407	1	0	0	0	1	1	0	0	384	235	38	273	156	16
15285	Internet_Engineering_Task_Force	201412	15	2	0	0	8	6	1	0	399	238	40	286	157	16
15285	Internet_Engineering_Task_Force	201501	1	0	0	0	1	0	0	0	400	239	40	286	157	16
15285	Internet_Engineering_Task_Force	201504	5	1	0	0	3	2	1	0	405	241	41	290	158	16
15285	Internet_Engineering_Task_Force	201505	3	0	0	0	2	2	0	0	408	243	41	293	160	16
15285	Internet_Engineering_Task_Force	201507	1	0	0	0	1	1	0	0	409	244	41	294	161	16
15285	Internet_Engineering_Task_Force	201508	6	1	0	0	4	2	1	0	415	247	42	297	162	16
15285	Internet_Engineering_Task_Force	201509	1	0	0	0	1	0	0	0	416	248	42	297	162	16
15285	Internet_Engineering_Task_Force	201510	2	1	0	0	2	0	1	0	418	250	43	297	162	16
15285	Internet_Engineering_Task_Force	201601	1	0	0	0	1	1	0	0	419	251	43	298	163	16
15285	Internet_Engineering_Task_Force	201605	2	0	0	0	2	2	0	0	421	253	43	300	165	16
15285	Internet_Engineering_Task_Force	201606	4	1	0	0	4	3	1	0	425	256	44	303	167	16
15285	Internet_Engineering_Task_Force	201610	2	1	0	0	2	1	1	0	427	258	45	304	168	16
15285	Internet_Engineering_Task_Force	201611	3	1	0	0	2	1	1	0	430	260	46	305	169	16
15285	Internet_Engineering_Task_Force	201704	6	3	0	0	6	5	3	0	436	265	49	310	173	18
15285	Internet_Engineering_Task_Force	201705	3	1	0	0	3	3	1	0	439	268	50	313	175	19
15285	Internet_Engineering_Task_Force	201706	3	1	0	0	3	2	1	0	442	270	51	315	175	19
15285	Internet_Engineering_Task_Force	201707	3	0	0	0	2	1	0	0	445	272	51	316	176	19
15285	Internet_Engineering_Task_Force	201710	4	2	0	0	4	3	2	0	449	276	53	319	179	20
15285	Internet_Engineering_Task_Force	201711	4	0	0	0	3	3	0	0	453	279	53	323	182	20
15285	Internet_Engineering_Task_Force	201801	2	1	0	0	2	2	1	0	455	280	54	325	182	21
15285	Internet_Engineering_Task_Force	201802	6	0	0	0	5	4	0	0	461	285	54	330	186	21
15285	Internet_Engineering_Task_Force	201803	2	1	0	0	2	2	1	0	463	286	55	332	186	22
15285	Internet_Engineering_Task_Force	201804	3	1	0	0	3	1	1	0	466	289	56	333	187	22
15285	Internet_Engineering_Task_Force	201805	3	1	0	0	3	2	1	0	469	291	57	335	188	23
15285	Internet_Engineering_Task_Force	201806	2	0	0	0	2	1	0	0	471	293	57	336	189	23
15285	Internet_Engineering_Task_Force	201807	4	0	0	0	2	2	0	0	475	295	57	340	191	23
194340	Internet_Key_Exchange	200305	1	0	0	0	1	1	0	0	1	1	0	1	1	0
194340	Internet_Key_Exchange	200309	5	0	0	0	4	1	0	0	6	5	0	2	2	0
194340	Internet_Key_Exchange	200403	2	0	0	0	1	1	0	0	8	6	0	4	3	0
194340	Internet_Key_Exchange	200404	3	0	0	0	2	1	0	0	11	8	0	5	4	0
194340	Internet_Key_Exchange	200405	1	0	0	0	1	1	0	0	12	9	0	6	5	0
194340	Internet_Key_Exchange	200406	1	0	0	0	1	1	0	0	13	9	0	7	5	0
194340	Internet_Key_Exchange	200407	2	0	0	0	1	1	0	0	15	9	0	9	5	0
194340	Internet_Key_Exchange	200409	1	0	0	0	1	1	0	0	16	10	0	10	6	0
194340	Internet_Key_Exchange	200411	3	0	0	0	2	1	0	0	19	11	0	12	6	0
194340	Internet_Key_Exchange	200501	2	0	0	0	2	1	0	0	21	12	0	13	6	0
194340	Internet_Key_Exchange	200502	2	0	0	0	1	0	0	0	23	13	0	13	6	0
194340	Internet_Key_Exchange	200504	1	0	0	0	1	0	0	0	24	14	0	13	6	0
194340	Internet_Key_Exchange	200509	1	0	0	0	1	0	0	0	25	15	0	13	6	0
194340	Internet_Key_Exchange	200601	1	0	0	0	1	1	0	0	26	16	0	14	7	0
194340	Internet_Key_Exchange	200602	1	0	0	0	1	0	0	0	27	17	0	14	7	0
194340	Internet_Key_Exchange	200603	1	0	0	0	1	1	0	0	28	18	0	15	8	0
194340	Internet_Key_Exchange	200604	1	0	0	0	1	1	0	0	29	19	0	16	9	0
194340	Internet_Key_Exchange	200605	2	0	0	0	2	1	0	0	31	21	0	17	10	0
194340	Internet_Key_Exchange	200606	6	0	0	0	3	2	0	0	37	24	0	19	12	0
194340	Internet_Key_Exchange	200607	5	1	0	0	4	0	1	0	42	28	1	19	12	0
194340	Internet_Key_Exchange	200608	1	0	0	0	1	1	0	0	43	28	1	20	12	0
194340	Internet_Key_Exchange	200609	2	0	0	0	2	1	0	0	45	30	1	21	13	0
194340	Internet_Key_Exchange	200610	5	0	0	0	3	3	0	0	50	33	1	26	16	0
194340	Internet_Key_Exchange	200611	2	0	0	0	2	1	0	0	52	35	1	27	17	0
194340	Internet_Key_Exchange	200612	3	0	0	0	2	1	0	0	55	37	1	28	18	0
194340	Internet_Key_Exchange	200701	1	0	0	0	1	1	0	0	56	38	1	29	19	0
194340	Internet_Key_Exchange	200705	3	0	0	0	3	2	0	0	59	40	1	31	20	0
194340	Internet_Key_Exchange	200707	1	0	0	0	1	1	0	0	60	41	1	32	21	0
194340	Internet_Key_Exchange	200708	1	0	0	0	1	1	0	0	61	42	1	33	22	0
194340	Internet_Key_Exchange	200710	7	0	0	0	4	3	0	0	68	46	1	38	25	0
194340	Internet_Key_Exchange	200711	1	0	0	0	1	1	0	0	69	47	1	39	26	0
194340	Internet_Key_Exchange	200712	3	1	0	0	3	1	1	0	72	50	2	40	27	0
194340	Internet_Key_Exchange	200802	2	0	0	0	1	0	0	0	74	51	2	40	27	0
194340	Internet_Key_Exchange	200804	3	2	0	0	2	1	2	0	77	53	4	41	28	0
194340	Internet_Key_Exchange	200805	2	0	0	0	2	1	0	0	79	55	4	42	29	0
194340	Internet_Key_Exchange	200808	1	1	0	0	1	1	1	0	80	56	5	43	30	0
194340	Internet_Key_Exchange	200809	1	0	0	0	1	0	0	0	81	57	5	43	30	0
194340	Internet_Key_Exchange	200810	5	1	0	0	5	3	1	0	86	61	6	46	32	0
194340	Internet_Key_Exchange	200811	2	0	0	0	1	1	0	0	88	62	6	48	33	0
194340	Internet_Key_Exchange	200901	4	1	0	0	4	1	1	0	92	65	7	49	33	0
194340	Internet_Key_Exchange	200902	1	0	0	0	1	1	0	0	93	66	7	50	34	0
194340	Internet_Key_Exchange	200903	2	0	0	0	2	2	0	0	95	67	7	52	35	0
194340	Internet_Key_Exchange	200904	5	1	0	0	5	3	1	0	100	72	8	55	38	0
194340	Internet_Key_Exchange	200905	1	0	0	0	1	0	0	0	101	73	8	55	38	0
194340	Internet_Key_Exchange	200906	1	0	0	0	1	0	0	0	102	74	8	55	38	0
194340	Internet_Key_Exchange	200907	1	0	0	0	1	1	0	0	103	75	8	56	39	0
194340	Internet_Key_Exchange	200909	2	0	0	0	2	2	0	0	105	76	8	58	40	0
194340	Internet_Key_Exchange	200910	7	0	0	0	2	1	0	0	112	78	8	64	41	0
194340	Internet_Key_Exchange	200911	3	0	0	0	3	2	0	0	115	80	8	66	42	0
194340	Internet_Key_Exchange	200912	4	0	0	0	4	3	0	0	119	83	8	69	44	0
194340	Internet_Key_Exchange	201001	4	0	0	0	4	1	0	0	123	87	8	70	45	0
194340	Internet_Key_Exchange	201004	1	0	0	0	1	0	0	0	124	88	8	70	45	0
194340	Internet_Key_Exchange	201005	2	0	0	0	2	2	0	0	126	88	8	72	45	0
194340	Internet_Key_Exchange	201008	1	0	0	0	1	0	0	0	127	89	8	72	45	0
194340	Internet_Key_Exchange	201009	1	0	0	0	1	0	0	0	128	90	8	72	45	0
194340	Internet_Key_Exchange	201010	5	0	0	0	4	1	0	0	133	93	8	73	45	0
194340	Internet_Key_Exchange	201011	3	0	0	0	2	2	0	0	136	94	8	76	46	0
194340	Internet_Key_Exchange	201012	2	1	0	0	2	1	1	0	138	96	9	77	47	0
194340	Internet_Key_Exchange	201101	1	0	0	0	1	1	0	0	139	97	9	78	48	0
194340	Internet_Key_Exchange	201105	2	0	0	0	2	2	0	0	141	97	9	80	48	0
194340	Internet_Key_Exchange	201106	2	0	0	0	2	1	0	0	143	99	9	81	49	0
194340	Internet_Key_Exchange	201108	1	0	0	0	1	1	0	0	144	100	9	82	50	0
194340	Internet_Key_Exchange	201109	2	0	0	0	2	1	0	0	146	101	9	83	50	0
194340	Internet_Key_Exchange	201110	2	0	0	0	2	2	0	0	148	103	9	85	52	0
194340	Internet_Key_Exchange	201111	1	0	0	0	1	0	0	0	149	104	9	85	52	0
194340	Internet_Key_Exchange	201202	1	0	0	0	1	0	0	0	150	105	9	85	52	0
194340	Internet_Key_Exchange	201203	2	0	0	0	1	0	0	0	152	106	9	85	52	0
194340	Internet_Key_Exchange	201206	2	0	0	0	2	2	0	0	154	108	9	87	54	0
194340	Internet_Key_Exchange	201210	1	0	0	0	1	1	0	0	155	109	9	88	55	0
194340	Internet_Key_Exchange	201211	1	0	0	0	1	0	0	0	156	110	9	88	55	0
194340	Internet_Key_Exchange	201301	1	0	0	0	1	0	0	0	157	110	9	88	55	0
194340	Internet_Key_Exchange	201302	1	0	0	0	1	0	0	0	158	111	9	88	55	0
194340	Internet_Key_Exchange	201303	1	0	0	0	1	1	0	0	159	112	9	89	56	0
194340	Internet_Key_Exchange	201304	2	0	0	0	2	0	0	0	161	114	9	89	56	0
194340	Internet_Key_Exchange	201307	3	0	0	0	3	0	0	0	164	117	9	89	56	0
194340	Internet_Key_Exchange	201310	1	0	0	0	1	1	0	0	165	118	9	90	57	0
194340	Internet_Key_Exchange	201402	1	0	0	0	1	0	0	0	166	119	9	90	57	0
194340	Internet_Key_Exchange	201403	1	0	0	0	1	1	0	0	167	120	9	91	58	0
194340	Internet_Key_Exchange	201405	1	0	0	0	1	0	0	0	168	121	9	91	58	0
194340	Internet_Key_Exchange	201406	1	0	0	0	1	0	0	0	169	122	9	91	58	0
194340	Internet_Key_Exchange	201407	2	0	0	0	2	1	0	0	171	123	9	92	58	0
194340	Internet_Key_Exchange	201408	1	0	0	0	1	1	0	0	172	124	9	93	59	0
194340	Internet_Key_Exchange	201410	1	0	0	0	1	0	0	0	173	125	9	93	59	0
194340	Internet_Key_Exchange	201412	1	0	0	0	1	1	0	0	174	125	9	94	59	0
194340	Internet_Key_Exchange	201501	2	0	0	0	2	1	0	0	176	127	9	95	60	0
194340	Internet_Key_Exchange	201504	1	0	0	0	1	0	0	0	177	128	9	95	60	0
194340	Internet_Key_Exchange	201505	1	0	0	0	1	1	0	0	178	129	9	96	61	0
194340	Internet_Key_Exchange	201506	2	0	0	0	2	2	0	0	180	130	9	98	62	0
194340	Internet_Key_Exchange	201509	3	0	0	0	3	3	0	0	183	133	9	101	65	0
194340	Internet_Key_Exchange	201510	2	0	0	0	1	0	0	0	185	134	9	101	65	0
194340	Internet_Key_Exchange	201511	1	0	0	0	1	1	0	0	186	135	9	102	66	0
194340	Internet_Key_Exchange	201512	2	0	0	0	1	0	0	0	188	136	9	102	66	0
194340	Internet_Key_Exchange	201603	2	1	0	0	2	1	1	0	190	137	10	103	66	0
194340	Internet_Key_Exchange	201605	2	0	0	0	2	1	0	0	192	139	10	104	67	0
194340	Internet_Key_Exchange	201606	2	0	0	0	1	0	0	0	194	140	10	104	67	0
194340	Internet_Key_Exchange	201609	2	0	0	0	1	1	0	0	196	141	10	106	68	0
194340	Internet_Key_Exchange	201610	4	0	0	0	3	1	0	0	200	144	10	107	69	0
194340	Internet_Key_Exchange	201611	2	0	0	0	1	0	0	0	202	145	10	107	69	0
194340	Internet_Key_Exchange	201612	1	0	0	0	1	1	0	0	203	146	10	108	70	0
194340	Internet_Key_Exchange	201703	2	0	0	0	2	1	0	0	205	148	10	109	71	0
194340	Internet_Key_Exchange	201706	2	1	0	0	2	1	1	0	207	149	11	110	71	0
194340	Internet_Key_Exchange	201708	1	0	0	0	1	1	0	0	208	150	11	111	71	0
194340	Internet_Key_Exchange	201709	2	0	0	0	2	2	0	0	210	152	11	113	73	0
194340	Internet_Key_Exchange	201801	3	0	0	0	2	2	0	0	213	154	11	116	75	0
194340	Internet_Key_Exchange	201802	2	0	0	0	2	0	0	0	215	156	11	116	75	0
194340	Internet_Key_Exchange	201804	1	0	0	0	1	1	0	0	216	157	11	117	76	0
194340	Internet_Key_Exchange	201806	1	0	0	0	1	0	0	0	217	158	11	117	76	0
194340	Internet_Key_Exchange	201807	5	0	0	0	3	2	0	0	222	159	11	120	77	0
15323	Internet_Protocol	200112	1	0	0	0	1	1	0	0	1	1	0	1	1	0
15323	Internet_Protocol	200202	2	0	0	0	2	2	0	0	3	3	0	3	3	0
15323	Internet_Protocol	200204	3	0	0	0	2	1	0	0	6	5	0	4	4	0
15323	Internet_Protocol	200210	1	0	0	0	1	0	0	0	7	6	0	4	4	0
15323	Internet_Protocol	200212	4	0	0	0	2	2	0	0	11	8	0	8	6	0
15323	Internet_Protocol	200301	1	0	0	0	1	1	0	0	12	9	0	9	7	0
15323	Internet_Protocol	200302	2	0	0	0	2	1	0	0	14	11	0	10	8	0
15323	Internet_Protocol	200303	4	0	0	0	3	1	0	0	18	14	0	11	9	0
15323	Internet_Protocol	200304	1	0	0	0	1	1	0	0	19	15	0	12	10	0
15323	Internet_Protocol	200305	1	0	0	0	1	1	0	0	20	16	0	13	11	0
15323	Internet_Protocol	200306	4	0	0	0	3	2	0	0	24	19	0	16	13	0
15323	Internet_Protocol	200307	2	0	0	0	1	0	0	0	26	20	0	16	13	0
15323	Internet_Protocol	200308	1	0	0	0	1	1	0	0	27	21	0	17	14	0
15323	Internet_Protocol	200309	4	0	0	0	2	2	0	0	31	22	0	21	15	0
15323	Internet_Protocol	200312	7	0	0	0	2	2	0	0	38	24	0	28	17	0
15323	Internet_Protocol	200401	7	0	0	0	4	3	0	0	45	27	0	34	19	0
15323	Internet_Protocol	200402	2	0	0	0	2	2	0	0	47	29	0	36	21	0
15323	Internet_Protocol	200403	4	0	0	0	4	3	0	0	51	33	0	39	24	0
15323	Internet_Protocol	200404	5	1	0	0	5	3	1	0	56	38	1	42	27	0
15323	Internet_Protocol	200405	3	0	0	0	3	2	0	0	59	41	1	44	29	0
15323	Internet_Protocol	200406	10	1	0	0	6	4	1	0	69	47	2	52	33	0
15323	Internet_Protocol	200407	8	0	0	0	7	7	0	0	77	51	2	60	36	0
15323	Internet_Protocol	200408	4	0	0	0	4	3	0	0	81	55	2	63	39	0
15323	Internet_Protocol	200409	4	0	0	0	3	2	0	0	85	58	2	66	41	0
15323	Internet_Protocol	200410	1	0	0	0	1	0	0	0	86	59	2	66	41	0
15323	Internet_Protocol	200411	7	1	0	0	4	3	1	0	93	62	3	72	43	0
15323	Internet_Protocol	200501	4	0	0	0	4	0	0	0	97	66	3	72	43	0
15323	Internet_Protocol	200502	1	0	0	0	1	1	0	0	98	67	3	73	44	0
15323	Internet_Protocol	200503	4	2	0	0	4	2	2	0	102	71	5	75	46	0
15323	Internet_Protocol	200504	1	0	0	0	1	0	0	0	103	72	5	75	46	0
15323	Internet_Protocol	200505	9	1	0	0	7	3	1	0	112	77	6	79	48	0
15323	Internet_Protocol	200506	3	0	0	0	3	3	0	0	115	80	6	82	51	0
15323	Internet_Protocol	200507	9	1	0	0	6	3	1	0	124	86	7	85	54	0
15323	Internet_Protocol	200508	11	1	0	0	9	4	1	0	135	95	8	90	58	0
15323	Internet_Protocol	200509	7	0	0	0	5	1	0	0	142	100	8	92	59	0
15323	Internet_Protocol	200510	6	2	0	0	5	3	2	0	148	105	10	96	62	0
15323	Internet_Protocol	200511	9	2	0	0	5	3	2	0	157	109	12	100	64	0
15323	Internet_Protocol	200512	17	6	0	0	10	5	4	0	174	118	18	107	68	0
15323	Internet_Protocol	200601	3	1	0	0	3	2	1	0	177	121	19	109	70	0
15323	Internet_Protocol	200602	14	3	0	0	11	4	2	0	191	132	22	114	74	0
15323	Internet_Protocol	200603	16	5	0	0	12	7	5	0	207	141	27	122	78	0
15323	Internet_Protocol	200604	13	2	0	0	9	5	2	0	220	150	29	130	83	0
15323	Internet_Protocol	200605	12	4	0	0	12	8	4	0	232	161	33	138	91	2
15323	Internet_Protocol	200606	4	1	0	0	4	2	1	0	236	164	34	140	92	2
15323	Internet_Protocol	200607	14	2	0	0	10	7	2	0	250	173	36	149	98	2
15323	Internet_Protocol	200608	8	1	0	0	7	5	1	0	258	179	37	155	102	2
15323	Internet_Protocol	200609	4	0	0	0	3	2	0	0	262	182	37	158	104	2
15323	Internet_Protocol	200610	10	1	0	0	9	5	1	0	272	189	38	164	107	2
15323	Internet_Protocol	200611	10	2	0	0	6	4	2	0	282	194	40	168	110	3
15323	Internet_Protocol	200612	24	3	0	0	18	7	3	0	306	210	43	178	115	4
15323	Internet_Protocol	200701	21	5	0	0	17	11	3	0	327	226	48	192	125	6
15323	Internet_Protocol	200702	14	1	0	0	11	5	1	0	341	235	49	197	129	6
15323	Internet_Protocol	200703	21	1	0	0	16	11	1	0	362	249	50	212	138	6
15323	Internet_Protocol	200704	16	4	0	0	12	8	4	0	378	259	54	221	145	7
15323	Internet_Protocol	200705	25	7	0	0	19	9	6	0	403	277	61	232	153	7
15323	Internet_Protocol	200706	18	4	0	0	15	7	4	0	421	291	65	240	159	7
15323	Internet_Protocol	200707	8	3	0	0	7	5	2	0	429	297	68	246	163	9
15323	Internet_Protocol	200708	11	0	0	0	8	3	0	0	440	304	68	250	166	9
15323	Internet_Protocol	200709	16	6	0	0	12	4	4	0	456	315	74	257	169	9
15323	Internet_Protocol	200710	12	6	1	0	9	6	5	1	468	323	80	266	174	12
15323	Internet_Protocol	200711	2	0	0	0	2	1	0	0	470	325	80	267	175	12
15323	Internet_Protocol	200712	21	7	0	0	16	10	5	0	491	339	87	280	183	13
15323	Internet_Protocol	200801	12	3	0	0	12	10	3	0	503	348	90	290	190	14
15323	Internet_Protocol	200802	6	1	0	0	6	4	1	0	509	354	91	294	194	14
15323	Internet_Protocol	200803	20	8	0	0	16	11	7	0	529	367	99	309	202	17
15323	Internet_Protocol	200804	19	1	0	0	13	6	1	0	548	378	100	316	206	17
15323	Internet_Protocol	200805	32	8	0	0	19	11	6	0	580	395	108	332	215	19
15323	Internet_Protocol	200806	11	3	0	0	8	3	2	0	591	402	111	337	217	19
15323	Internet_Protocol	200807	32	11	0	0	23	9	7	0	623	422	122	351	223	19
15323	Internet_Protocol	200808	29	8	0	0	17	6	6	0	652	438	130	365	228	20
15323	Internet_Protocol	200809	17	3	0	0	12	9	3	0	669	446	133	379	233	20
15323	Internet_Protocol	200810	15	3	0	0	9	4	3	0	684	455	136	384	237	20
15323	Internet_Protocol	200811	7	4	0	0	6	4	4	0	691	460	140	388	240	21
15323	Internet_Protocol	200812	28	6	0	0	15	7	3	0	719	473	146	405	245	24
15323	Internet_Protocol	200901	20	4	0	0	12	8	4	0	739	482	150	420	250	25
15323	Internet_Protocol	200902	17	6	0	0	15	8	6	0	756	493	156	430	254	26
15323	Internet_Protocol	200903	13	3	0	0	7	3	1	0	769	499	159	437	256	26
15323	Internet_Protocol	200904	22	9	0	0	17	8	8	0	791	513	168	447	261	26
15323	Internet_Protocol	200905	8	4	0	0	8	6	4	0	799	519	172	453	265	28
15323	Internet_Protocol	200906	4	2	0	0	3	1	1	0	803	521	174	455	265	28
15323	Internet_Protocol	200907	10	3	0	0	7	4	2	0	813	527	177	461	268	29
15323	Internet_Protocol	200908	7	1	0	0	5	3	1	0	820	531	178	466	270	29
15323	Internet_Protocol	200909	11	2	0	0	9	5	2	0	831	539	180	472	274	29
15323	Internet_Protocol	200910	9	2	0	0	8	4	2	0	840	544	182	477	275	29
15323	Internet_Protocol	200911	22	6	0	0	15	9	4	0	862	554	188	488	279	30
15323	Internet_Protocol	200912	7	3	0	0	5	4	1	0	869	557	191	494	281	32
15323	Internet_Protocol	201001	15	6	0	0	14	9	6	0	884	567	197	504	286	33
15323	Internet_Protocol	201002	21	8	0	0	17	8	8	0	905	580	205	512	290	33
15323	Internet_Protocol	201003	13	3	0	0	8	4	3	0	918	586	208	516	292	33
15323	Internet_Protocol	201004	5	1	0	0	5	4	1	0	923	590	209	520	295	33
15323	Internet_Protocol	201005	19	5	0	0	10	7	2	0	942	597	214	533	299	33
15323	Internet_Protocol	201006	13	5	0	0	11	6	4	0	955	606	219	540	303	34
15323	Internet_Protocol	201007	2	1	0	0	2	1	1	0	957	607	220	541	303	34
15323	Internet_Protocol	201008	11	1	0	0	8	4	1	0	968	613	221	547	305	34
15323	Internet_Protocol	201009	8	2	0	0	7	4	2	0	976	618	223	552	307	35
15323	Internet_Protocol	201010	25	5	0	0	16	8	5	0	1001	631	228	569	312	35
15323	Internet_Protocol	201011	3	1	0	0	3	2	1	0	1004	634	229	571	314	35
15323	Internet_Protocol	201012	23	9	2	1	18	11	7	2	1027	649	238	584	322	37
15323	Internet_Protocol	201101	7	1	0	0	5	4	1	0	1034	652	239	589	324	38
15323	Internet_Protocol	201102	9	3	0	0	9	6	3	0	1043	659	242	595	328	38
15323	Internet_Protocol	201103	9	3	0	0	9	6	3	0	1052	663	245	601	329	38
15323	Internet_Protocol	201104	7	1	0	0	4	3	1	0	1059	665	246	606	330	38
15323	Internet_Protocol	201105	13	4	0	0	13	10	4	0	1072	674	250	616	336	40
15323	Internet_Protocol	201106	7	2	0	0	6	4	2	0	1079	678	252	620	338	41
15323	Internet_Protocol	201107	15	6	0	0	11	6	6	0	1094	688	258	626	343	41
15323	Internet_Protocol	201108	25	5	0	0	13	8	5	0	1119	696	263	642	346	41
15323	Internet_Protocol	201109	11	5	0	0	9	5	4	0	1130	702	268	648	348	42
15323	Internet_Protocol	201110	7	2	0	0	6	4	2	0	1137	706	270	652	350	42
15323	Internet_Protocol	201111	2	1	0	0	2	1	1	0	1139	707	271	653	350	42
15323	Internet_Protocol	201112	9	4	0	0	8	4	3	0	1148	712	275	658	351	42
15323	Internet_Protocol	201201	9	5	1	0	8	6	5	1	1157	720	280	664	357	44
15323	Internet_Protocol	201202	12	1	0	0	4	2	1	0	1169	723	281	674	358	44
15323	Internet_Protocol	201203	13	0	0	0	3	3	0	0	1182	726	281	687	361	44
15323	Internet_Protocol	201204	16	4	0	0	11	8	4	0	1198	734	285	698	366	46
15323	Internet_Protocol	201205	9	3	0	0	9	4	3	0	1207	739	288	702	366	46
15323	Internet_Protocol	201206	6	3	0	0	6	4	3	0	1213	744	291	706	369	47
15323	Internet_Protocol	201207	1	0	0	0	1	1	0	0	1214	745	291	707	370	47
15323	Internet_Protocol	201208	7	4	0	0	5	3	3	0	1221	750	295	711	373	48
15323	Internet_Protocol	201209	1	0	0	0	1	1	0	0	1222	751	295	712	374	48
15323	Internet_Protocol	201210	16	6	0	0	13	5	5	0	1238	759	301	718	374	49
15323	Internet_Protocol	201211	9	2	0	0	9	5	2	0	1247	763	303	723	375	49
15323	Internet_Protocol	201212	5	2	0	0	5	3	2	0	1252	767	305	726	377	49
15323	Internet_Protocol	201301	18	6	0	0	13	8	5	0	1270	776	311	735	381	50
15323	Internet_Protocol	201302	12	2	0	0	8	6	2	0	1282	781	313	745	384	50
15323	Internet_Protocol	201303	12	2	0	0	10	6	2	0	1294	789	315	752	388	50
15323	Internet_Protocol	201304	8	3	0	0	8	5	3	0	1302	796	318	757	392	50
15323	Internet_Protocol	201305	5	3	0	0	5	3	3	0	1307	800	321	760	394	51
15323	Internet_Protocol	201306	10	4	0	0	7	4	4	0	1317	804	325	764	395	53
15323	Internet_Protocol	201307	14	7	2	1	10	5	6	2	1331	813	332	770	399	54
15323	Internet_Protocol	201308	24	12	0	0	14	8	8	0	1355	827	344	782	407	55
15323	Internet_Protocol	201309	13	3	0	0	8	5	2	0	1368	832	347	790	407	56
15323	Internet_Protocol	201310	4	2	0	0	4	3	2	0	1372	834	349	793	408	57
15323	Internet_Protocol	201311	12	5	0	0	10	4	5	0	1384	843	354	797	411	57
15323	Internet_Protocol	201312	3	1	0	0	2	1	1	0	1387	844	355	798	411	57
15323	Internet_Protocol	201401	6	2	0	0	5	3	1	0	1393	847	357	802	411	57
15323	Internet_Protocol	201402	2	1	0	0	2	1	1	0	1395	848	358	803	411	57
15323	Internet_Protocol	201403	2	1	0	0	2	1	1	0	1397	849	359	804	411	57
15323	Internet_Protocol	201404	2	0	0	0	2	1	0	0	1399	851	359	805	412	57
15323	Internet_Protocol	201405	16	7	0	0	10	6	4	0	1415	858	366	816	415	60
15323	Internet_Protocol	201406	7	1	0	0	5	4	1	0	1422	862	367	822	418	60
15323	Internet_Protocol	201407	7	2	0	0	6	4	2	0	1429	865	369	827	419	60
15323	Internet_Protocol	201408	7	0	0	0	2	2	0	0	1436	866	369	834	420	60
15323	Internet_Protocol	201409	3	1	0	0	2	1	1	0	1439	867	370	835	420	60
15323	Internet_Protocol	201410	5	2	0	0	4	2	2	0	1444	869	372	837	420	60
15323	Internet_Protocol	201411	14	5	0	0	9	6	5	0	1458	875	377	844	423	61
15323	Internet_Protocol	201412	4	0	0	0	3	1	0	0	1462	878	377	845	424	61
15323	Internet_Protocol	201501	9	4	0	0	7	3	3	0	1471	882	381	849	424	61
15323	Internet_Protocol	201502	4	2	0	0	4	2	2	0	1475	886	383	851	426	61
15323	Internet_Protocol	201503	6	2	0	0	3	2	2	0	1481	888	385	853	427	61
15323	Internet_Protocol	201504	8	3	0	0	6	3	3	0	1489	893	388	856	429	61
15323	Internet_Protocol	201505	16	7	0	0	14	9	6	0	1505	902	395	867	433	63
15323	Internet_Protocol	201506	6	3	0	0	5	3	3	0	1511	906	398	871	434	64
15323	Internet_Protocol	201507	8	3	0	0	6	3	2	0	1519	911	401	875	436	64
15323	Internet_Protocol	201508	10	4	0	0	8	5	4	0	1529	916	405	881	438	64
15323	Internet_Protocol	201509	8	2	0	0	6	3	2	0	1537	921	407	884	440	65
15323	Internet_Protocol	201510	6	4	0	0	5	3	4	0	1543	925	411	887	442	66
15323	Internet_Protocol	201511	8	3	0	0	7	4	3	0	1551	929	414	891	443	67
15323	Internet_Protocol	201512	4	2	0	0	4	2	2	0	1555	933	416	893	445	67
15323	Internet_Protocol	201601	7	3	0	0	6	4	3	0	1562	936	419	898	446	68
15323	Internet_Protocol	201602	3	1	0	0	3	2	1	0	1565	938	420	900	447	68
15323	Internet_Protocol	201603	2	1	0	0	2	1	1	0	1567	940	421	901	448	68
15323	Internet_Protocol	201604	8	4	0	0	8	5	4	0	1575	945	425	906	450	69
15323	Internet_Protocol	201605	11	5	0	0	10	7	5	0	1586	952	430	914	454	71
15323	Internet_Protocol	201606	19	6	0	0	11	6	4	0	1605	959	436	924	455	72
15323	Internet_Protocol	201607	10	4	0	0	10	4	4	0	1615	965	440	928	455	72
15323	Internet_Protocol	201608	19	11	2	0	8	6	6	1	1634	973	451	937	461	76
15323	Internet_Protocol	201609	23	7	0	0	15	8	6	0	1657	982	458	949	462	77
15323	Internet_Protocol	201610	16	7	0	0	12	7	5	0	1673	990	465	958	465	78
15323	Internet_Protocol	201611	11	4	0	0	10	5	4	0	1684	996	469	964	466	79
15323	Internet_Protocol	201612	7	2	0	0	6	3	2	0	1691	1002	471	967	468	80
15323	Internet_Protocol	201701	6	3	0	0	5	2	2	0	1697	1007	474	970	470	80
15323	Internet_Protocol	201702	6	2	0	0	5	4	2	0	1703	1010	476	974	472	80
15323	Internet_Protocol	201703	6	3	0	0	6	3	3	0	1709	1014	479	977	473	80
15323	Internet_Protocol	201704	6	3	0	0	6	4	3	0	1715	1017	482	981	473	81
15323	Internet_Protocol	201706	8	3	0	0	7	6	3	0	1723	1022	485	987	477	82
15323	Internet_Protocol	201707	6	2	0	0	5	4	2	0	1729	1026	487	991	479	83
15323	Internet_Protocol	201708	10	4	0	0	8	6	3	0	1739	1032	491	999	482	85
15323	Internet_Protocol	201709	6	2	0	0	6	6	2	0	1745	1035	493	1005	484	87
15323	Internet_Protocol	201710	11	2	0	0	7	5	2	0	1756	1038	495	1013	485	87
15323	Internet_Protocol	201711	9	1	0	0	8	6	1	0	1765	1042	496	1020	486	87
15323	Internet_Protocol	201712	9	4	0	0	8	5	4	0	1774	1046	500	1026	487	88
15323	Internet_Protocol	201801	1	0	0	0	1	1	0	0	1775	1046	500	1027	487	88
15323	Internet_Protocol	201802	9	2	0	0	8	6	2	0	1784	1049	502	1034	487	89
15323	Internet_Protocol	201803	4	0	0	0	3	2	0	0	1788	1051	502	1036	488	89
15323	Internet_Protocol	201804	9	3	0	0	7	4	3	0	1797	1055	505	1040	489	89
15323	Internet_Protocol	201805	9	3	0	0	7	5	3	0	1806	1060	508	1046	491	90
15323	Internet_Protocol	201806	10	1	0	0	8	6	1	0	1816	1066	509	1054	493	90
15323	Internet_Protocol	201807	13	6	0	0	10	8	6	0	1829	1075	515	1065	499	95
184820	Internet_Research_Task_Force	200310	3	0	0	0	1	1	0	0	3	1	0	3	1	0
184820	Internet_Research_Task_Force	200311	2	0	0	0	2	2	0	0	5	3	0	5	3	0
184820	Internet_Research_Task_Force	200401	1	0	0	0	1	1	0	0	6	4	0	6	4	0
184820	Internet_Research_Task_Force	200402	1	0	0	0	1	1	0	0	7	5	0	7	5	0
184820	Internet_Research_Task_Force	200405	1	0	0	0	1	0	0	0	8	6	0	7	5	0
184820	Internet_Research_Task_Force	200406	4	0	0	0	2	1	0	0	12	8	0	8	6	0
184820	Internet_Research_Task_Force	200501	1	0	0	0	1	1	0	0	13	9	0	9	7	0
184820	Internet_Research_Task_Force	200503	2	0	0	0	1	1	0	0	15	10	0	11	8	0
184820	Internet_Research_Task_Force	200512	1	0	0	0	1	1	0	0	16	11	0	12	9	0
184820	Internet_Research_Task_Force	200601	1	0	0	0	1	1	0	0	17	12	0	13	10	0
184820	Internet_Research_Task_Force	200605	3	1	0	0	3	2	1	0	20	15	1	15	12	0
184820	Internet_Research_Task_Force	200607	1	0	0	0	1	1	0	0	21	16	1	16	13	0
184820	Internet_Research_Task_Force	200610	1	0	0	0	1	1	0	0	22	17	1	17	14	0
184820	Internet_Research_Task_Force	200703	1	0	0	0	1	0	0	0	23	18	1	17	14	0
184820	Internet_Research_Task_Force	200706	1	0	0	0	1	1	0	0	24	19	1	18	15	0
184820	Internet_Research_Task_Force	200709	2	0	0	0	2	2	0	0	26	21	1	20	17	0
184820	Internet_Research_Task_Force	200710	1	0	0	0	1	1	0	0	27	22	1	21	18	0
184820	Internet_Research_Task_Force	200808	1	0	0	0	1	1	0	0	28	23	1	22	19	0
184820	Internet_Research_Task_Force	200809	1	0	0	0	1	1	0	0	29	24	1	23	20	0
184820	Internet_Research_Task_Force	201002	1	0	0	0	1	1	0	0	30	25	1	24	21	0
184820	Internet_Research_Task_Force	201004	1	0	0	0	1	1	0	0	31	26	1	25	22	0
184820	Internet_Research_Task_Force	201104	1	0	0	0	1	1	0	0	32	27	1	26	23	0
184820	Internet_Research_Task_Force	201105	4	0	0	0	1	1	0	0	36	28	1	30	24	0
184820	Internet_Research_Task_Force	201107	1	0	0	0	1	1	0	0	37	28	1	31	24	0
184820	Internet_Research_Task_Force	201112	1	0	0	0	1	1	0	0	38	29	1	32	25	0
184820	Internet_Research_Task_Force	201302	1	0	0	0	1	1	0	0	39	30	1	33	26	0
184820	Internet_Research_Task_Force	201304	1	0	0	0	1	1	0	0	40	31	1	34	27	0
184820	Internet_Research_Task_Force	201306	2	0	0	0	1	1	0	0	42	32	1	36	28	0
184820	Internet_Research_Task_Force	201309	1	0	0	0	1	0	0	0	43	33	1	36	28	0
184820	Internet_Research_Task_Force	201604	1	0	0	0	1	1	0	0	44	34	1	37	29	0
184820	Internet_Research_Task_Force	201711	1	0	0	0	1	1	0	0	45	35	1	38	30	0
48402	Internet_backbone	200207	5	0	0	0	1	1	0	0	5	1	0	5	1	0
48402	Internet_backbone	200302	1	0	0	0	1	0	0	0	6	2	0	5	1	0
48402	Internet_backbone	200308	1	0	0	0	1	0	0	0	7	3	0	5	1	0
48402	Internet_backbone	200311	7	0	0	0	1	0	0	0	14	4	0	5	1	0
48402	Internet_backbone	200410	1	0	0	0	1	1	0	0	15	5	0	6	2	0
48402	Internet_backbone	200411	3	0	0	0	2	2	0	0	18	6	0	9	3	0
48402	Internet_backbone	200412	2	0	0	0	1	1	0	0	20	7	0	11	4	0
48402	Internet_backbone	200502	2	1	0	0	2	0	1	0	22	9	1	11	4	0
48402	Internet_backbone	200506	1	0	0	0	1	1	0	0	23	10	1	12	5	0
48402	Internet_backbone	200507	2	0	0	0	2	2	0	0	25	12	1	14	7	0
48402	Internet_backbone	200508	3	0	0	0	3	3	0	0	28	15	1	17	10	0
48402	Internet_backbone	200509	3	0	0	0	2	0	0	0	31	17	1	17	10	0
48402	Internet_backbone	200510	4	0	0	0	2	2	0	0	35	19	1	21	12	0
48402	Internet_backbone	200511	3	0	0	0	3	3	0	0	38	22	1	24	15	0
48402	Internet_backbone	200512	1	0	0	0	1	0	0	0	39	23	1	24	15	0
48402	Internet_backbone	200601	14	7	2	1	7	5	4	2	53	30	8	32	20	1
48402	Internet_backbone	200602	1	0	0	0	1	0	0	0	54	31	8	32	20	1
48402	Internet_backbone	200603	5	0	0	0	5	0	0	0	59	36	8	32	20	1
48402	Internet_backbone	200604	6	1	0	0	6	2	1	0	65	42	9	34	22	1
48402	Internet_backbone	200605	11	0	0	0	10	7	0	0	76	52	9	42	29	1
48402	Internet_backbone	200606	3	0	0	0	3	3	0	0	79	55	9	45	32	1
48402	Internet_backbone	200607	3	0	0	0	3	2	0	0	82	58	9	47	34	1
48402	Internet_backbone	200608	5	1	0	0	4	3	1	0	87	62	10	50	37	1
48402	Internet_backbone	200609	2	0	0	0	2	2	0	0	89	64	10	52	39	1
48402	Internet_backbone	200610	1	0	0	0	1	0	0	0	90	65	10	52	39	1
48402	Internet_backbone	200611	7	2	0	0	6	2	1	0	97	70	12	55	40	1
48402	Internet_backbone	200612	5	2	0	0	5	4	2	0	102	75	14	59	44	2
48402	Internet_backbone	200701	3	1	0	0	3	2	1	0	105	77	15	61	45	3
48402	Internet_backbone	200702	5	1	0	0	4	3	1	0	110	81	16	65	48	3
48402	Internet_backbone	200703	5	1	0	0	4	3	1	0	115	85	17	69	51	3
48402	Internet_backbone	200704	2	1	0	0	2	0	1	0	117	87	18	69	51	3
48402	Internet_backbone	200705	3	1	0	0	3	1	1	0	120	90	19	70	52	3
48402	Internet_backbone	200706	18	4	0	0	13	7	4	0	138	103	23	77	59	3
48402	Internet_backbone	200707	7	1	0	0	6	2	1	0	145	108	24	79	60	3
48402	Internet_backbone	200709	2	0	0	0	2	2	0	0	147	109	24	81	61	3
48402	Internet_backbone	200710	7	2	0	0	5	1	2	0	154	114	26	82	62	3
48402	Internet_backbone	200711	1	0	0	0	1	1	0	0	155	115	26	83	63	3
48402	Internet_backbone	200712	3	1	0	0	2	1	1	0	158	117	27	84	64	3
48402	Internet_backbone	200801	5	0	0	0	5	2	0	0	163	122	27	86	66	3
48402	Internet_backbone	200802	1	0	0	0	1	1	0	0	164	123	27	87	67	3
48402	Internet_backbone	200803	12	5	0	0	9	7	4	0	176	132	32	95	74	4
48402	Internet_backbone	200804	2	0	0	0	2	1	0	0	178	134	32	96	75	4
48402	Internet_backbone	200805	6	1	0	0	5	2	1	0	184	139	33	98	77	4
48402	Internet_backbone	200806	2	0	0	0	2	2	0	0	186	141	33	100	79	4
48402	Internet_backbone	200807	3	0	0	0	2	1	0	0	189	142	33	101	79	4
48402	Internet_backbone	200808	3	0	0	0	1	0	0	0	192	143	33	101	79	4
48402	Internet_backbone	200809	3	0	0	0	2	1	0	0	195	144	33	102	80	4
48402	Internet_backbone	200810	9	2	0	0	6	3	2	0	204	150	35	105	83	4
48402	Internet_backbone	200811	2	0	0	0	2	0	0	0	206	152	35	105	83	4
48402	Internet_backbone	200812	4	2	0	0	4	3	2	0	210	156	37	108	86	5
48402	Internet_backbone	200901	3	1	0	0	2	1	1	0	213	157	38	109	86	5
48402	Internet_backbone	200902	1	0	0	0	1	0	0	0	214	158	38	109	86	5
48402	Internet_backbone	200904	3	0	0	0	3	1	0	0	217	160	38	110	86	5
48402	Internet_backbone	200905	3	0	0	0	3	2	0	0	220	163	38	112	88	5
48402	Internet_backbone	200906	1	0	0	0	1	1	0	0	221	164	38	113	89	5
48402	Internet_backbone	200907	1	0	0	0	1	0	0	0	222	165	38	113	89	5
48402	Internet_backbone	200908	5	1	0	0	5	2	1	0	227	170	39	115	91	5
48402	Internet_backbone	200909	1	0	0	0	1	0	0	0	228	171	39	115	91	5
48402	Internet_backbone	201001	2	1	0	0	2	1	1	0	230	173	40	116	92	5
48402	Internet_backbone	201003	2	0	0	0	2	2	0	0	232	174	40	118	93	5
48402	Internet_backbone	201004	1	0	0	0	1	1	0	0	233	175	40	119	94	5
48402	Internet_backbone	201006	2	1	0	0	2	1	1	0	235	177	41	120	95	5
48402	Internet_backbone	201007	1	0	0	0	1	1	0	0	236	178	41	121	96	5
48402	Internet_backbone	201009	2	0	0	0	2	2	0	0	238	180	41	123	98	5
48402	Internet_backbone	201011	2	0	0	0	1	0	0	0	240	181	41	123	98	5
48402	Internet_backbone	201012	2	0	0	0	2	1	0	0	242	183	41	124	99	5
48402	Internet_backbone	201101	1	1	0	0	1	0	1	0	243	184	42	124	99	5
48402	Internet_backbone	201104	4	1	0	0	4	3	1	0	247	188	43	127	102	5
48402	Internet_backbone	201105	11	0	0	0	7	6	0	0	258	195	43	137	108	5
48402	Internet_backbone	201106	9	0	0	0	8	4	0	0	267	202	43	142	111	5
48402	Internet_backbone	201107	5	0	0	0	4	3	0	0	272	206	43	145	114	5
48402	Internet_backbone	201108	2	0	0	0	2	1	0	0	274	208	43	146	115	5
48402	Internet_backbone	201109	5	1	0	0	5	4	1	0	279	212	44	150	118	6
48402	Internet_backbone	201110	10	0	0	0	7	5	0	0	289	218	44	158	122	6
48402	Internet_backbone	201111	2	0	0	0	2	1	0	0	291	220	44	159	123	6
48402	Internet_backbone	201112	4	0	0	0	4	2	0	0	295	224	44	161	125	6
48402	Internet_backbone	201201	4	0	0	0	2	1	0	0	299	226	44	163	126	6
48402	Internet_backbone	201202	4	1	0	0	4	2	1	0	303	230	45	165	128	6
48402	Internet_backbone	201203	1	0	0	0	1	1	0	0	304	231	45	166	129	6
48402	Internet_backbone	201206	8	0	0	0	4	2	0	0	312	234	45	172	130	6
48402	Internet_backbone	201207	3	0	0	0	2	2	0	0	315	235	45	175	131	6
48402	Internet_backbone	201208	7	1	0	0	4	1	1	0	322	239	46	179	132	6
48402	Internet_backbone	201209	12	3	0	0	7	3	2	0	334	245	49	183	135	6
48402	Internet_backbone	201210	3	0	0	0	3	3	0	0	337	247	49	186	137	6
48402	Internet_backbone	201212	2	0	0	0	2	0	0	0	339	249	49	186	137	6
48402	Internet_backbone	201301	1	0	0	0	1	1	0	0	340	250	49	187	138	6
48402	Internet_backbone	201302	4	1	0	0	4	2	1	0	344	254	50	189	140	6
48402	Internet_backbone	201304	4	0	0	0	4	4	0	0	348	258	50	193	144	6
48402	Internet_backbone	201305	5	1	0	0	3	3	1	0	353	261	51	198	147	7
48402	Internet_backbone	201306	6	2	0	0	6	2	2	0	359	266	53	200	148	7
48402	Internet_backbone	201307	2	0	0	0	1	0	0	0	361	267	53	200	148	7
48402	Internet_backbone	201310	2	0	0	0	2	2	0	0	363	269	53	202	150	7
48402	Internet_backbone	201311	7	1	0	0	4	3	1	0	370	273	54	208	153	7
48402	Internet_backbone	201401	2	0	0	0	1	0	0	0	372	274	54	208	153	7
48402	Internet_backbone	201402	4	0	0	0	1	1	0	0	376	275	54	212	154	7
48402	Internet_backbone	201403	1	0	0	0	1	1	0	0	377	275	54	213	154	7
48402	Internet_backbone	201404	1	0	0	0	1	0	0	0	378	276	54	213	154	7
48402	Internet_backbone	201405	6	0	0	0	4	2	0	0	384	279	54	217	155	7
48402	Internet_backbone	201406	3	0	0	0	3	3	0	0	387	282	54	220	158	7
48402	Internet_backbone	201408	1	0	0	0	1	1	0	0	388	282	54	221	158	7
48402	Internet_backbone	201409	1	0	0	0	1	1	0	0	389	283	54	222	159	7
48402	Internet_backbone	201410	1	0	0	0	1	1	0	0	390	284	54	223	160	7
48402	Internet_backbone	201411	1	0	0	0	1	0	0	0	391	285	54	223	160	7
48402	Internet_backbone	201412	4	2	0	0	4	2	2	0	395	288	56	225	161	7
48402	Internet_backbone	201503	3	0	0	0	3	1	0	0	398	291	56	226	162	7
48402	Internet_backbone	201508	1	0	0	0	1	0	0	0	399	292	56	226	162	7
48402	Internet_backbone	201509	2	1	0	0	2	2	1	0	401	293	57	228	162	8
48402	Internet_backbone	201510	1	0	0	0	1	1	0	0	402	294	57	229	163	8
48402	Internet_backbone	201511	1	0	0	0	1	1	0	0	403	295	57	230	164	8
48402	Internet_backbone	201512	4	1	0	0	3	1	1	0	407	298	58	231	165	8
48402	Internet_backbone	201601	1	0	0	0	1	0	0	0	408	299	58	231	165	8
48402	Internet_backbone	201604	1	0	0	0	1	0	0	0	409	300	58	231	165	8
48402	Internet_backbone	201607	2	1	0	0	2	1	1	0	411	302	59	232	166	8
48402	Internet_backbone	201608	3	1	0	0	3	1	1	0	414	304	60	233	166	8
48402	Internet_backbone	201610	1	0	0	0	1	1	0	0	415	305	60	234	167	8
48402	Internet_backbone	201611	1	0	0	0	1	1	0	0	416	306	60	235	168	8
48402	Internet_backbone	201702	4	0	0	0	1	1	0	0	420	307	60	239	169	8
48402	Internet_backbone	201703	1	0	0	0	1	1	0	0	421	308	60	240	170	8
48402	Internet_backbone	201705	2	0	0	0	1	1	0	0	423	309	60	242	171	8
48402	Internet_backbone	201706	1	0	0	0	1	0	0	0	424	310	60	242	171	8
48402	Internet_backbone	201707	2	0	0	0	2	2	0	0	426	311	60	244	172	8
48402	Internet_backbone	201708	2	1	0	0	2	1	1	0	428	313	61	245	173	8
48402	Internet_backbone	201709	1	0	0	0	1	1	0	0	429	313	61	246	173	8
48402	Internet_backbone	201710	1	0	0	0	1	1	0	0	430	314	61	247	174	8
48402	Internet_backbone	201711	3	0	0	0	2	1	0	0	433	315	61	248	174	8
48402	Internet_backbone	201712	1	0	0	0	1	1	0	0	434	316	61	249	175	8
48402	Internet_backbone	201801	6	1	0	0	4	1	1	0	440	320	62	251	176	8
48402	Internet_backbone	201802	6	1	0	0	4	1	1	0	446	324	63	252	177	8
48402	Internet_backbone	201803	1	0	0	0	1	0	0	0	447	325	63	252	177	8
359193	Internet_exchange_point	200312	10	0	0	0	4	4	0	0	10	4	0	10	4	0
359193	Internet_exchange_point	200401	3	0	0	0	3	2	0	0	13	7	0	12	6	0
359193	Internet_exchange_point	200402	4	0	0	0	4	4	0	0	17	11	0	16	10	0
359193	Internet_exchange_point	200403	1	0	0	0	1	1	0	0	18	12	0	17	11	0
359193	Internet_exchange_point	200404	2	0	0	0	2	1	0	0	20	14	0	18	12	0
359193	Internet_exchange_point	200405	5	0	0	0	3	2	0	0	25	16	0	22	13	0
359193	Internet_exchange_point	200406	1	0	0	0	1	1	0	0	26	17	0	23	14	0
359193	Internet_exchange_point	200407	3	0	0	0	2	1	0	0	29	19	0	24	15	0
359193	Internet_exchange_point	200408	3	0	0	0	2	1	0	0	32	20	0	26	15	0
359193	Internet_exchange_point	200409	4	0	0	0	3	2	0	0	36	23	0	29	17	0
359193	Internet_exchange_point	200410	4	0	0	0	4	4	0	0	40	26	0	33	20	0
359193	Internet_exchange_point	200411	1	0	0	0	1	1	0	0	41	27	0	34	21	0
359193	Internet_exchange_point	200412	6	0	0	0	3	3	0	0	47	30	0	40	24	0
359193	Internet_exchange_point	200502	3	0	0	0	2	2	0	0	50	32	0	43	26	0
359193	Internet_exchange_point	200504	1	0	0	0	1	0	0	0	51	33	0	43	26	0
359193	Internet_exchange_point	200506	4	0	0	0	4	2	0	0	55	37	0	45	28	0
359193	Internet_exchange_point	200507	5	0	0	0	3	1	0	0	60	40	0	46	29	0
359193	Internet_exchange_point	200508	3	0	0	0	3	2	0	0	63	43	0	48	31	0
359193	Internet_exchange_point	200509	8	0	0	0	5	2	0	0	71	48	0	52	33	0
359193	Internet_exchange_point	200510	8	0	0	0	4	2	0	0	79	52	0	56	35	0
359193	Internet_exchange_point	200511	17	1	0	0	12	8	1	0	96	64	1	69	43	0
359193	Internet_exchange_point	200512	5	0	0	0	4	2	0	0	101	68	1	71	45	0
359193	Internet_exchange_point	200602	4	0	0	0	3	1	0	0	105	71	1	72	46	0
359193	Internet_exchange_point	200603	4	0	0	0	3	3	0	0	109	74	1	76	49	0
359193	Internet_exchange_point	200604	12	0	0	0	4	2	0	0	121	78	1	85	51	0
359193	Internet_exchange_point	200605	9	0	0	0	8	6	0	0	130	85	1	92	56	0
359193	Internet_exchange_point	200606	4	0	0	0	3	2	0	0	134	88	1	94	58	0
359193	Internet_exchange_point	200607	8	0	0	0	7	5	0	0	142	94	1	100	62	0
359193	Internet_exchange_point	200608	6	0	0	0	4	3	0	0	148	98	1	105	65	0
359193	Internet_exchange_point	200609	4	0	0	0	4	1	0	0	152	102	1	106	66	0
359193	Internet_exchange_point	200610	3	1	0	0	3	2	1	0	155	105	2	108	68	0
359193	Internet_exchange_point	200611	10	2	0	0	8	1	2	0	165	113	4	109	69	0
359193	Internet_exchange_point	200612	15	1	0	0	5	5	1	0	180	117	5	124	73	1
359193	Internet_exchange_point	200701	9	0	0	0	5	4	0	0	189	122	5	131	77	1
359193	Internet_exchange_point	200702	10	1	0	0	6	3	1	0	199	127	6	137	79	1
359193	Internet_exchange_point	200703	13	0	0	0	7	5	0	0	212	134	6	145	84	1
359193	Internet_exchange_point	200704	6	0	0	0	5	2	0	0	218	139	6	148	86	1
359193	Internet_exchange_point	200705	5	0	0	0	5	3	0	0	223	142	6	151	88	1
359193	Internet_exchange_point	200706	6	1	0	0	5	4	1	0	229	146	7	156	91	2
359193	Internet_exchange_point	200707	4	0	0	0	4	2	0	0	233	150	7	158	93	2
359193	Internet_exchange_point	200708	13	1	0	0	11	8	1	0	246	160	8	168	100	3
359193	Internet_exchange_point	200709	4	1	0	0	4	4	1	0	250	163	9	172	103	4
359193	Internet_exchange_point	200710	7	0	0	0	7	4	0	0	257	168	9	176	105	4
359193	Internet_exchange_point	200711	16	0	0	0	11	7	0	0	273	178	9	188	111	4
359193	Internet_exchange_point	200712	3	0	0	0	3	0	0	0	276	181	9	188	111	4
359193	Internet_exchange_point	200801	3	0	0	0	3	2	0	0	279	184	9	190	113	4
359193	Internet_exchange_point	200802	2	0	0	0	2	1	0	0	281	186	9	191	114	4
359193	Internet_exchange_point	200803	2	0	0	0	2	2	0	0	283	188	9	193	116	4
359193	Internet_exchange_point	200804	12	2	0	0	8	5	2	0	295	196	11	200	121	4
359193	Internet_exchange_point	200805	12	0	0	0	10	5	0	0	307	206	11	206	126	4
359193	Internet_exchange_point	200806	10	1	0	0	10	6	1	0	317	215	12	212	131	4
359193	Internet_exchange_point	200807	7	0	0	0	7	2	0	0	324	220	12	214	132	4
359193	Internet_exchange_point	200808	16	0	0	0	9	4	0	0	340	228	12	222	136	4
359193	Internet_exchange_point	200809	2	0	0	0	2	2	0	0	342	230	12	224	138	4
359193	Internet_exchange_point	200810	10	0	0	0	3	3	0	0	352	231	12	234	139	4
359193	Internet_exchange_point	200903	2	0	0	0	2	0	0	0	354	233	12	234	139	4
359193	Internet_exchange_point	200905	1	0	0	0	1	1	0	0	355	234	12	235	140	4
359193	Internet_exchange_point	200906	6	0	0	0	2	2	0	0	361	236	12	241	142	4
359193	Internet_exchange_point	200909	3	0	0	0	3	1	0	0	364	238	12	242	142	4
359193	Internet_exchange_point	200910	7	0	0	0	3	3	0	0	371	241	12	249	145	4
359193	Internet_exchange_point	200911	3	1	0	0	3	1	1	0	374	244	13	250	146	4
359193	Internet_exchange_point	201003	1	0	0	0	1	0	0	0	375	245	13	250	146	4
359193	Internet_exchange_point	201005	2	0	0	0	1	0	0	0	377	246	13	250	146	4
359193	Internet_exchange_point	201007	1	0	0	0	1	1	0	0	378	247	13	251	147	4
359193	Internet_exchange_point	201009	3	0	0	0	3	3	0	0	381	250	13	254	150	4
359193	Internet_exchange_point	201101	1	0	0	0	1	1	0	0	382	251	13	255	151	4
359193	Internet_exchange_point	201102	5	1	0	0	5	2	1	0	387	256	14	257	153	4
359193	Internet_exchange_point	201103	1	0	0	0	1	1	0	0	388	257	14	258	154	4
359193	Internet_exchange_point	201104	1	0	0	0	1	1	0	0	389	258	14	259	155	4
359193	Internet_exchange_point	201106	2	0	0	0	2	1	0	0	391	260	14	260	156	4
359193	Internet_exchange_point	201108	1	0	0	0	1	1	0	0	392	261	14	261	157	4
359193	Internet_exchange_point	201109	2	1	0	0	2	2	1	0	394	262	15	263	158	5
359193	Internet_exchange_point	201111	3	0	0	0	2	1	0	0	397	263	15	264	158	5
359193	Internet_exchange_point	201201	1	0	0	0	1	1	0	0	398	264	15	265	159	5
359193	Internet_exchange_point	201203	3	1	0	0	2	2	1	0	401	266	16	268	161	6
359193	Internet_exchange_point	201205	1	0	0	0	1	1	0	0	402	267	16	269	162	6
359193	Internet_exchange_point	201206	1	0	0	0	1	1	0	0	403	268	16	270	163	6
359193	Internet_exchange_point	201208	3	0	0	0	2	2	0	0	406	270	16	273	165	6
359193	Internet_exchange_point	201209	2	0	0	0	2	1	0	0	408	272	16	274	166	6
359193	Internet_exchange_point	201211	6	0	0	0	2	2	0	0	414	273	16	280	167	6
359193	Internet_exchange_point	201212	5	1	0	0	3	2	1	0	419	276	17	284	168	6
359193	Internet_exchange_point	201301	4	0	0	0	2	2	0	0	423	278	17	288	170	6
359193	Internet_exchange_point	201302	2	1	0	0	2	1	1	0	425	279	18	289	170	6
359193	Internet_exchange_point	201303	1	0	0	0	1	1	0	0	426	280	18	290	171	6
359193	Internet_exchange_point	201305	1	0	0	0	1	0	0	0	427	281	18	290	171	6
359193	Internet_exchange_point	201309	2	0	0	0	2	2	0	0	429	283	18	292	173	6
359193	Internet_exchange_point	201310	1	0	0	0	1	0	0	0	430	284	18	292	173	6
359193	Internet_exchange_point	201311	1	0	0	0	1	1	0	0	431	285	18	293	174	6
359193	Internet_exchange_point	201401	2	0	0	0	2	1	0	0	433	286	18	294	174	6
359193	Internet_exchange_point	201410	1	0	0	0	1	1	0	0	434	287	18	295	175	6
359193	Internet_exchange_point	201411	2	0	0	0	2	1	0	0	436	288	18	296	175	6
359193	Internet_exchange_point	201504	4	0	0	0	1	0	0	0	440	289	18	296	175	6
359193	Internet_exchange_point	201505	12	0	0	0	5	5	0	0	452	293	18	308	179	6
359193	Internet_exchange_point	201506	2	0	0	0	1	1	0	0	454	294	18	310	180	6
359193	Internet_exchange_point	201508	1	0	0	0	1	1	0	0	455	294	18	311	180	6
359193	Internet_exchange_point	201510	1	0	0	0	1	1	0	0	456	294	18	312	180	6
359193	Internet_exchange_point	201512	4	0	0	0	1	1	0	0	460	295	18	316	181	6
359193	Internet_exchange_point	201601	1	0	0	0	1	1	0	0	461	296	18	317	182	6
359193	Internet_exchange_point	201606	4	2	0	0	2	2	1	0	465	298	20	321	184	8
359193	Internet_exchange_point	201608	2	1	0	0	2	2	1	0	467	299	21	323	184	9
359193	Internet_exchange_point	201609	3	1	0	0	3	2	1	0	470	301	22	325	185	9
359193	Internet_exchange_point	201611	5	2	0	0	4	3	2	0	475	303	24	328	186	9
359193	Internet_exchange_point	201702	1	0	0	0	1	1	0	0	476	304	24	329	187	9
359193	Internet_exchange_point	201703	2	1	0	0	2	1	1	0	478	306	25	330	188	9
359193	Internet_exchange_point	201705	1	0	0	0	1	1	0	0	479	307	25	331	189	9
359193	Internet_exchange_point	201710	1	0	0	0	1	0	0	0	480	308	25	331	189	9
359193	Internet_exchange_point	201712	1	0	0	0	1	1	0	0	481	309	25	332	190	9
359193	Internet_exchange_point	201802	1	0	0	0	1	1	0	0	482	309	25	333	190	9
359193	Internet_exchange_point	201803	1	0	0	0	1	1	0	0	483	310	25	334	191	9
12057519	Internet_of_things	200712	6	0	0	0	1	1	0	0	6	1	0	6	1	0
12057519	Internet_of_things	200801	1	0	0	0	1	1	0	0	7	2	0	7	2	0
12057519	Internet_of_things	200802	1	0	0	0	1	1	0	0	8	3	0	8	3	0
12057519	Internet_of_things	200804	2	0	0	0	1	0	0	0	10	4	0	8	3	0
12057519	Internet_of_things	200805	2	0	0	0	2	1	0	0	12	5	0	9	4	0
12057519	Internet_of_things	200806	5	2	0	0	2	1	1	0	17	6	2	12	4	0
12057519	Internet_of_things	200808	2	0	0	0	2	1	0	0	19	8	2	13	5	0
12057519	Internet_of_things	200809	1	0	0	0	1	0	0	0	20	9	2	13	5	0
12057519	Internet_of_things	200810	5	0	0	0	2	2	0	0	25	11	2	18	7	0
12057519	Internet_of_things	200811	21	0	0	0	5	4	0	0	46	13	2	36	9	0
12057519	Internet_of_things	200812	6	1	0	0	5	3	1	0	52	17	3	40	11	0
12057519	Internet_of_things	200902	2	0	0	0	1	1	0	0	54	17	3	42	11	0
12057519	Internet_of_things	200903	3	0	0	0	3	2	0	0	57	20	3	44	13	0
12057519	Internet_of_things	200904	4	0	0	0	4	4	0	0	61	23	3	48	16	0
12057519	Internet_of_things	200905	3	1	0	0	3	2	1	0	64	25	4	50	17	0
12057519	Internet_of_things	200906	7	0	0	0	5	2	0	0	71	30	4	52	19	0
12057519	Internet_of_things	200907	19	8	6	3	5	4	3	3	90	34	12	63	22	4
12057519	Internet_of_things	200908	2	0	0	0	1	0	0	0	92	35	12	63	22	4
12057519	Internet_of_things	200909	1	0	0	0	1	1	0	0	93	36	12	64	23	4
12057519	Internet_of_things	200910	25	0	0	0	3	2	0	0	118	38	12	88	24	4
12057519	Internet_of_things	200911	2	0	0	0	2	2	0	0	120	40	12	90	26	4
12057519	Internet_of_things	200912	4	1	0	0	4	2	1	0	124	44	13	92	28	4
12057519	Internet_of_things	201001	1	0	0	0	1	0	0	0	125	45	13	92	28	4
12057519	Internet_of_things	201002	3	1	0	0	3	2	1	0	128	48	14	94	30	4
12057519	Internet_of_things	201003	2	0	0	0	2	1	0	0	130	50	14	95	31	4
12057519	Internet_of_things	201004	6	0	0	0	4	3	0	0	136	53	14	100	33	4
12057519	Internet_of_things	201005	5	0	0	0	2	2	0	0	141	54	14	105	34	4
12057519	Internet_of_things	201006	5	1	0	0	4	2	1	0	146	58	15	107	36	4
12057519	Internet_of_things	201007	10	2	0	0	6	4	2	0	156	64	17	115	40	6
12057519	Internet_of_things	201009	4	0	0	0	4	2	0	0	160	67	17	117	41	6
12057519	Internet_of_things	201010	8	0	0	0	5	4	0	0	168	72	17	123	45	6
12057519	Internet_of_things	201011	9	1	0	0	6	5	1	0	177	76	18	131	48	6
12057519	Internet_of_things	201012	6	2	0	0	5	4	2	0	183	81	20	136	52	7
12057519	Internet_of_things	201101	2	0	0	0	2	2	0	0	185	82	20	138	53	7
12057519	Internet_of_things	201102	9	2	0	0	5	3	2	0	194	85	22	144	54	7
12057519	Internet_of_things	201103	2	1	0	0	2	0	1	0	196	87	23	144	54	8
12057519	Internet_of_things	201104	14	2	0	0	6	4	2	0	210	91	25	153	56	8
12057519	Internet_of_things	201105	20	0	0	0	6	4	0	0	230	97	25	170	60	8
12057519	Internet_of_things	201106	6	0	0	0	3	2	0	0	236	99	25	174	61	8
12057519	Internet_of_things	201107	4	0	0	0	4	2	0	0	240	103	25	176	63	8
12057519	Internet_of_things	201108	3	0	0	0	3	3	0	0	243	106	25	179	66	8
12057519	Internet_of_things	201109	15	0	0	0	6	4	0	0	258	111	25	192	69	8
12057519	Internet_of_things	201110	22	4	0	0	13	9	3	0	280	120	29	209	74	11
12057519	Internet_of_things	201111	10	1	0	0	8	4	1	0	290	128	30	214	78	11
12057519	Internet_of_things	201112	6	1	0	0	5	3	1	0	296	132	31	217	80	11
12057519	Internet_of_things	201201	7	1	0	0	7	4	1	0	303	136	32	221	82	11
12057519	Internet_of_things	201202	4	1	0	0	4	3	1	0	307	139	33	224	84	11
12057519	Internet_of_things	201203	6	0	0	0	5	3	0	0	313	143	33	227	86	11
12057519	Internet_of_things	201204	7	0	0	0	3	3	0	0	320	145	33	234	88	11
12057519	Internet_of_things	201205	5	0	0	0	2	1	0	0	325	147	33	237	89	11
12057519	Internet_of_things	201206	2	0	0	0	2	1	0	0	327	149	33	238	90	11
12057519	Internet_of_things	201207	6	0	0	0	6	4	0	0	333	155	33	242	94	11
12057519	Internet_of_things	201208	10	0	0	0	7	3	0	0	343	161	33	246	96	11
12057519	Internet_of_things	201209	13	1	0	0	8	5	1	0	356	168	34	255	100	12
12057519	Internet_of_things	201210	3	1	0	0	3	2	1	0	359	170	35	257	101	12
12057519	Internet_of_things	201211	6	0	0	0	4	2	0	0	365	174	35	261	103	12
12057519	Internet_of_things	201212	8	0	0	0	6	3	0	0	373	179	35	264	105	12
12057519	Internet_of_things	201301	5	0	0	0	5	3	0	0	378	183	35	267	107	12
12057519	Internet_of_things	201302	4	0	0	0	4	2	0	0	382	187	35	269	109	12
12057519	Internet_of_things	201303	13	1	0	0	11	7	1	0	395	195	36	276	114	13
12057519	Internet_of_things	201304	8	1	0	0	7	5	1	0	403	200	37	282	118	13
12057519	Internet_of_things	201305	11	1	0	0	9	7	1	0	414	207	38	290	123	13
12057519	Internet_of_things	201306	18	4	0	0	11	9	2	0	432	216	42	305	130	15
12057519	Internet_of_things	201307	62	3	0	0	13	9	2	0	494	227	45	362	137	16
12057519	Internet_of_things	201308	9	0	0	0	8	4	0	0	503	234	45	367	140	16
12057519	Internet_of_things	201309	7	1	0	0	7	4	1	0	510	241	46	371	144	16
12057519	Internet_of_things	201310	12	1	0	0	7	7	1	0	522	248	47	383	151	17
12057519	Internet_of_things	201311	32	4	2	1	19	12	3	2	554	263	51	400	159	20
12057519	Internet_of_things	201312	16	1	0	0	13	7	1	0	570	275	52	408	165	20
12057519	Internet_of_things	201401	20	3	0	0	12	8	2	0	590	282	55	418	170	21
12057519	Internet_of_things	201402	41	8	0	0	25	17	4	0	631	304	63	447	183	25
12057519	Internet_of_things	201403	25	4	1	0	16	10	2	1	656	316	67	463	188	28
12057519	Internet_of_things	201404	25	1	0	0	17	12	1	0	681	328	68	480	195	28
12057519	Internet_of_things	201405	27	3	0	0	18	11	2	0	708	344	71	496	204	29
12057519	Internet_of_things	201406	40	6	0	0	20	12	3	0	748	361	77	523	213	31
12057519	Internet_of_things	201407	42	5	0	0	19	12	2	0	790	376	82	557	221	35
12057519	Internet_of_things	201408	67	1	0	0	26	18	1	0	857	397	83	609	233	35
12057519	Internet_of_things	201409	20	1	0	0	19	12	1	0	877	415	84	622	244	36
12057519	Internet_of_things	201410	21	1	0	0	13	10	1	0	898	424	85	639	250	37
12057519	Internet_of_things	201411	15	2	0	0	14	11	2	0	913	437	87	651	259	39
12057519	Internet_of_things	201412	22	2	0	0	16	10	2	0	935	450	89	665	266	40
12057519	Internet_of_things	201501	14	1	0	0	12	7	1	0	949	460	90	672	271	41
12057519	Internet_of_things	201502	35	1	0	0	19	12	1	0	984	474	91	700	277	41
12057519	Internet_of_things	201503	46	3	0	0	25	16	2	0	1030	492	94	726	286	41
12057519	Internet_of_things	201504	42	3	0	0	27	13	3	0	1072	516	97	753	295	42
12057519	Internet_of_things	201505	9	1	0	0	9	5	1	0	1081	523	98	758	298	42
12057519	Internet_of_things	201506	23	4	0	0	18	13	4	0	1104	537	102	776	307	42
12057519	Internet_of_things	201507	58	9	0	0	34	20	6	0	1162	563	111	806	317	48
12057519	Internet_of_things	201508	22	3	0	0	19	10	3	0	1184	581	114	816	326	48
12057519	Internet_of_things	201509	58	21	2	0	33	22	12	2	1242	605	135	861	336	59
12057519	Internet_of_things	201510	40	4	0	0	25	16	2	0	1282	623	139	884	344	60
12057519	Internet_of_things	201511	63	12	0	0	36	23	8	0	1345	652	151	922	360	62
12057519	Internet_of_things	201512	37	9	0	0	24	13	5	0	1382	672	160	945	369	65
12057519	Internet_of_things	201601	33	4	0	0	18	10	4	0	1415	686	164	963	374	66
12057519	Internet_of_things	201602	69	21	4	1	32	20	10	3	1484	714	185	1000	388	77
12057519	Internet_of_things	201603	56	3	0	0	31	23	2	0	1540	736	188	1034	402	78
12057519	Internet_of_things	201604	61	9	1	0	29	24	5	1	1601	759	197	1079	419	81
12057519	Internet_of_things	201605	51	8	0	0	30	20	7	0	1652	785	205	1116	435	84
12057519	Internet_of_things	201606	34	8	1	0	20	13	6	1	1686	799	213	1139	443	88
12057519	Internet_of_things	201607	58	8	0	0	30	24	5	0	1744	820	221	1189	457	95
12057519	Internet_of_things	201608	62	11	0	0	32	19	7	0	1806	844	232	1229	468	100
12057519	Internet_of_things	201609	35	9	2	1	13	11	4	2	1841	851	241	1260	473	108
12057519	Internet_of_things	201610	72	8	0	0	35	22	8	0	1913	874	249	1304	481	109
12057519	Internet_of_things	201611	109	12	0	0	54	31	9	0	2022	914	261	1367	498	111
12057519	Internet_of_things	201612	77	22	1	0	39	22	12	1	2099	942	283	1412	508	114
12057519	Internet_of_things	201701	29	5	0	0	25	16	5	0	2128	962	288	1431	518	114
12057519	Internet_of_things	201702	42	11	0	0	30	23	10	0	2170	984	299	1462	530	122
12057519	Internet_of_things	201703	40	13	1	0	24	18	7	1	2210	1001	312	1493	542	129
12057519	Internet_of_things	201704	57	5	0	0	27	21	5	0	2267	1022	317	1541	555	133
12057519	Internet_of_things	201705	29	6	0	0	23	16	5	0	2296	1037	323	1561	562	136
12057519	Internet_of_things	201706	55	15	1	0	33	22	10	1	2351	1061	338	1599	573	141
12057519	Internet_of_things	201707	43	7	0	0	25	17	7	0	2394	1080	345	1629	584	144
12057519	Internet_of_things	201708	31	6	0	0	24	14	4	0	2425	1099	351	1649	594	145
12057519	Internet_of_things	201709	57	13	1	0	29	21	11	1	2482	1121	364	1678	607	153
12057519	Internet_of_things	201710	34	10	0	0	26	20	8	0	2516	1139	374	1704	615	159
12057519	Internet_of_things	201711	46	5	0	0	27	19	4	0	2562	1160	379	1740	628	159
12057519	Internet_of_things	201712	75	21	0	0	42	29	14	0	2637	1192	400	1793	646	163
12057519	Internet_of_things	201801	29	5	0	0	26	17	5	0	2666	1211	405	1813	654	164
12057519	Internet_of_things	201802	30	5	0	0	24	13	5	0	2696	1226	410	1829	658	164
12057519	Internet_of_things	201803	32	7	0	0	27	17	6	0	2728	1250	417	1851	671	166
12057519	Internet_of_things	201804	40	6	0	0	24	16	5	0	2768	1267	423	1875	678	168
12057519	Internet_of_things	201805	63	13	0	0	37	28	10	0	2831	1296	436	1921	696	176
12057519	Internet_of_things	201806	23	6	0	0	16	10	4	0	2854	1307	442	1938	700	178
12057519	Internet_of_things	201807	92	22	2	1	47	29	14	2	2946	1344	464	2000	715	184
15476	Internet_protocol_suite	200112	1	0	0	0	1	1	0	0	1	1	0	1	1	0
15476	Internet_protocol_suite	200201	2	0	0	0	2	2	0	0	3	3	0	3	3	0
15476	Internet_protocol_suite	200202	14	0	0	0	6	6	0	0	17	9	0	17	6	0
15476	Internet_protocol_suite	200205	1	0	0	0	1	1	0	0	18	10	0	18	6	0
15476	Internet_protocol_suite	200206	2	0	0	0	2	2	0	0	20	12	0	20	8	0
15476	Internet_protocol_suite	200207	1	0	0	0	1	1	0	0	21	13	0	21	9	0
15476	Internet_protocol_suite	200208	5	0	0	0	2	1	0	0	26	15	0	23	10	0
15476	Internet_protocol_suite	200209	2	0	0	0	2	2	0	0	28	16	0	25	11	0
15476	Internet_protocol_suite	200210	1	0	0	0	1	1	0	0	29	17	0	26	12	0
15476	Internet_protocol_suite	200211	2	0	0	0	1	1	0	0	31	18	0	28	13	0
15476	Internet_protocol_suite	200212	1	0	0	0	1	1	0	0	32	19	0	29	14	0
15476	Internet_protocol_suite	200301	5	2	0	0	4	3	2	0	37	23	2	33	17	1
15476	Internet_protocol_suite	200303	1	0	0	0	1	1	0	0	38	24	2	34	18	1
15476	Internet_protocol_suite	200304	5	0	0	0	3	1	0	0	43	26	2	36	18	1
15476	Internet_protocol_suite	200305	1	0	0	0	1	1	0	0	44	27	2	37	19	1
15476	Internet_protocol_suite	200307	3	0	0	0	3	2	0	0	47	29	2	39	20	1
15476	Internet_protocol_suite	200308	6	0	0	0	2	2	0	0	53	31	2	45	22	1
15476	Internet_protocol_suite	200309	6	0	0	0	2	2	0	0	59	32	2	51	23	1
15476	Internet_protocol_suite	200310	2	0	0	0	2	2	0	0	61	34	2	53	25	1
15476	Internet_protocol_suite	200311	1	0	0	0	1	0	0	0	62	35	2	53	25	1
15476	Internet_protocol_suite	200312	7	0	0	0	4	4	0	0	69	37	2	60	27	1
15476	Internet_protocol_suite	200401	6	0	0	0	2	2	0	0	75	39	2	66	29	1
15476	Internet_protocol_suite	200402	2	0	0	0	2	2	0	0	77	41	2	68	31	1
15476	Internet_protocol_suite	200403	3	0	0	0	2	1	0	0	80	43	2	70	32	1
15476	Internet_protocol_suite	200404	12	0	0	0	7	3	0	0	92	49	2	73	34	1
15476	Internet_protocol_suite	200405	7	0	0	0	7	4	0	0	99	55	2	77	37	1
15476	Internet_protocol_suite	200406	7	0	0	0	5	3	0	0	106	59	2	81	39	1
15476	Internet_protocol_suite	200407	5	0	0	0	5	5	0	0	111	64	2	86	43	1
15476	Internet_protocol_suite	200408	10	1	0	0	7	4	1	0	121	70	3	91	46	1
15476	Internet_protocol_suite	200409	5	0	0	0	4	1	0	0	126	74	3	92	47	1
15476	Internet_protocol_suite	200410	13	1	0	0	5	2	1	0	139	77	4	96	48	1
15476	Internet_protocol_suite	200411	8	0	0	0	6	5	0	0	147	82	4	103	52	1
15476	Internet_protocol_suite	200412	13	1	0	0	9	3	1	0	160	90	5	108	54	1
15476	Internet_protocol_suite	200501	3	0	0	0	3	3	0	0	163	92	5	111	56	1
15476	Internet_protocol_suite	200502	13	0	0	0	9	4	0	0	176	100	5	117	59	1
15476	Internet_protocol_suite	200503	13	0	0	0	7	1	0	0	189	107	5	118	60	1
15476	Internet_protocol_suite	200504	9	0	0	0	8	5	0	0	198	115	5	123	65	1
15476	Internet_protocol_suite	200505	8	0	0	0	5	3	0	0	206	120	5	127	68	1
15476	Internet_protocol_suite	200506	9	0	0	0	7	6	0	0	215	127	5	135	74	1
15476	Internet_protocol_suite	200507	28	6	0	0	22	9	5	0	243	147	11	146	81	1
15476	Internet_protocol_suite	200508	15	2	0	0	10	3	1	0	258	157	13	151	84	1
15476	Internet_protocol_suite	200509	20	0	0	0	15	7	0	0	278	172	13	161	91	1
15476	Internet_protocol_suite	200510	36	11	2	1	27	12	7	2	314	196	24	179	100	2
15476	Internet_protocol_suite	200511	35	8	0	0	27	11	5	0	349	218	32	195	106	2
15476	Internet_protocol_suite	200512	23	1	0	0	18	9	1	0	372	232	33	207	111	2
15476	Internet_protocol_suite	200601	26	2	0	0	17	8	2	0	398	248	35	223	118	2
15476	Internet_protocol_suite	200602	31	5	0	0	23	15	5	0	429	264	40	243	127	3
15476	Internet_protocol_suite	200603	25	5	0	0	21	9	5	0	454	281	45	252	133	4
15476	Internet_protocol_suite	200604	72	10	0	0	31	12	6	0	526	308	55	299	141	5
15476	Internet_protocol_suite	200605	22	3	0	0	16	10	3	0	548	323	58	309	150	5
15476	Internet_protocol_suite	200606	51	8	0	0	32	16	7	0	599	351	66	338	162	6
15476	Internet_protocol_suite	200607	28	5	0	0	19	10	5	0	627	368	71	354	170	6
15476	Internet_protocol_suite	200608	23	5	0	0	12	5	3	0	650	379	76	366	174	6
15476	Internet_protocol_suite	200609	34	8	0	0	21	10	4	0	684	398	84	384	182	7
15476	Internet_protocol_suite	200610	29	7	0	0	20	13	6	0	713	416	91	403	193	9
15476	Internet_protocol_suite	200611	28	7	0	0	20	9	5	0	741	430	98	418	196	11
15476	Internet_protocol_suite	200612	33	3	1	0	14	7	3	1	774	441	101	441	200	13
15476	Internet_protocol_suite	200701	8	1	0	0	8	6	1	0	782	447	102	447	204	13
15476	Internet_protocol_suite	200702	29	5	0	0	21	10	4	0	811	465	107	460	211	14
15476	Internet_protocol_suite	200703	22	6	0	0	17	7	4	0	833	480	113	470	216	14
15476	Internet_protocol_suite	200704	27	6	0	0	17	9	5	0	860	495	119	480	223	14
15476	Internet_protocol_suite	200705	22	4	0	0	17	9	4	0	882	511	123	490	231	14
15476	Internet_protocol_suite	200706	12	5	0	0	11	5	5	0	894	521	128	495	235	14
15476	Internet_protocol_suite	200707	6	2	0	0	6	3	2	0	900	525	130	498	236	14
15476	Internet_protocol_suite	200708	13	3	0	0	10	7	2	0	913	534	133	507	242	14
15476	Internet_protocol_suite	200709	19	4	0	0	12	6	2	0	932	543	137	517	245	14
15476	Internet_protocol_suite	200710	20	5	0	0	14	8	5	0	952	554	142	530	250	16
15476	Internet_protocol_suite	200711	34	6	0	0	20	12	6	0	986	570	148	546	258	18
15476	Internet_protocol_suite	200712	35	8	0	0	21	13	5	0	1021	589	156	572	269	21
15476	Internet_protocol_suite	200801	14	1	0	0	10	4	1	0	1035	597	157	576	271	21
15476	Internet_protocol_suite	200802	31	8	0	0	20	11	7	0	1066	612	165	596	277	23
15476	Internet_protocol_suite	200803	10	1	0	0	7	4	1	0	1076	618	166	602	280	23
15476	Internet_protocol_suite	200804	11	4	0	0	9	3	3	0	1087	625	170	606	281	23
15476	Internet_protocol_suite	200805	16	1	0	0	8	4	1	0	1103	632	171	614	284	23
15476	Internet_protocol_suite	200806	17	3	0	0	14	6	2	0	1120	646	174	621	290	23
15476	Internet_protocol_suite	200807	3	0	0	0	2	0	0	0	1123	648	174	621	290	23
15476	Internet_protocol_suite	200808	24	3	0	0	10	6	3	0	1147	657	177	640	295	24
15476	Internet_protocol_suite	200809	13	1	0	0	7	5	1	0	1160	659	178	651	295	24
15476	Internet_protocol_suite	200810	28	10	0	0	24	14	9	0	1188	680	188	667	306	24
15476	Internet_protocol_suite	200811	22	7	0	0	14	7	4	0	1210	692	195	678	311	24
15476	Internet_protocol_suite	200812	33	9	0	0	19	10	4	0	1243	708	204	697	318	26
15476	Internet_protocol_suite	200901	11	1	0	0	7	3	1	0	1254	715	205	700	321	26
15476	Internet_protocol_suite	200902	37	10	0	0	20	13	7	0	1291	731	215	725	330	30
15476	Internet_protocol_suite	200903	32	12	2	0	19	12	8	1	1323	745	227	743	337	34
15476	Internet_protocol_suite	200904	11	2	0	0	8	5	2	0	1334	750	229	749	339	34
15476	Internet_protocol_suite	200905	25	6	0	0	14	9	5	0	1359	760	235	767	344	35
15476	Internet_protocol_suite	200906	9	0	0	0	9	5	0	0	1368	767	235	772	347	35
15476	Internet_protocol_suite	200907	21	8	0	0	12	6	3	0	1389	776	243	784	350	37
15476	Internet_protocol_suite	200908	7	2	0	0	4	2	2	0	1396	778	245	786	350	37
15476	Internet_protocol_suite	200909	13	6	0	0	11	6	5	0	1409	786	251	794	353	38
15476	Internet_protocol_suite	200910	19	3	0	0	13	5	3	0	1428	797	254	799	356	38
15476	Internet_protocol_suite	200911	15	4	0	0	11	4	3	0	1443	806	258	804	358	38
15476	Internet_protocol_suite	200912	5	1	0	0	5	2	1	0	1448	810	259	806	359	38
15476	Internet_protocol_suite	201001	18	6	0	0	13	8	4	0	1466	819	265	816	363	39
15476	Internet_protocol_suite	201002	2	1	0	0	2	1	1	0	1468	820	266	817	363	39
15476	Internet_protocol_suite	201003	9	1	0	0	6	4	1	0	1477	825	267	824	366	39
15476	Internet_protocol_suite	201004	9	1	0	0	8	4	1	0	1486	832	268	828	369	39
15476	Internet_protocol_suite	201005	20	4	0	0	17	10	4	0	1506	848	272	839	378	39
15476	Internet_protocol_suite	201006	14	3	0	0	11	5	3	0	1520	856	275	844	380	39
15476	Internet_protocol_suite	201007	31	9	0	0	22	13	6	0	1551	873	284	863	388	40
15476	Internet_protocol_suite	201008	20	6	0	0	14	6	4	0	1571	884	290	872	391	40
15476	Internet_protocol_suite	201009	5	0	0	0	4	2	0	0	1576	888	290	874	393	40
15476	Internet_protocol_suite	201010	21	4	0	0	10	5	3	0	1597	896	294	880	396	41
15476	Internet_protocol_suite	201011	14	5	0	0	11	7	4	0	1611	904	299	888	400	42
15476	Internet_protocol_suite	201012	30	14	1	0	19	12	12	1	1641	919	313	902	408	45
15476	Internet_protocol_suite	201101	10	1	0	0	5	5	1	0	1651	922	314	912	411	46
15476	Internet_protocol_suite	201102	8	2	0	0	7	5	1	0	1659	928	316	918	415	46
15476	Internet_protocol_suite	201103	11	3	0	0	9	7	3	0	1670	935	319	926	420	47
15476	Internet_protocol_suite	201104	4	2	0	0	4	2	2	0	1674	937	321	928	420	47
15476	Internet_protocol_suite	201105	14	5	0	0	9	4	4	0	1688	944	326	932	422	47
15476	Internet_protocol_suite	201106	9	3	0	0	5	3	3	0	1697	948	329	935	424	47
15476	Internet_protocol_suite	201107	11	5	0	0	9	5	5	0	1708	956	334	940	428	49
15476	Internet_protocol_suite	201109	10	4	0	0	6	5	2	0	1718	961	338	948	432	51
15476	Internet_protocol_suite	201110	6	0	0	0	5	3	0	0	1724	964	338	952	433	51
15476	Internet_protocol_suite	201111	15	0	0	0	6	4	0	0	1739	968	338	957	435	51
15476	Internet_protocol_suite	201112	22	5	0	0	12	9	4	0	1761	976	343	973	441	54
15476	Internet_protocol_suite	201201	13	2	0	0	8	6	2	0	1774	981	345	980	444	55
15476	Internet_protocol_suite	201202	13	2	0	0	10	6	2	0	1787	990	347	988	449	55
15476	Internet_protocol_suite	201203	26	1	0	0	3	2	1	0	1813	992	348	1013	450	55
15476	Internet_protocol_suite	201204	6	2	0	0	5	4	2	0	1819	996	350	1017	453	56
15476	Internet_protocol_suite	201205	20	1	0	0	9	6	1	0	1839	1003	351	1033	457	56
15476	Internet_protocol_suite	201206	5	1	0	0	5	1	1	0	1844	1007	352	1034	457	56
15476	Internet_protocol_suite	201207	15	4	0	0	11	5	4	0	1859	1016	356	1043	460	56
15476	Internet_protocol_suite	201208	9	2	0	0	7	4	1	0	1868	1021	358	1049	462	56
15476	Internet_protocol_suite	201209	10	2	0	0	10	7	2	0	1878	1029	360	1056	467	56
15476	Internet_protocol_suite	201210	11	1	0	0	9	5	1	0	1889	1035	361	1061	469	56
15476	Internet_protocol_suite	201211	16	5	0	0	12	4	4	0	1905	1044	366	1068	470	56
15476	Internet_protocol_suite	201212	8	0	0	0	8	4	0	0	1913	1050	366	1072	472	56
15476	Internet_protocol_suite	201301	11	1	0	0	8	4	1	0	1924	1056	367	1076	474	56
15476	Internet_protocol_suite	201302	9	3	0	0	7	5	3	0	1933	1059	370	1082	475	56
15476	Internet_protocol_suite	201303	20	3	0	0	14	6	3	0	1953	1073	373	1089	481	57
15476	Internet_protocol_suite	201304	8	3	0	0	6	4	3	0	1961	1076	376	1093	482	58
15476	Internet_protocol_suite	201305	8	3	0	0	7	4	3	0	1969	1081	379	1097	484	59
15476	Internet_protocol_suite	201306	19	5	0	0	13	7	5	0	1988	1089	384	1106	486	59
15476	Internet_protocol_suite	201307	7	2	0	0	5	3	2	0	1995	1093	386	1111	488	59
15476	Internet_protocol_suite	201308	13	3	0	0	11	7	3	0	2008	1102	389	1118	493	59
15476	Internet_protocol_suite	201309	8	3	0	0	6	3	2	0	2016	1106	392	1123	494	59
15476	Internet_protocol_suite	201310	7	2	0	0	7	5	2	0	2023	1108	394	1128	494	59
15476	Internet_protocol_suite	201311	16	4	0	0	11	6	4	0	2039	1114	398	1135	495	60
15476	Internet_protocol_suite	201312	15	8	1	0	12	7	7	1	2054	1124	406	1143	499	61
15476	Internet_protocol_suite	201401	9	3	0	0	8	4	3	0	2063	1131	409	1147	502	62
15476	Internet_protocol_suite	201402	12	4	0	0	12	7	4	0	2075	1138	413	1154	502	64
15476	Internet_protocol_suite	201403	16	6	0	0	12	6	5	0	2091	1147	419	1161	505	65
15476	Internet_protocol_suite	201404	27	6	0	0	11	7	5	0	2118	1155	425	1173	509	67
15476	Internet_protocol_suite	201405	24	5	0	0	14	6	4	0	2142	1166	430	1181	512	67
15476	Internet_protocol_suite	201406	4	1	0	0	4	3	1	0	2146	1168	431	1184	513	67
15476	Internet_protocol_suite	201407	16	5	0	0	12	6	4	0	2162	1178	436	1191	517	68
15476	Internet_protocol_suite	201408	4	1	0	0	4	1	1	0	2166	1181	437	1192	517	68
15476	Internet_protocol_suite	201409	4	0	0	0	3	3	0	0	2170	1184	437	1196	520	68
15476	Internet_protocol_suite	201410	12	5	0	0	8	5	4	0	2182	1190	442	1204	523	70
15476	Internet_protocol_suite	201411	16	6	0	0	12	7	4	0	2198	1201	448	1214	529	73
15476	Internet_protocol_suite	201412	7	3	0	0	6	3	3	0	2205	1204	451	1217	529	73
15476	Internet_protocol_suite	201501	6	2	0	0	5	2	2	0	2211	1208	453	1219	530	73
15476	Internet_protocol_suite	201502	7	2	0	0	4	2	2	0	2218	1209	455	1221	530	73
15476	Internet_protocol_suite	201503	11	2	0	0	7	5	2	0	2229	1213	457	1227	532	73
15476	Internet_protocol_suite	201504	6	2	0	0	5	3	2	0	2235	1217	459	1230	534	73
15476	Internet_protocol_suite	201505	8	2	0	0	5	3	1	0	2243	1221	461	1236	536	73
15476	Internet_protocol_suite	201506	8	0	0	0	3	2	0	0	2251	1222	461	1243	536	73
15476	Internet_protocol_suite	201507	1	0	0	0	1	0	0	0	2252	1223	461	1243	536	73
15476	Internet_protocol_suite	201508	1	0	0	0	1	1	0	0	2253	1224	461	1244	537	73
15476	Internet_protocol_suite	201509	19	7	0	0	15	8	6	0	2272	1234	468	1253	539	73
15476	Internet_protocol_suite	201510	15	4	0	0	11	3	3	0	2287	1242	472	1257	539	73
15476	Internet_protocol_suite	201511	23	7	0	0	14	8	5	0	2310	1252	479	1268	543	74
15476	Internet_protocol_suite	201512	3	1	0	0	3	1	1	0	2313	1254	480	1269	543	74
15476	Internet_protocol_suite	201601	9	0	0	0	4	1	0	0	2322	1257	480	1271	543	74
15476	Internet_protocol_suite	201602	11	5	0	0	10	5	5	0	2333	1264	485	1276	545	74
15476	Internet_protocol_suite	201603	14	5	0	0	11	6	4	0	2347	1272	490	1283	549	74
15476	Internet_protocol_suite	201604	7	2	0	0	5	1	1	0	2354	1276	492	1285	549	74
15476	Internet_protocol_suite	201605	13	3	0	0	11	8	3	0	2367	1283	495	1295	551	76
15476	Internet_protocol_suite	201606	2	0	0	0	2	2	0	0	2369	1283	495	1297	551	76
15476	Internet_protocol_suite	201607	4	1	0	0	4	3	1	0	2373	1287	496	1300	553	77
15476	Internet_protocol_suite	201608	5	0	0	0	3	1	0	0	2378	1289	496	1301	553	77
15476	Internet_protocol_suite	201609	6	0	0	0	5	3	0	0	2384	1291	496	1304	553	77
15476	Internet_protocol_suite	201610	14	1	0	0	9	7	1	0	2398	1298	497	1316	558	77
15476	Internet_protocol_suite	201611	20	7	0	0	14	8	5	0	2418	1307	504	1327	561	77
15476	Internet_protocol_suite	201612	20	2	0	0	12	7	2	0	2438	1315	506	1340	564	77
15476	Internet_protocol_suite	201701	16	5	0	0	11	4	3	0	2454	1324	511	1347	566	77
15476	Internet_protocol_suite	201702	14	7	0	0	12	7	6	0	2468	1332	518	1355	569	78
15476	Internet_protocol_suite	201703	3	1	0	0	3	3	1	0	2471	1334	519	1358	571	79
15476	Internet_protocol_suite	201704	4	2	0	0	4	2	2	0	2475	1336	521	1360	571	79
15476	Internet_protocol_suite	201705	2	1	0	0	2	1	1	0	2477	1337	522	1361	571	79
15476	Internet_protocol_suite	201706	12	5	0	0	10	7	5	0	2489	1344	527	1368	575	80
15476	Internet_protocol_suite	201707	2	0	0	0	2	1	0	0	2491	1346	527	1369	576	80
15476	Internet_protocol_suite	201708	10	4	0	0	8	5	3	0	2501	1351	531	1375	578	81
15476	Internet_protocol_suite	201709	22	7	0	0	12	7	5	0	2523	1359	538	1386	581	81
15476	Internet_protocol_suite	201710	11	3	0	0	7	6	2	0	2534	1364	541	1396	585	83
15476	Internet_protocol_suite	201711	3	1	0	0	3	2	1	0	2537	1365	542	1398	585	83
15476	Internet_protocol_suite	201712	4	1	0	0	4	3	1	0	2541	1367	543	1401	586	83
15476	Internet_protocol_suite	201801	3	1	0	0	3	3	1	0	2544	1368	544	1404	587	84
15476	Internet_protocol_suite	201802	7	1	0	0	6	6	1	0	2551	1372	545	1411	590	85
15476	Internet_protocol_suite	201803	4	1	0	0	4	2	1	0	2555	1375	546	1413	591	85
15476	Internet_protocol_suite	201804	3	1	0	0	3	2	1	0	2558	1377	547	1415	592	85
15476	Internet_protocol_suite	201805	4	2	0	0	4	2	2	0	2562	1380	549	1417	593	85
15476	Internet_protocol_suite	201806	5	1	0	0	5	5	1	0	2567	1384	550	1422	596	86
15476	Internet_protocol_suite	201807	6	1	0	0	5	5	1	0	2573	1388	551	1428	600	87
100245	Internet_service_provider	200211	3	0	0	0	3	3	0	0	3	3	0	3	3	0
100245	Internet_service_provider	200212	1	0	0	0	1	1	0	0	4	4	0	4	4	0
100245	Internet_service_provider	200303	6	0	0	0	2	2	0	0	10	5	0	10	5	0
100245	Internet_service_provider	200305	2	0	0	0	2	2	0	0	12	7	0	12	7	0
100245	Internet_service_provider	200308	1	0	0	0	1	1	0	0	13	8	0	13	8	0
100245	Internet_service_provider	200309	2	1	0	0	2	2	1	0	15	10	1	15	10	1
100245	Internet_service_provider	200310	2	0	0	0	2	0	0	0	17	12	1	15	10	1
100245	Internet_service_provider	200311	2	0	0	0	2	2	0	0	19	13	1	17	11	1
100245	Internet_service_provider	200312	1	0	0	0	1	0	0	0	20	14	1	17	11	1
100245	Internet_service_provider	200402	1	0	0	0	1	0	0	0	21	15	1	17	11	1
100245	Internet_service_provider	200403	3	0	0	0	2	2	0	0	24	17	1	20	13	1
100245	Internet_service_provider	200404	1	0	0	0	1	1	0	0	25	18	1	21	14	1
100245	Internet_service_provider	200405	1	0	0	0	1	1	0	0	26	19	1	22	15	1
100245	Internet_service_provider	200406	1	0	0	0	1	1	0	0	27	20	1	23	16	1
100245	Internet_service_provider	200407	4	0	0	0	4	2	0	0	31	24	1	25	18	1
100245	Internet_service_provider	200408	4	0	0	0	4	3	0	0	35	28	1	28	21	1
100245	Internet_service_provider	200409	1	0	0	0	1	0	0	0	36	29	1	28	21	1
100245	Internet_service_provider	200410	4	1	0	0	4	2	1	0	40	33	2	30	23	1
100245	Internet_service_provider	200411	1	0	0	0	1	1	0	0	41	34	2	31	24	1
100245	Internet_service_provider	200412	4	0	0	0	4	4	0	0	45	38	2	35	28	1
100245	Internet_service_provider	200501	5	0	0	0	4	2	0	0	50	42	2	37	30	1
100245	Internet_service_provider	200502	11	1	0	0	8	3	1	0	61	50	3	43	33	2
100245	Internet_service_provider	200503	6	0	0	0	6	2	0	0	67	56	3	45	35	2
100245	Internet_service_provider	200504	3	0	0	0	2	1	0	0	70	58	3	46	36	2
100245	Internet_service_provider	200505	9	0	0	0	8	4	0	0	79	66	3	50	40	2
100245	Internet_service_provider	200506	16	0	0	0	9	4	0	0	95	74	3	55	43	2
100245	Internet_service_provider	200507	9	1	0	0	9	5	1	0	104	82	4	60	47	2
100245	Internet_service_provider	200508	12	1	0	0	7	4	1	0	116	89	5	68	51	2
100245	Internet_service_provider	200509	13	2	0	0	11	5	2	0	129	97	7	73	55	2
100245	Internet_service_provider	200510	49	17	4	0	28	5	10	2	178	124	24	78	60	3
100245	Internet_service_provider	200511	38	5	0	0	26	3	5	0	216	147	29	85	62	3
100245	Internet_service_provider	200512	103	43	11	3	39	5	12	3	319	184	72	135	66	14
100245	Internet_service_provider	200601	16	5	0	0	11	8	5	0	335	194	77	144	73	14
100245	Internet_service_provider	200602	26	2	0	0	21	16	2	0	361	214	79	162	88	14
100245	Internet_service_provider	200603	1	0	0	0	1	1	0	0	362	215	79	163	89	14
100245	Internet_service_provider	200604	15	2	0	0	13	6	2	0	377	227	81	170	94	14
100245	Internet_service_provider	200605	20	5	0	0	15	7	5	0	397	241	86	179	100	14
100245	Internet_service_provider	200606	15	2	0	0	13	5	2	0	412	253	88	184	104	14
100245	Internet_service_provider	200607	26	2	0	0	17	8	2	0	438	269	90	194	111	14
100245	Internet_service_provider	200608	20	2	0	0	16	4	2	0	458	283	92	198	114	14
100245	Internet_service_provider	200609	47	9	0	0	28	12	8	0	505	309	101	220	124	14
100245	Internet_service_provider	200610	55	11	0	0	26	9	5	0	560	334	112	243	132	14
100245	Internet_service_provider	200611	22	5	0	0	17	9	5	0	582	349	117	253	141	15
100245	Internet_service_provider	200612	17	7	0	0	14	7	6	0	599	359	124	261	145	16
100245	Internet_service_provider	200701	22	2	0	0	9	4	2	0	621	367	126	265	148	16
100245	Internet_service_provider	200702	15	2	0	0	11	4	2	0	636	378	128	269	152	16
100245	Internet_service_provider	200703	19	7	0	0	18	10	7	0	655	396	135	279	162	17
100245	Internet_service_provider	200704	26	4	0	0	17	7	4	0	681	412	139	286	168	17
100245	Internet_service_provider	200705	37	8	0	0	24	12	8	0	718	433	147	299	177	17
100245	Internet_service_provider	200706	11	5	0	0	7	3	3	0	729	438	152	304	178	18
100245	Internet_service_provider	200707	11	4	0	0	11	4	4	0	740	449	156	308	182	18
100245	Internet_service_provider	200708	4	1	0	0	4	1	1	0	744	453	157	309	183	18
100245	Internet_service_provider	200709	16	3	0	0	11	5	3	0	760	463	160	314	187	19
100245	Internet_service_provider	200710	25	7	0	0	20	10	7	0	785	480	167	324	194	20
100245	Internet_service_provider	200711	35	5	0	0	23	10	5	0	820	502	172	339	203	20
100245	Internet_service_provider	200712	7	2	0	0	7	4	2	0	827	507	174	343	205	20
100245	Internet_service_provider	200801	7	2	0	0	5	2	2	0	834	511	176	346	206	20
100245	Internet_service_provider	200802	21	3	0	0	16	9	3	0	855	526	179	360	214	21
100245	Internet_service_provider	200803	12	4	0	0	11	5	3	0	867	534	183	366	216	21
100245	Internet_service_provider	200804	13	3	0	0	8	4	2	0	880	540	186	371	218	21
100245	Internet_service_provider	200805	13	3	0	0	11	5	3	0	893	549	189	376	221	21
100245	Internet_service_provider	200806	13	5	0	0	10	5	4	0	906	556	194	382	223	21
100245	Internet_service_provider	200807	18	8	0	0	18	8	8	0	924	572	202	390	229	21
100245	Internet_service_provider	200808	55	9	0	0	21	13	8	0	979	589	211	404	238	23
100245	Internet_service_provider	200809	18	7	0	0	14	8	6	0	997	601	218	413	244	23
100245	Internet_service_provider	200810	20	9	0	0	16	8	8	0	1017	614	227	422	249	23
100245	Internet_service_provider	200811	14	3	0	0	10	4	2	0	1031	623	230	427	252	23
100245	Internet_service_provider	200812	8	4	0	0	8	6	4	0	1039	630	234	433	257	25
100245	Internet_service_provider	200901	17	1	0	0	6	3	1	0	1056	636	235	439	260	25
100245	Internet_service_provider	200902	28	11	0	0	19	9	8	0	1084	654	246	454	268	25
100245	Internet_service_provider	200903	6	3	0	0	6	4	3	0	1090	657	249	458	269	26
100245	Internet_service_provider	200904	8	4	0	0	8	4	4	0	1098	662	253	462	270	26
100245	Internet_service_provider	200905	7	3	0	0	6	3	2	0	1105	666	256	466	271	26
100245	Internet_service_provider	200906	11	3	0	0	10	5	3	0	1116	675	259	471	275	26
100245	Internet_service_provider	200907	4	1	0	0	4	3	1	0	1120	678	260	474	277	26
100245	Internet_service_provider	200908	13	3	0	0	9	7	2	0	1133	685	263	483	282	27
100245	Internet_service_provider	200909	7	3	0	0	7	5	3	0	1140	688	266	488	284	28
100245	Internet_service_provider	200910	15	6	0	0	10	6	4	0	1155	696	272	496	288	29
100245	Internet_service_provider	200911	24	13	3	1	16	10	9	3	1179	710	285	510	296	33
100245	Internet_service_provider	200912	15	4	0	0	14	10	4	0	1194	720	289	521	302	34
100245	Internet_service_provider	201001	11	3	0	0	8	3	2	0	1205	727	292	525	304	34
100245	Internet_service_provider	201002	10	5	0	0	8	4	4	0	1215	733	297	530	306	34
100245	Internet_service_provider	201003	18	4	0	0	7	4	3	0	1233	737	301	540	308	36
100245	Internet_service_provider	201004	13	4	0	0	10	4	3	0	1246	746	305	545	311	36
100245	Internet_service_provider	201005	25	3	0	0	16	8	3	0	1271	758	308	558	315	36
100245	Internet_service_provider	201006	7	1	0	0	6	5	1	0	1278	763	309	563	319	37
100245	Internet_service_provider	201008	5	1	0	0	4	4	1	0	1283	766	310	568	322	38
100245	Internet_service_provider	201009	6	2	0	0	6	3	2	0	1289	771	312	571	324	38
100245	Internet_service_provider	201010	24	9	1	0	18	11	9	1	1313	787	321	583	333	42
100245	Internet_service_provider	201011	17	6	0	0	15	9	6	0	1330	800	327	592	340	43
100245	Internet_service_provider	201012	17	6	0	0	12	8	5	0	1347	810	333	605	346	46
100245	Internet_service_provider	201101	11	7	2	0	8	5	6	1	1358	814	340	610	347	48
100245	Internet_service_provider	201102	3	0	0	0	3	2	0	0	1361	816	340	612	348	48
100245	Internet_service_provider	201103	7	2	0	0	7	3	2	0	1368	822	342	615	350	48
100245	Internet_service_provider	201104	20	5	0	0	12	4	3	0	1388	832	347	622	352	48
100245	Internet_service_provider	201105	6	1	0	0	5	4	1	0	1394	837	348	627	356	48
100245	Internet_service_provider	201106	7	2	0	0	3	1	1	0	1401	839	350	629	356	48
100245	Internet_service_provider	201107	7	3	0	0	6	4	3	0	1408	844	353	633	359	49
100245	Internet_service_provider	201108	8	1	0	0	6	5	1	0	1416	850	354	640	364	49
100245	Internet_service_provider	201109	16	3	0	0	9	6	3	0	1432	856	357	646	367	50
100245	Internet_service_provider	201110	8	1	0	0	7	5	1	0	1440	861	358	651	370	50
100245	Internet_service_provider	201111	14	4	0	0	9	5	4	0	1454	867	362	656	372	50
100245	Internet_service_provider	201112	8	1	0	0	8	5	1	0	1462	873	363	661	375	50
100245	Internet_service_provider	201201	7	3	0	0	7	5	3	0	1469	879	366	666	379	51
100245	Internet_service_provider	201202	13	1	0	0	8	7	1	0	1482	886	367	678	385	51
100245	Internet_service_provider	201203	3	1	0	0	3	1	1	0	1485	889	368	679	386	51
100245	Internet_service_provider	201204	6	3	0	0	6	3	3	0	1491	893	371	682	387	51
100245	Internet_service_provider	201205	3	1	0	0	3	2	1	0	1494	896	372	684	389	51
100245	Internet_service_provider	201206	14	3	0	0	11	7	2	0	1508	905	375	693	394	52
100245	Internet_service_provider	201207	9	2	0	0	6	4	2	0	1517	909	377	698	396	52
100245	Internet_service_provider	201208	6	2	0	0	6	3	2	0	1523	913	379	701	397	52
100245	Internet_service_provider	201209	11	1	0	0	7	4	1	0	1534	917	380	709	398	52
100245	Internet_service_provider	201210	9	3	0	0	7	2	2	0	1543	922	383	712	398	52
100245	Internet_service_provider	201211	10	3	0	0	8	6	3	0	1553	928	386	720	402	53
100245	Internet_service_provider	201212	15	7	0	0	12	6	5	0	1568	938	393	728	406	53
100245	Internet_service_provider	201301	6	2	0	0	6	3	2	0	1574	942	395	731	407	53
100245	Internet_service_provider	201302	11	5	0	0	9	5	3	0	1585	950	400	738	411	55
100245	Internet_service_provider	201303	22	9	0	0	13	7	6	0	1607	959	409	748	414	55
100245	Internet_service_provider	201304	17	6	0	0	11	8	6	0	1624	966	415	757	418	56
100245	Internet_service_provider	201305	8	0	0	0	3	3	0	0	1632	968	415	765	420	56
100245	Internet_service_provider	201306	1	0	0	0	1	1	0	0	1633	968	415	766	420	56
100245	Internet_service_provider	201307	6	3	0	0	5	4	3	0	1639	972	418	771	423	58
100245	Internet_service_provider	201308	15	3	0	0	10	6	3	0	1654	981	421	782	428	58
100245	Internet_service_provider	201309	4	1	0	0	3	2	1	0	1658	984	422	785	430	58
100245	Internet_service_provider	201310	12	4	0	0	6	4	2	0	1670	989	426	792	433	58
100245	Internet_service_provider	201311	21	6	0	0	14	8	5	0	1691	998	432	801	436	59
100245	Internet_service_provider	201312	18	8	0	0	8	4	4	0	1709	1005	440	809	439	59
100245	Internet_service_provider	201401	11	5	0	0	7	4	5	0	1720	1011	445	813	442	60
100245	Internet_service_provider	201402	13	2	0	0	12	6	2	0	1733	1021	447	820	446	60
100245	Internet_service_provider	201403	5	2	0	0	4	3	2	0	1738	1024	449	823	448	60
100245	Internet_service_provider	201404	17	7	1	0	9	7	6	1	1755	1028	456	836	450	63
100245	Internet_service_provider	201405	25	7	0	0	14	10	5	0	1780	1038	463	857	456	67
100245	Internet_service_provider	201406	6	0	0	0	5	3	0	0	1786	1042	463	860	458	67
100245	Internet_service_provider	201408	4	1	0	0	4	2	1	0	1790	1046	464	862	460	67
100245	Internet_service_provider	201409	8	3	0	0	8	4	3	0	1798	1054	467	866	463	67
100245	Internet_service_provider	201410	12	6	0	0	11	7	6	0	1810	1060	473	873	465	68
100245	Internet_service_provider	201411	2	1	0	0	2	1	1	0	1812	1061	474	874	465	68
100245	Internet_service_provider	201412	5	2	0	0	5	2	2	0	1817	1064	476	876	465	68
100245	Internet_service_provider	201501	10	2	0	0	10	7	2	0	1827	1071	478	883	468	69
100245	Internet_service_provider	201502	7	2	0	0	6	2	2	0	1834	1075	480	885	468	69
100245	Internet_service_provider	201503	23	3	1	0	9	7	3	1	1857	1082	483	904	473	70
100245	Internet_service_provider	201504	22	8	3	2	9	5	4	2	1879	1088	491	915	475	71
100245	Internet_service_provider	201505	10	2	0	0	8	7	2	0	1889	1095	493	924	480	72
100245	Internet_service_provider	201506	2	0	0	0	1	0	0	0	1891	1096	493	924	480	72
100245	Internet_service_provider	201507	9	4	0	0	6	4	3	0	1900	1101	497	929	483	72
100245	Internet_service_provider	201508	7	2	0	0	7	2	2	0	1907	1108	499	931	485	72
100245	Internet_service_provider	201509	3	1	0	0	3	2	1	0	1910	1110	500	933	486	72
100245	Internet_service_provider	201510	6	2	0	0	6	4	2	0	1916	1114	502	937	488	72
100245	Internet_service_provider	201511	2	1	0	0	2	0	1	0	1918	1116	503	937	488	72
100245	Internet_service_provider	201512	6	3	0	0	6	3	3	0	1924	1121	506	940	490	72
100245	Internet_service_provider	201601	4	2	0	0	4	2	2	0	1928	1124	508	942	491	72
100245	Internet_service_provider	201602	16	7	2	0	12	9	6	2	1944	1134	515	954	497	76
100245	Internet_service_provider	201603	7	0	0	0	7	4	0	0	1951	1140	515	958	500	76
100245	Internet_service_provider	201604	7	4	1	0	6	4	4	1	1958	1144	519	962	502	77
100245	Internet_service_provider	201605	10	5	0	0	7	4	3	0	1968	1149	524	968	504	78
100245	Internet_service_provider	201606	10	4	0	0	9	4	3	0	1978	1156	528	973	506	78
100245	Internet_service_provider	201607	12	4	0	0	10	7	3	0	1990	1164	532	981	511	79
100245	Internet_service_provider	201608	4	2	0	0	3	2	2	0	1994	1166	534	983	512	79
100245	Internet_service_provider	201609	11	2	0	0	8	6	2	0	2005	1172	536	990	516	80
100245	Internet_service_provider	201610	7	2	0	0	7	4	2	0	2012	1178	538	994	519	80
100245	Internet_service_provider	201611	8	3	0	0	7	5	3	0	2020	1184	541	1000	523	81
100245	Internet_service_provider	201701	10	4	0	0	10	5	4	0	2030	1194	545	1005	528	81
100245	Internet_service_provider	201702	10	4	0	0	8	5	4	0	2040	1202	549	1010	532	82
100245	Internet_service_provider	201703	13	6	0	0	12	9	5	0	2053	1211	555	1020	537	85
100245	Internet_service_provider	201704	3	1	0	0	3	3	1	0	2056	1212	556	1023	537	86
100245	Internet_service_provider	201705	6	2	0	0	5	4	1	0	2062	1216	558	1028	539	87
100245	Internet_service_provider	201706	9	3	0	0	9	6	3	0	2071	1222	561	1034	540	88
100245	Internet_service_provider	201707	9	4	0	0	7	4	3	0	2080	1227	565	1039	542	88
100245	Internet_service_provider	201708	3	1	0	0	3	2	1	0	2083	1230	566	1041	544	88
100245	Internet_service_provider	201709	19	7	0	0	10	9	5	0	2102	1237	573	1057	549	92
100245	Internet_service_provider	201710	6	1	0	0	5	4	1	0	2108	1241	574	1062	552	92
100245	Internet_service_provider	201711	12	5	0	0	9	7	4	0	2120	1248	579	1072	556	95
100245	Internet_service_provider	201712	6	1	0	0	5	3	1	0	2126	1252	580	1076	558	95
100245	Internet_service_provider	201801	7	2	0	0	4	3	2	0	2133	1255	582	1080	559	96
100245	Internet_service_provider	201802	5	2	0	0	4	3	1	0	2138	1257	584	1084	559	97
100245	Internet_service_provider	201803	2	1	0	0	2	1	1	0	2140	1258	585	1085	559	97
100245	Internet_service_provider	201804	13	3	0	0	8	5	2	0	2153	1264	588	1094	561	99
100245	Internet_service_provider	201805	7	3	0	0	6	4	3	0	2160	1270	591	1098	564	100
100245	Internet_service_provider	201806	7	3	0	0	7	6	3	0	2167	1275	594	1104	566	102
100245	Internet_service_provider	201807	7	2	0	0	6	4	2	0	2174	1280	596	1109	568	103
856845	Internet_traffic	200510	2	0	0	0	1	1	0	0	2	1	0	2	1	0
856845	Internet_traffic	200511	4	0	0	0	1	1	0	0	6	2	0	6	2	0
856845	Internet_traffic	200512	2	1	0	0	2	1	1	0	8	3	1	7	2	0
856845	Internet_traffic	200601	4	2	0	0	4	2	2	0	12	6	3	9	3	0
856845	Internet_traffic	200602	7	0	0	0	3	1	0	0	19	9	3	12	4	0
856845	Internet_traffic	200603	2	1	0	0	2	1	1	0	21	11	4	13	5	0
856845	Internet_traffic	200604	2	1	0	0	2	1	1	0	23	13	5	14	6	0
856845	Internet_traffic	200605	1	0	0	0	1	0	0	0	24	14	5	14	6	0
856845	Internet_traffic	200612	1	0	0	0	1	1	0	0	25	15	5	15	7	0
856845	Internet_traffic	200702	1	0	0	0	1	1	0	0	26	16	5	16	8	0
856845	Internet_traffic	200704	2	1	0	0	2	1	1	0	28	18	6	17	9	0
856845	Internet_traffic	200705	2	0	0	0	1	1	0	0	30	19	6	19	10	0
856845	Internet_traffic	200709	2	1	0	0	2	1	1	0	32	20	7	20	10	0
856845	Internet_traffic	200710	1	0	0	0	1	0	0	0	33	21	7	20	10	0
856845	Internet_traffic	200711	5	3	2	1	2	1	2	2	38	23	10	22	11	1
856845	Internet_traffic	200807	1	1	0	0	1	1	1	0	39	24	11	23	12	1
856845	Internet_traffic	200808	1	0	0	0	1	1	0	0	40	25	11	24	13	1
856845	Internet_traffic	200810	3	0	0	0	1	1	0	0	43	25	11	27	13	1
856845	Internet_traffic	200811	4	1	0	0	4	3	1	0	47	29	12	30	16	1
856845	Internet_traffic	200812	1	1	0	0	1	1	1	0	48	30	13	31	17	2
856845	Internet_traffic	200902	4	0	0	0	2	1	0	0	52	32	13	34	18	2
856845	Internet_traffic	200903	1	0	0	0	1	1	0	0	53	33	13	35	19	2
856845	Internet_traffic	200904	5	1	0	0	4	4	1	0	58	36	14	40	22	3
856845	Internet_traffic	200906	5	2	0	0	4	3	2	0	63	40	16	44	25	4
856845	Internet_traffic	200907	4	0	0	0	3	2	0	0	67	43	16	47	27	4
856845	Internet_traffic	200909	2	0	0	0	2	2	0	0	69	44	16	49	28	4
856845	Internet_traffic	200910	2	1	0	0	2	1	1	0	71	46	17	50	29	4
856845	Internet_traffic	200912	1	0	0	0	1	0	0	0	72	47	17	50	29	4
856845	Internet_traffic	201002	3	0	0	0	1	0	0	0	75	48	17	50	29	4
856845	Internet_traffic	201003	6	1	0	0	5	2	1	0	81	52	18	52	30	4
856845	Internet_traffic	201004	4	2	0	0	4	4	2	0	85	55	20	56	33	6
856845	Internet_traffic	201005	4	1	0	0	3	1	1	0	89	58	21	57	34	6
856845	Internet_traffic	201006	12	6	1	0	5	3	2	1	101	61	27	65	36	8
856845	Internet_traffic	201007	2	1	0	0	2	1	1	0	103	62	28	66	36	8
856845	Internet_traffic	201009	5	2	0	0	5	2	2	0	108	67	30	68	38	8
856845	Internet_traffic	201011	2	1	0	0	2	1	1	0	110	68	31	69	38	8
856845	Internet_traffic	201012	1	0	0	0	1	1	0	0	111	69	31	70	39	8
856845	Internet_traffic	201101	5	1	0	0	2	2	1	0	116	71	32	75	41	9
856845	Internet_traffic	201102	2	1	0	0	2	1	1	0	118	72	33	76	41	9
856845	Internet_traffic	201103	5	0	0	0	3	2	0	0	123	75	33	79	43	9
856845	Internet_traffic	201106	2	0	0	0	2	1	0	0	125	77	33	80	44	9
856845	Internet_traffic	201107	1	0	0	0	1	0	0	0	126	78	33	80	44	9
856845	Internet_traffic	201111	2	1	0	0	2	0	1	0	128	80	34	80	44	9
856845	Internet_traffic	201112	2	1	0	0	2	1	1	0	130	81	35	81	44	9
856845	Internet_traffic	201201	1	0	0	0	1	0	0	0	131	82	35	81	44	9
856845	Internet_traffic	201202	2	1	0	0	2	1	1	0	133	84	36	82	45	9
856845	Internet_traffic	201203	5	2	0	0	5	2	2	0	138	89	38	84	47	9
856845	Internet_traffic	201204	2	0	0	0	2	1	0	0	140	90	38	85	47	9
856845	Internet_traffic	201210	11	1	0	0	5	2	1	0	151	94	39	90	48	9
856845	Internet_traffic	201303	2	0	0	0	2	1	0	0	153	96	39	91	49	9
856845	Internet_traffic	201304	1	0	0	0	1	1	0	0	154	97	39	92	50	9
856845	Internet_traffic	201309	1	0	0	0	1	1	0	0	155	98	39	93	51	9
856845	Internet_traffic	201310	1	0	0	0	1	1	0	0	156	99	39	94	52	9
856845	Internet_traffic	201312	4	0	0	0	2	1	0	0	160	101	39	95	53	9
856845	Internet_traffic	201401	2	1	0	0	2	1	1	0	162	102	40	96	53	9
856845	Internet_traffic	201402	3	1	0	0	2	1	1	0	165	104	41	97	54	9
856845	Internet_traffic	201403	2	1	0	0	2	1	1	0	167	106	42	98	55	9
856845	Internet_traffic	201409	2	1	0	0	2	2	1	0	169	108	43	100	57	10
856845	Internet_traffic	201410	2	1	0	0	2	2	1	0	171	109	44	102	58	11
856845	Internet_traffic	201411	31	0	0	0	1	1	0	0	202	110	44	133	59	11
856845	Internet_traffic	201412	7	0	0	0	5	3	0	0	209	115	44	138	62	11
856845	Internet_traffic	201501	2	1	0	0	2	2	1	0	211	117	45	140	64	12
856845	Internet_traffic	201502	3	0	0	0	3	2	0	0	214	120	45	142	66	12
856845	Internet_traffic	201504	9	0	0	0	5	3	0	0	223	123	45	148	67	12
856845	Internet_traffic	201511	3	0	0	0	2	2	0	0	226	125	45	151	69	12
856845	Internet_traffic	201512	1	0	0	0	1	1	0	0	227	126	45	152	70	12
856845	Internet_traffic	201601	1	0	0	0	1	1	0	0	228	127	45	153	71	12
856845	Internet_traffic	201604	5	1	0	0	3	2	1	0	233	130	46	157	73	12
856845	Internet_traffic	201606	5	2	0	0	5	3	2	0	238	134	48	160	75	12
856845	Internet_traffic	201607	5	1	0	0	5	5	1	0	243	138	49	165	79	13
856845	Internet_traffic	201608	1	0	0	0	1	1	0	0	244	139	49	166	80	13
856845	Internet_traffic	201609	3	0	0	0	2	0	0	0	247	141	49	166	80	13
856845	Internet_traffic	201612	3	1	0	0	3	2	1	0	250	143	50	168	81	13
856845	Internet_traffic	201701	2	0	0	0	2	1	0	0	252	145	50	169	82	13
856845	Internet_traffic	201704	1	0	0	0	1	1	0	0	253	146	50	170	83	13
856845	Internet_traffic	201708	1	0	0	0	1	1	0	0	254	147	50	171	84	13
856845	Internet_traffic	201710	4	0	0	0	3	2	0	0	258	148	50	173	85	13
856845	Internet_traffic	201711	1	0	0	0	1	1	0	0	259	149	50	174	86	13
856845	Internet_traffic	201712	1	0	0	0	1	1	0	0	260	150	50	175	87	13
856845	Internet_traffic	201803	1	0	0	0	1	0	0	0	261	151	50	175	87	13
856845	Internet_traffic	201807	1	0	0	0	1	1	0	0	262	152	50	176	88	13
1575082	JSON	200504	13	0	0	0	3	3	0	0	13	3	0	13	3	0
1575082	JSON	200505	8	0	0	0	3	1	0	0	21	6	0	16	4	0
1575082	JSON	200506	2	0	0	0	2	0	0	0	23	8	0	16	4	0
1575082	JSON	200507	10	1	0	0	5	1	1	0	33	13	1	17	5	0
1575082	JSON	200508	5	0	0	0	2	0	0	0	38	15	1	17	5	0
1575082	JSON	200509	12	0	0	0	9	4	0	0	50	24	1	21	9	0
1575082	JSON	200510	7	0	0	0	4	0	0	0	57	28	1	21	9	0
1575082	JSON	200511	3	0	0	0	2	0	0	0	60	30	1	21	9	0
1575082	JSON	200512	12	0	0	0	12	7	0	0	72	42	1	28	16	0
1575082	JSON	200601	9	0	0	0	8	6	0	0	81	48	1	35	20	0
1575082	JSON	200602	12	2	0	0	9	4	2	0	93	55	3	41	22	0
1575082	JSON	200603	20	3	0	0	10	2	1	0	113	64	6	48	23	0
1575082	JSON	200604	5	0	0	0	5	1	0	0	118	69	6	49	24	0
1575082	JSON	200605	21	2	0	0	9	5	1	0	139	75	8	61	27	0
1575082	JSON	200606	18	0	0	0	14	8	0	0	157	88	8	73	34	0
1575082	JSON	200607	14	1	0	0	7	5	1	0	171	94	9	81	38	0
1575082	JSON	200608	18	0	0	0	15	2	0	0	189	109	9	83	40	0
1575082	JSON	200609	25	0	0	0	6	3	0	0	214	115	9	86	43	0
1575082	JSON	200610	9	0	0	0	7	5	0	0	223	122	9	91	48	0
1575082	JSON	200611	7	0	0	0	6	3	0	0	230	128	9	94	51	0
1575082	JSON	200612	18	0	0	0	16	9	0	0	248	142	9	103	58	0
1575082	JSON	200701	29	4	0	0	13	9	3	0	277	154	13	122	66	1
1575082	JSON	200702	13	0	0	0	12	8	0	0	290	163	13	131	71	1
1575082	JSON	200703	11	0	0	0	9	6	0	0	301	170	13	139	75	1
1575082	JSON	200704	28	4	0	0	15	6	2	0	329	182	17	150	79	2
1575082	JSON	200705	14	1	0	0	7	4	1	0	343	188	18	160	82	2
1575082	JSON	200706	4	0	0	0	3	2	0	0	347	191	18	163	84	2
1575082	JSON	200707	21	2	0	0	15	5	2	0	368	204	20	168	87	2
1575082	JSON	200708	15	0	0	0	13	6	0	0	383	217	20	175	93	2
1575082	JSON	200709	10	2	0	0	8	4	2	0	393	223	22	179	95	3
1575082	JSON	200710	28	1	0	0	13	5	1	0	421	233	23	185	98	3
1575082	JSON	200711	17	1	0	0	9	2	1	0	438	240	24	187	99	3
1575082	JSON	200712	18	2	0	0	10	5	2	0	456	247	26	195	102	4
1575082	JSON	200801	8	1	0	0	8	4	1	0	464	253	27	199	105	4
1575082	JSON	200802	19	1	0	0	12	6	1	0	483	264	28	206	110	4
1575082	JSON	200803	12	3	0	0	11	6	3	0	495	274	31	212	115	4
1575082	JSON	200804	10	1	0	0	8	3	1	0	505	280	32	215	116	4
1575082	JSON	200805	19	1	0	0	12	4	1	0	524	287	33	222	116	4
1575082	JSON	200806	9	1	0	0	8	3	1	0	533	294	34	225	118	4
1575082	JSON	200807	10	0	0	0	8	3	0	0	543	301	34	228	121	4
1575082	JSON	200808	24	1	0	0	18	10	1	0	567	318	35	240	130	4
1575082	JSON	200809	21	0	0	0	11	8	0	0	588	328	35	249	137	4
1575082	JSON	200810	14	1	0	0	11	7	1	0	602	338	36	257	143	4
1575082	JSON	200811	8	1	0	0	7	3	1	0	610	344	37	260	145	4
1575082	JSON	200812	8	0	0	0	7	5	0	0	618	349	37	266	148	4
1575082	JSON	200901	9	0	0	0	8	3	0	0	627	357	37	269	151	4
1575082	JSON	200902	9	1	0	0	8	4	1	0	636	365	38	274	155	5
1575082	JSON	200903	17	1	0	0	9	4	1	0	653	373	39	286	158	5
1575082	JSON	200904	18	3	0	0	11	4	3	0	671	382	42	295	160	6
1575082	JSON	200905	6	0	0	0	5	3	0	0	677	387	42	299	163	6
1575082	JSON	200906	6	1	0	0	5	3	1	0	683	390	43	303	164	6
1575082	JSON	200907	18	0	0	0	9	5	0	0	701	399	43	308	169	6
1575082	JSON	200908	15	1	0	0	7	3	1	0	716	406	44	318	172	6
1575082	JSON	200909	21	1	0	0	20	10	1	0	737	424	45	329	180	6
1575082	JSON	200910	12	1	0	0	11	5	1	0	749	434	46	334	184	6
1575082	JSON	200911	27	3	1	0	18	6	3	1	776	451	49	346	189	7
1575082	JSON	200912	13	1	0	0	10	3	1	0	789	460	50	350	191	7
1575082	JSON	201001	7	0	0	0	6	4	0	0	796	466	50	355	195	7
1575082	JSON	201002	32	3	0	0	15	7	2	0	828	479	53	363	200	7
1575082	JSON	201003	13	0	0	0	11	7	0	0	841	490	53	372	207	7
1575082	JSON	201004	24	4	0	0	20	10	4	0	865	506	57	384	213	7
1575082	JSON	201005	42	0	0	0	18	7	0	0	907	519	57	394	216	7
1575082	JSON	201006	15	1	0	0	12	7	1	0	922	530	58	403	222	7
1575082	JSON	201007	6	1	0	0	6	5	1	0	928	535	59	408	226	8
1575082	JSON	201008	7	1	0	0	6	4	1	0	935	538	60	413	227	9
1575082	JSON	201009	29	1	0	0	14	5	1	0	964	550	61	431	230	9
1575082	JSON	201010	21	3	0	0	15	5	1	0	985	565	64	437	235	9
1575082	JSON	201011	12	0	0	0	6	3	0	0	997	571	64	446	238	9
1575082	JSON	201012	15	0	0	0	12	7	0	0	1012	581	64	455	243	9
1575082	JSON	201101	12	1	0	0	11	4	1	0	1024	591	65	460	246	9
1575082	JSON	201102	12	1	0	0	11	4	1	0	1036	601	66	465	249	9
1575082	JSON	201103	15	0	0	0	8	5	0	0	1051	608	66	477	253	9
1575082	JSON	201104	40	3	0	0	15	10	3	0	1091	620	69	508	260	9
1575082	JSON	201105	17	2	0	0	15	7	2	0	1108	633	71	517	265	10
1575082	JSON	201106	13	1	0	0	11	6	1	0	1121	641	72	523	269	11
1575082	JSON	201107	7	1	0	0	5	4	1	0	1128	644	73	528	271	12
1575082	JSON	201108	8	2	0	0	7	3	1	0	1136	650	75	532	273	12
1575082	JSON	201109	14	1	0	0	12	7	1	0	1150	661	76	540	279	12
1575082	JSON	201110	19	1	0	0	12	9	1	0	1169	672	77	556	287	12
1575082	JSON	201111	19	2	0	0	13	8	2	0	1188	684	79	570	294	12
1575082	JSON	201112	13	0	0	0	8	6	0	0	1201	692	79	579	300	12
1575082	JSON	201201	15	2	0	0	13	5	2	0	1216	702	81	584	302	12
1575082	JSON	201202	4	0	0	0	4	3	0	0	1220	705	81	587	304	12
1575082	JSON	201203	2	0	0	0	2	0	0	0	1222	707	81	587	304	12
1575082	JSON	201204	19	2	0	0	16	9	2	0	1241	719	83	597	310	12
1575082	JSON	201205	9	0	0	0	7	4	0	0	1250	725	83	601	313	12
1575082	JSON	201206	8	1	0	0	5	2	1	0	1258	730	84	604	315	12
1575082	JSON	201207	8	0	0	0	6	3	0	0	1266	734	84	608	317	12
1575082	JSON	201208	13	0	0	0	8	3	0	0	1279	741	84	613	319	12
1575082	JSON	201209	11	1	0	0	7	4	1	0	1290	746	85	618	321	12
1575082	JSON	201210	4	0	0	0	4	2	0	0	1294	749	85	620	322	12
1575082	JSON	201211	30	10	4	3	16	10	6	2	1324	762	95	634	329	13
1575082	JSON	201212	13	3	0	0	10	5	3	0	1337	769	98	639	331	13
1575082	JSON	201301	8	1	0	0	6	3	1	0	1345	774	99	643	333	13
1575082	JSON	201302	15	2	0	0	10	3	2	0	1360	784	101	648	336	13
1575082	JSON	201303	17	1	0	0	14	5	1	0	1377	797	102	653	340	13
1575082	JSON	201304	34	2	0	0	22	13	2	0	1411	817	104	670	351	13
1575082	JSON	201305	30	4	0	0	22	14	2	0	1441	835	108	689	361	14
1575082	JSON	201306	26	6	0	0	21	12	6	0	1467	852	114	703	369	14
1575082	JSON	201307	8	0	0	0	6	2	0	0	1475	858	114	705	371	14
1575082	JSON	201308	31	7	0	0	19	10	4	0	1506	874	121	721	378	14
1575082	JSON	201309	19	5	0	0	14	8	4	0	1525	886	126	734	384	15
1575082	JSON	201310	17	3	0	0	13	8	2	0	1542	896	129	744	388	16
1575082	JSON	201311	13	2	0	0	11	6	1	0	1555	906	131	751	393	16
1575082	JSON	201312	25	1	0	0	12	5	1	0	1580	916	132	763	396	16
1575082	JSON	201401	6	0	0	0	6	2	0	0	1586	922	132	765	398	16
1575082	JSON	201402	19	1	0	0	16	9	1	0	1605	937	133	775	406	16
1575082	JSON	201403	13	3	0	0	13	7	3	0	1618	948	136	782	411	16
1575082	JSON	201404	37	1	0	0	19	12	1	0	1655	961	137	808	416	16
1575082	JSON	201405	13	3	0	0	9	4	3	0	1668	967	140	812	417	16
1575082	JSON	201406	19	4	0	0	16	7	4	0	1687	981	144	820	422	16
1575082	JSON	201407	17	2	0	0	13	6	2	0	1704	991	146	827	423	16
1575082	JSON	201408	17	2	0	0	14	7	2	0	1721	1004	148	836	429	16
1575082	JSON	201409	23	4	0	0	18	8	4	0	1744	1019	152	845	433	16
1575082	JSON	201410	17	3	0	0	12	7	3	0	1761	1030	155	855	439	16
1575082	JSON	201411	5	1	0	0	5	3	1	0	1766	1034	156	858	441	16
1575082	JSON	201412	19	8	0	0	12	6	6	0	1785	1043	164	867	444	17
1575082	JSON	201501	16	2	0	0	12	7	2	0	1801	1052	166	876	448	17
1575082	JSON	201502	17	3	0	0	14	8	2	0	1818	1062	169	886	452	17
1575082	JSON	201503	19	2	0	0	15	6	2	0	1837	1075	171	893	456	17
1575082	JSON	201504	14	5	0	0	11	7	4	0	1851	1083	176	901	460	18
1575082	JSON	201505	9	2	0	0	7	3	1	0	1860	1088	178	906	461	18
1575082	JSON	201506	8	3	0	0	8	3	3	0	1868	1095	181	909	463	19
1575082	JSON	201507	8	2	0	0	6	4	2	0	1876	1099	183	914	465	19
1575082	JSON	201508	5	1	0	0	5	1	1	0	1881	1103	184	915	465	19
1575082	JSON	201509	25	5	2	1	16	10	4	2	1906	1116	189	930	472	21
1575082	JSON	201510	15	2	0	0	11	9	2	0	1921	1123	191	940	477	21
1575082	JSON	201511	15	4	0	0	13	6	4	0	1936	1134	195	947	480	21
1575082	JSON	201512	20	3	0	0	14	9	2	0	1956	1143	198	960	483	21
1575082	JSON	201601	11	3	0	0	9	5	2	0	1967	1150	201	966	486	22
1575082	JSON	201602	22	5	0	0	18	11	5	0	1989	1162	206	979	492	22
1575082	JSON	201603	22	4	0	0	14	9	3	0	2011	1171	210	993	495	22
1575082	JSON	201604	17	1	0	0	13	7	1	0	2028	1182	211	1001	500	22
1575082	JSON	201605	11	0	0	0	5	2	0	0	2039	1186	211	1009	501	22
1575082	JSON	201606	8	1	0	0	7	2	1	0	2047	1191	212	1011	501	22
1575082	JSON	201607	10	3	0	0	8	3	2	0	2057	1196	215	1015	501	22
1575082	JSON	201608	19	5	0	0	13	9	4	0	2076	1205	220	1029	503	25
1575082	JSON	201609	14	1	0	0	10	7	1	0	2090	1211	221	1039	506	25
1575082	JSON	201610	25	5	0	0	17	11	4	0	2115	1222	226	1057	511	25
1575082	JSON	201611	14	4	0	0	14	9	4	0	2129	1233	230	1066	516	25
1575082	JSON	201612	16	1	0	0	12	9	1	0	2145	1240	231	1076	520	25
1575082	JSON	201701	21	4	0	0	13	7	4	0	2166	1251	235	1089	523	26
1575082	JSON	201702	27	5	1	0	16	13	5	1	2193	1262	240	1102	528	29
1575082	JSON	201703	14	1	0	0	11	9	1	0	2207	1271	241	1114	535	29
1575082	JSON	201704	7	2	0	0	7	2	2	0	2214	1276	243	1116	535	29
1575082	JSON	201705	30	4	0	0	16	13	4	0	2244	1285	247	1143	539	30
1575082	JSON	201706	12	3	0	0	8	5	2	0	2256	1291	250	1150	541	31
1575082	JSON	201707	15	6	0	0	14	8	5	0	2271	1303	256	1159	546	33
1575082	JSON	201708	11	1	0	0	9	4	1	0	2282	1311	257	1165	549	33
1575082	JSON	201709	7	2	0	0	5	3	2	0	2289	1314	259	1169	550	33
1575082	JSON	201710	31	9	0	0	21	10	8	0	2320	1333	268	1185	554	33
1575082	JSON	201711	9	2	0	0	6	3	2	0	2329	1339	270	1188	555	33
1575082	JSON	201712	7	2	0	0	7	2	2	0	2336	1345	272	1190	555	33
1575082	JSON	201801	11	1	0	0	8	5	1	0	2347	1352	273	1197	558	33
1575082	JSON	201802	6	2	0	0	4	3	2	0	2353	1355	275	1201	559	34
1575082	JSON	201803	5	1	0	0	5	3	1	0	2358	1360	276	1204	562	35
1575082	JSON	201804	14	3	1	0	8	3	3	1	2372	1365	279	1209	562	37
1575082	JSON	201805	7	0	0	0	6	3	0	0	2379	1370	279	1212	564	37
1575082	JSON	201806	8	2	0	0	7	5	2	0	2387	1375	281	1218	567	38
1575082	JSON	201807	6	0	0	0	5	5	0	0	2393	1378	281	1224	569	38
16947	Kerberos_(protocol)	200203	1	0	0	0	1	1	0	0	1	1	0	1	1	0
16947	Kerberos_(protocol)	200207	1	0	0	0	1	0	0	0	2	2	0	1	1	0
16947	Kerberos_(protocol)	200212	1	0	0	0	1	1	0	0	3	3	0	2	2	0
16947	Kerberos_(protocol)	200303	2	0	0	0	2	2	0	0	5	5	0	4	4	0
16947	Kerberos_(protocol)	200305	2	0	0	0	2	1	0	0	7	7	0	5	5	0
16947	Kerberos_(protocol)	200310	4	0	0	0	1	1	0	0	11	8	0	9	6	0
16947	Kerberos_(protocol)	200402	1	0	0	0	1	0	0	0	12	9	0	9	6	0
16947	Kerberos_(protocol)	200403	2	0	0	0	2	1	0	0	14	11	0	10	7	0
16947	Kerberos_(protocol)	200404	1	0	0	0	1	1	0	0	15	12	0	11	8	0
16947	Kerberos_(protocol)	200405	2	0	0	0	2	1	0	0	17	14	0	12	9	0
16947	Kerberos_(protocol)	200406	8	0	0	0	6	5	0	0	25	19	0	19	13	0
16947	Kerberos_(protocol)	200407	6	0	0	0	6	5	0	0	31	25	0	24	18	0
16947	Kerberos_(protocol)	200408	1	0	0	0	1	1	0	0	32	25	0	25	18	0
16947	Kerberos_(protocol)	200409	5	0	0	0	4	3	0	0	37	29	0	29	21	0
16947	Kerberos_(protocol)	200410	3	0	0	0	3	3	0	0	40	31	0	32	23	0
16947	Kerberos_(protocol)	200411	19	1	0	0	3	2	1	0	59	33	1	48	24	0
16947	Kerberos_(protocol)	200412	3	0	0	0	3	2	0	0	62	36	1	50	26	0
16947	Kerberos_(protocol)	200501	2	0	0	0	2	1	0	0	64	38	1	51	27	0
16947	Kerberos_(protocol)	200502	2	0	0	0	2	2	0	0	66	40	1	53	29	0
16947	Kerberos_(protocol)	200503	3	1	0	0	3	1	1	0	69	43	2	54	30	0
16947	Kerberos_(protocol)	200504	18	1	0	0	10	5	1	0	87	52	3	65	34	0
16947	Kerberos_(protocol)	200505	6	0	0	0	4	1	0	0	93	56	3	66	35	0
16947	Kerberos_(protocol)	200506	2	0	0	0	1	0	0	0	95	57	3	66	35	0
16947	Kerberos_(protocol)	200507	10	1	0	0	8	2	1	0	105	65	4	68	37	0
16947	Kerberos_(protocol)	200508	11	0	0	0	9	6	0	0	116	71	4	76	40	0
16947	Kerberos_(protocol)	200509	4	0	0	0	4	2	0	0	120	75	4	78	42	0
16947	Kerberos_(protocol)	200510	2	0	0	0	2	1	0	0	122	77	4	79	43	0
16947	Kerberos_(protocol)	200511	1	0	0	0	1	0	0	0	123	78	4	79	43	0
16947	Kerberos_(protocol)	200512	4	0	0	0	4	3	0	0	127	82	4	82	46	0
16947	Kerberos_(protocol)	200601	10	0	0	0	8	5	0	0	137	90	4	87	51	0
16947	Kerberos_(protocol)	200602	5	0	0	0	4	1	0	0	142	94	4	88	52	0
16947	Kerberos_(protocol)	200603	7	0	0	0	4	1	0	0	149	98	4	89	53	0
16947	Kerberos_(protocol)	200604	9	2	0	0	6	1	2	0	158	104	6	90	54	0
16947	Kerberos_(protocol)	200605	8	1	0	0	6	4	1	0	166	110	7	94	58	0
16947	Kerberos_(protocol)	200606	9	0	0	0	8	3	0	0	175	118	7	97	61	0
16947	Kerberos_(protocol)	200607	15	0	0	0	9	5	0	0	190	127	7	103	66	0
16947	Kerberos_(protocol)	200608	9	0	0	0	4	1	0	0	199	131	7	104	67	0
16947	Kerberos_(protocol)	200609	4	0	0	0	3	1	0	0	203	134	7	105	68	0
16947	Kerberos_(protocol)	200610	9	0	0	0	7	2	0	0	212	141	7	107	70	0
16947	Kerberos_(protocol)	200611	4	0	0	0	4	2	0	0	216	145	7	109	72	0
16947	Kerberos_(protocol)	200612	7	0	0	0	7	3	0	0	223	152	7	112	75	0
16947	Kerberos_(protocol)	200701	9	1	0	0	9	4	1	0	232	161	8	116	79	0
16947	Kerberos_(protocol)	200702	6	0	0	0	6	5	0	0	238	167	8	121	84	0
16947	Kerberos_(protocol)	200703	7	1	0	0	5	3	1	0	245	171	9	125	86	0
16947	Kerberos_(protocol)	200704	12	3	0	0	10	3	2	0	257	179	12	129	87	0
16947	Kerberos_(protocol)	200705	7	3	1	0	6	2	2	1	264	184	15	132	88	1
16947	Kerberos_(protocol)	200706	7	0	0	0	7	6	0	0	271	190	15	138	93	1
16947	Kerberos_(protocol)	200707	11	0	0	0	9	2	0	0	282	199	15	140	95	1
16947	Kerberos_(protocol)	200708	6	0	0	0	5	1	0	0	288	204	15	141	96	1
16947	Kerberos_(protocol)	200709	1	0	0	0	1	1	0	0	289	205	15	142	97	1
16947	Kerberos_(protocol)	200710	7	0	0	0	6	2	0	0	296	211	15	145	99	1
16947	Kerberos_(protocol)	200711	16	1	0	0	12	6	1	0	312	223	16	152	105	2
16947	Kerberos_(protocol)	200712	6	0	0	0	6	0	0	0	318	229	16	152	105	2
16947	Kerberos_(protocol)	200801	9	0	0	0	5	2	0	0	327	234	16	158	107	2
16947	Kerberos_(protocol)	200802	10	0	0	0	7	4	0	0	337	239	16	163	109	2
16947	Kerberos_(protocol)	200803	7	2	0	0	4	2	1	0	344	243	18	167	111	3
16947	Kerberos_(protocol)	200804	6	1	0	0	6	2	1	0	350	248	19	169	112	3
16947	Kerberos_(protocol)	200805	6	1	0	0	6	2	1	0	356	252	20	171	112	3
16947	Kerberos_(protocol)	200806	6	1	0	0	4	1	1	0	362	255	21	172	112	3
16947	Kerberos_(protocol)	200807	4	0	0	0	2	1	0	0	366	257	21	175	113	3
16947	Kerberos_(protocol)	200808	14	1	0	0	8	6	1	0	380	264	22	186	118	4
16947	Kerberos_(protocol)	200809	5	0	0	0	5	4	0	0	385	269	22	190	122	4
16947	Kerberos_(protocol)	200810	5	1	0	0	5	3	1	0	390	274	23	193	125	4
16947	Kerberos_(protocol)	200811	3	0	0	0	3	3	0	0	393	276	23	196	127	4
16947	Kerberos_(protocol)	200812	7	1	0	0	7	4	1	0	400	283	24	200	131	4
16947	Kerberos_(protocol)	200901	3	1	0	0	3	2	1	0	403	285	25	202	132	4
16947	Kerberos_(protocol)	200902	3	0	0	0	2	2	0	0	406	287	25	205	134	4
16947	Kerberos_(protocol)	200903	6	1	0	0	6	2	1	0	412	292	26	207	135	4
16947	Kerberos_(protocol)	200904	10	0	0	0	3	0	0	0	422	295	26	207	135	4
16947	Kerberos_(protocol)	200905	8	0	0	0	6	4	0	0	430	301	26	213	139	4
16947	Kerberos_(protocol)	200906	10	1	0	0	5	3	1	0	440	305	27	221	141	4
16947	Kerberos_(protocol)	200907	4	0	0	0	3	3	0	0	444	308	27	225	144	4
16947	Kerberos_(protocol)	200908	4	0	0	0	3	2	0	0	448	311	27	228	146	4
16947	Kerberos_(protocol)	200909	5	0	0	0	4	0	0	0	453	315	27	228	146	4
16947	Kerberos_(protocol)	200910	8	2	0	0	7	2	2	0	461	321	29	230	147	4
16947	Kerberos_(protocol)	200911	3	0	0	0	2	1	0	0	464	323	29	232	148	4
16947	Kerberos_(protocol)	200912	9	2	0	0	8	5	2	0	473	329	31	237	151	5
16947	Kerberos_(protocol)	201001	8	2	0	0	5	3	1	0	481	333	33	243	153	6
16947	Kerberos_(protocol)	201002	4	0	0	0	4	1	0	0	485	337	33	244	154	6
16947	Kerberos_(protocol)	201003	3	1	0	0	3	2	1	0	488	339	34	246	155	7
16947	Kerberos_(protocol)	201004	3	1	0	0	3	1	1	0	491	341	35	247	155	7
16947	Kerberos_(protocol)	201005	2	0	0	0	2	2	0	0	493	343	35	249	157	7
16947	Kerberos_(protocol)	201006	6	1	0	0	6	4	1	0	499	347	36	253	159	7
16947	Kerberos_(protocol)	201007	7	1	0	0	5	3	1	0	506	349	37	257	159	7
16947	Kerberos_(protocol)	201008	1	0	0	0	1	0	0	0	507	350	37	257	159	7
16947	Kerberos_(protocol)	201009	12	2	0	0	11	8	2	0	519	358	39	266	164	7
16947	Kerberos_(protocol)	201010	8	2	0	0	6	2	2	0	527	363	41	268	165	7
16947	Kerberos_(protocol)	201011	4	0	0	0	4	3	0	0	531	367	41	271	168	7
16947	Kerberos_(protocol)	201012	7	1	0	0	6	1	1	0	538	373	42	272	169	7
16947	Kerberos_(protocol)	201101	10	2	0	0	8	4	2	0	548	381	44	276	173	7
16947	Kerberos_(protocol)	201102	6	0	0	0	5	1	0	0	554	386	44	277	174	7
16947	Kerberos_(protocol)	201103	10	2	0	0	9	5	2	0	564	394	46	282	178	7
16947	Kerberos_(protocol)	201104	6	1	0	0	5	2	1	0	570	398	47	285	179	7
16947	Kerberos_(protocol)	201105	7	0	0	0	4	2	0	0	577	402	47	289	181	7
16947	Kerberos_(protocol)	201106	9	2	0	0	6	3	1	0	586	407	49	294	183	7
16947	Kerberos_(protocol)	201107	11	4	0	0	9	6	4	0	597	415	53	300	188	7
16947	Kerberos_(protocol)	201108	9	0	0	0	2	2	0	0	606	417	53	309	190	7
16947	Kerberos_(protocol)	201109	4	0	0	0	3	1	0	0	610	420	53	310	191	7
16947	Kerberos_(protocol)	201110	6	0	0	0	4	3	0	0	616	424	53	315	194	7
16947	Kerberos_(protocol)	201111	2	1	0	0	2	1	1	0	618	426	54	316	195	7
16947	Kerberos_(protocol)	201112	9	1	0	0	6	3	1	0	627	431	55	320	197	7
16947	Kerberos_(protocol)	201201	5	0	0	0	4	4	0	0	632	435	55	325	201	7
16947	Kerberos_(protocol)	201202	4	0	0	0	4	3	0	0	636	438	55	328	203	7
16947	Kerberos_(protocol)	201203	1	0	0	0	1	1	0	0	637	439	55	329	204	7
16947	Kerberos_(protocol)	201204	10	1	0	0	7	3	1	0	647	445	56	334	206	7
16947	Kerberos_(protocol)	201205	6	0	0	0	5	3	0	0	653	449	56	338	208	7
16947	Kerberos_(protocol)	201206	1	0	0	0	1	1	0	0	654	450	56	339	209	7
16947	Kerberos_(protocol)	201207	2	0	0	0	1	1	0	0	656	451	56	341	210	7
16947	Kerberos_(protocol)	201208	4	0	0	0	3	0	0	0	660	454	56	341	210	7
16947	Kerberos_(protocol)	201209	3	0	0	0	2	2	0	0	663	455	56	344	211	7
16947	Kerberos_(protocol)	201210	7	1	0	0	6	3	1	0	670	460	57	347	213	7
16947	Kerberos_(protocol)	201211	3	0	0	0	3	2	0	0	673	463	57	349	215	7
16947	Kerberos_(protocol)	201212	2	0	0	0	2	1	0	0	675	465	57	350	216	7
16947	Kerberos_(protocol)	201302	3	0	0	0	2	0	0	0	678	467	57	350	216	7
16947	Kerberos_(protocol)	201303	2	0	0	0	2	2	0	0	680	469	57	352	218	7
16947	Kerberos_(protocol)	201304	3	1	0	0	3	1	1	0	683	471	58	353	218	7
16947	Kerberos_(protocol)	201305	3	1	0	0	3	2	1	0	686	473	59	355	219	7
16947	Kerberos_(protocol)	201306	6	0	0	0	4	3	0	0	692	476	59	359	220	7
16947	Kerberos_(protocol)	201307	10	2	0	0	7	3	2	0	702	482	61	364	222	8
16947	Kerberos_(protocol)	201308	1	0	0	0	1	1	0	0	703	483	61	365	223	8
16947	Kerberos_(protocol)	201309	3	0	0	0	3	2	0	0	706	485	61	367	224	8
16947	Kerberos_(protocol)	201310	3	0	0	0	3	1	0	0	709	488	61	368	225	8
16947	Kerberos_(protocol)	201311	8	1	0	0	7	2	1	0	717	494	62	371	226	8
16947	Kerberos_(protocol)	201312	3	0	0	0	3	0	0	0	720	497	62	371	226	8
16947	Kerberos_(protocol)	201401	10	1	0	0	4	0	1	0	730	501	63	371	226	8
16947	Kerberos_(protocol)	201402	3	0	0	0	3	1	0	0	733	504	63	372	227	8
16947	Kerberos_(protocol)	201403	5	2	0	0	5	3	2	0	738	509	65	375	230	8
16947	Kerberos_(protocol)	201404	3	0	0	0	3	2	0	0	741	512	65	377	231	8
16947	Kerberos_(protocol)	201405	2	0	0	0	2	1	0	0	743	514	65	378	232	8
16947	Kerberos_(protocol)	201406	4	1	0	0	4	3	1	0	747	517	66	381	234	8
16947	Kerberos_(protocol)	201408	2	1	0	0	2	2	1	0	749	519	67	383	236	9
16947	Kerberos_(protocol)	201410	3	0	0	0	2	0	0	0	752	521	67	383	236	9
16947	Kerberos_(protocol)	201411	1	0	0	0	1	0	0	0	753	522	67	383	236	9
16947	Kerberos_(protocol)	201412	12	2	0	0	11	5	2	0	765	532	69	388	240	9
16947	Kerberos_(protocol)	201501	2	0	0	0	1	0	0	0	767	533	69	388	240	9
16947	Kerberos_(protocol)	201502	4	0	0	0	3	2	0	0	771	535	69	391	241	9
16947	Kerberos_(protocol)	201503	4	1	0	0	3	1	1	0	775	537	70	392	241	9
16947	Kerberos_(protocol)	201504	11	4	0	0	6	3	2	0	786	542	74	397	243	9
16947	Kerberos_(protocol)	201505	5	0	0	0	4	1	0	0	791	546	74	399	244	9
16947	Kerberos_(protocol)	201506	3	0	0	0	2	0	0	0	794	548	74	399	244	9
16947	Kerberos_(protocol)	201507	2	0	0	0	2	1	0	0	796	550	74	400	245	9
16947	Kerberos_(protocol)	201508	1	0	0	0	1	0	0	0	797	551	74	400	245	9
16947	Kerberos_(protocol)	201509	6	1	0	0	3	1	1	0	803	553	75	401	245	9
16947	Kerberos_(protocol)	201510	2	0	0	0	1	1	0	0	805	554	75	403	246	9
16947	Kerberos_(protocol)	201511	8	1	0	0	5	3	1	0	813	559	76	406	249	9
16947	Kerberos_(protocol)	201512	2	1	0	0	2	1	1	0	815	561	77	407	249	9
16947	Kerberos_(protocol)	201601	1	0	0	0	1	0	0	0	816	562	77	407	249	9
16947	Kerberos_(protocol)	201602	5	1	0	0	5	3	1	0	821	567	78	410	252	10
16947	Kerberos_(protocol)	201603	2	0	0	0	2	1	0	0	823	569	78	411	253	10
16947	Kerberos_(protocol)	201604	1	0	0	0	1	1	0	0	824	570	78	412	254	10
16947	Kerberos_(protocol)	201605	1	0	0	0	1	0	0	0	825	571	78	412	254	10
16947	Kerberos_(protocol)	201606	5	0	0	0	4	3	0	0	830	575	78	416	256	10
16947	Kerberos_(protocol)	201607	6	1	0	0	5	4	1	0	836	577	79	421	257	10
16947	Kerberos_(protocol)	201608	2	0	0	0	2	1	0	0	838	579	79	422	257	10
16947	Kerberos_(protocol)	201609	5	0	0	0	5	5	0	0	843	584	79	427	262	10
16947	Kerberos_(protocol)	201610	3	1	0	0	3	1	1	0	846	587	80	428	263	10
16947	Kerberos_(protocol)	201611	4	1	0	0	4	3	1	0	850	591	81	431	266	10
16947	Kerberos_(protocol)	201612	4	0	0	0	3	0	0	0	854	594	81	431	266	10
16947	Kerberos_(protocol)	201701	4	1	0	0	4	3	1	0	858	598	82	434	269	10
16947	Kerberos_(protocol)	201702	1	0	0	0	1	1	0	0	859	599	82	435	270	10
16947	Kerberos_(protocol)	201703	3	0	0	0	3	1	0	0	862	602	82	436	271	10
16947	Kerberos_(protocol)	201705	5	0	0	0	3	2	0	0	867	605	82	440	273	10
16947	Kerberos_(protocol)	201706	3	0	0	0	2	2	0	0	870	607	82	443	275	10
16947	Kerberos_(protocol)	201708	2	0	0	0	2	1	0	0	872	609	82	444	276	10
16947	Kerberos_(protocol)	201709	4	0	0	0	3	1	0	0	876	611	82	445	276	10
16947	Kerberos_(protocol)	201710	8	1	0	0	8	7	1	0	884	618	83	452	280	11
16947	Kerberos_(protocol)	201712	1	0	0	0	1	0	0	0	885	619	83	452	280	11
16947	Kerberos_(protocol)	201801	2	0	0	0	2	2	0	0	887	621	83	454	282	11
16947	Kerberos_(protocol)	201802	1	0	0	0	1	1	0	0	888	622	83	455	283	11
16947	Kerberos_(protocol)	201803	2	1	0	0	2	1	1	0	890	624	84	456	284	11
16947	Kerberos_(protocol)	201805	1	0	0	0	1	1	0	0	891	624	84	457	284	11
16947	Kerberos_(protocol)	201806	1	0	0	0	1	1	0	0	892	625	84	458	285	11
19752979	LTE_(telecommunication)	200612	21	0	0	0	4	4	0	0	21	4	0	21	4	0
19752979	LTE_(telecommunication)	200701	9	1	0	0	6	4	1	0	30	9	1	27	7	0
19752979	LTE_(telecommunication)	200702	14	0	0	0	3	2	0	0	44	11	1	40	8	0
19752979	LTE_(telecommunication)	200703	3	0	0	0	2	1	0	0	47	13	1	41	9	0
19752979	LTE_(telecommunication)	200705	6	0	0	0	3	2	0	0	53	14	1	45	9	0
19752979	LTE_(telecommunication)	200706	2	0	0	0	2	2	0	0	55	16	1	47	11	0
19752979	LTE_(telecommunication)	200707	4	0	0	0	3	2	0	0	59	19	1	49	13	0
19752979	LTE_(telecommunication)	200708	13	0	0	0	7	5	0	0	72	25	1	56	17	0
19752979	LTE_(telecommunication)	200709	4	0	0	0	2	2	0	0	76	27	1	60	19	0
19752979	LTE_(telecommunication)	200710	2	0	0	0	2	1	0	0	78	29	1	61	20	0
19752979	LTE_(telecommunication)	200711	3	0	0	0	3	2	0	0	81	32	1	63	22	0
19752979	LTE_(telecommunication)	200712	13	1	0	0	7	5	1	0	94	38	2	73	26	1
19752979	LTE_(telecommunication)	200801	14	1	0	0	10	5	1	0	108	46	3	82	29	1
19752979	LTE_(telecommunication)	200802	8	0	0	0	7	5	0	0	116	53	3	88	34	1
19752979	LTE_(telecommunication)	200803	16	0	0	0	9	7	0	0	132	61	3	100	40	1
19752979	LTE_(telecommunication)	200804	11	0	0	0	7	5	0	0	143	68	3	108	45	1
19752979	LTE_(telecommunication)	200805	5	0	0	0	4	2	0	0	148	71	3	110	46	1
19752979	LTE_(telecommunication)	200806	19	1	0	0	14	8	1	0	167	83	4	122	52	1
19752979	LTE_(telecommunication)	200807	25	1	0	0	7	5	1	0	192	88	5	144	55	1
19752979	LTE_(telecommunication)	200808	12	0	0	0	11	5	0	0	204	97	5	150	59	1
19752979	LTE_(telecommunication)	200809	18	1	0	0	13	7	1	0	222	107	6	162	63	1
19752979	LTE_(telecommunication)	200810	16	1	0	0	14	7	1	0	238	119	7	170	69	1
19752979	LTE_(telecommunication)	200811	82	2	0	0	27	15	2	0	320	143	9	234	82	2
19752979	LTE_(telecommunication)	200812	29	4	1	0	12	6	3	1	349	153	13	251	86	5
19752979	LTE_(telecommunication)	200901	18	0	0	0	9	5	0	0	367	159	13	262	88	5
19752979	LTE_(telecommunication)	200902	19	2	0	0	16	8	2	0	386	171	15	272	93	7
19752979	LTE_(telecommunication)	200903	32	3	0	0	16	8	2	0	418	185	18	292	100	10
19752979	LTE_(telecommunication)	200904	28	2	0	0	21	12	2	0	446	202	20	308	109	10
19752979	LTE_(telecommunication)	200905	40	1	0	0	19	13	1	0	486	218	21	342	119	11
19752979	LTE_(telecommunication)	200906	21	1	0	0	14	7	1	0	507	228	22	352	122	11
19752979	LTE_(telecommunication)	200907	26	2	0	0	16	6	2	0	533	241	24	363	125	13
19752979	LTE_(telecommunication)	200908	75	2	0	0	27	17	2	0	608	261	26	412	137	15
19752979	LTE_(telecommunication)	200909	33	0	0	0	20	11	0	0	641	279	26	434	147	15
19752979	LTE_(telecommunication)	200910	19	1	0	0	16	6	1	0	660	292	27	442	150	15
19752979	LTE_(telecommunication)	200911	29	3	0	0	19	11	2	0	689	308	30	461	158	17
19752979	LTE_(telecommunication)	200912	21	1	0	0	16	6	1	0	710	324	31	468	164	17
19752979	LTE_(telecommunication)	201001	53	3	0	0	29	17	2	0	763	348	34	499	177	19
19752979	LTE_(telecommunication)	201002	17	1	0	0	11	7	1	0	780	355	35	510	180	20
19752979	LTE_(telecommunication)	201003	22	2	0	0	17	7	1	0	802	370	37	521	185	20
19752979	LTE_(telecommunication)	201004	27	1	0	0	20	10	1	0	829	386	38	536	192	20
19752979	LTE_(telecommunication)	201005	16	3	0	0	13	6	1	0	845	398	41	544	197	21
19752979	LTE_(telecommunication)	201006	20	2	0	0	14	6	2	0	865	410	43	552	201	21
19752979	LTE_(telecommunication)	201007	16	2	0	0	14	4	2	0	881	422	45	556	203	22
19752979	LTE_(telecommunication)	201008	37	3	0	0	19	11	3	0	918	437	48	578	211	22
19752979	LTE_(telecommunication)	201009	19	5	0	0	17	8	5	0	937	452	53	588	218	24
19752979	LTE_(telecommunication)	201010	29	0	0	0	19	6	0	0	966	468	53	595	222	24
19752979	LTE_(telecommunication)	201011	15	0	0	0	13	11	0	0	981	480	53	608	232	24
19752979	LTE_(telecommunication)	201012	20	1	0	0	15	7	1	0	1001	492	54	616	237	25
19752979	LTE_(telecommunication)	201101	36	2	0	0	20	8	2	0	1037	507	56	627	240	25
19752979	LTE_(telecommunication)	201102	23	1	0	0	17	6	1	0	1060	521	57	636	244	25
19752979	LTE_(telecommunication)	201103	9	1	0	0	8	6	1	0	1069	528	58	643	249	26
19752979	LTE_(telecommunication)	201104	9	1	0	0	8	4	1	0	1078	535	59	647	252	27
19752979	LTE_(telecommunication)	201105	25	1	0	0	16	8	1	0	1103	551	60	661	260	28
19752979	LTE_(telecommunication)	201106	36	1	0	0	19	7	1	0	1139	568	61	674	266	28
19752979	LTE_(telecommunication)	201107	26	0	0	0	16	7	0	0	1165	583	61	687	272	28
19752979	LTE_(telecommunication)	201108	20	1	0	0	17	8	1	0	1185	597	62	696	277	28
19752979	LTE_(telecommunication)	201109	10	0	0	0	9	5	0	0	1195	604	62	701	281	28
19752979	LTE_(telecommunication)	201110	51	6	0	0	28	14	3	0	1246	624	68	732	289	28
19752979	LTE_(telecommunication)	201111	34	6	2	0	25	14	4	2	1280	642	74	751	296	32
19752979	LTE_(telecommunication)	201112	58	1	0	0	15	8	1	0	1338	651	75	782	299	33
19752979	LTE_(telecommunication)	201201	32	0	0	0	26	11	0	0	1370	674	75	794	307	33
19752979	LTE_(telecommunication)	201202	30	2	0	0	21	13	2	0	1400	692	77	815	317	35
19752979	LTE_(telecommunication)	201203	60	3	0	0	19	9	2	0	1460	705	80	856	322	37
19752979	LTE_(telecommunication)	201204	67	8	5	4	22	12	3	2	1527	724	88	906	331	41
19752979	LTE_(telecommunication)	201205	15	4	0	0	12	5	3	0	1542	734	92	913	334	41
19752979	LTE_(telecommunication)	201206	29	2	0	0	17	10	1	0	1571	743	94	929	337	41
19752979	LTE_(telecommunication)	201207	9	3	0	0	9	6	3	0	1580	749	97	935	340	41
19752979	LTE_(telecommunication)	201208	8	1	0	0	7	3	1	0	1588	755	98	939	343	41
19752979	LTE_(telecommunication)	201209	9	1	0	0	5	3	1	0	1597	758	99	946	344	41
19752979	LTE_(telecommunication)	201210	28	5	0	0	20	8	3	0	1625	775	104	960	349	42
19752979	LTE_(telecommunication)	201211	28	7	0	0	15	9	2	0	1653	789	111	974	357	46
19752979	LTE_(telecommunication)	201212	22	7	0	0	17	8	4	0	1675	799	118	985	360	46
19752979	LTE_(telecommunication)	201301	13	4	0	0	12	7	4	0	1688	807	122	992	363	46
19752979	LTE_(telecommunication)	201302	3	0	0	0	2	1	0	0	1691	808	122	994	363	46
19752979	LTE_(telecommunication)	201303	9	2	0	0	9	4	2	0	1700	815	124	998	365	46
19752979	LTE_(telecommunication)	201304	6	1	0	0	5	2	1	0	1706	818	125	1001	365	46
19752979	LTE_(telecommunication)	201305	7	0	0	0	6	4	0	0	1713	824	125	1006	369	46
19752979	LTE_(telecommunication)	201306	7	1	0	0	6	5	1	0	1720	829	126	1012	373	47
19752979	LTE_(telecommunication)	201307	7	3	0	0	7	4	3	0	1727	834	129	1016	375	47
19752979	LTE_(telecommunication)	201308	4	1	0	0	4	3	1	0	1731	838	130	1019	378	47
19752979	LTE_(telecommunication)	201309	21	4	0	0	12	7	4	0	1752	848	134	1026	383	47
19752979	LTE_(telecommunication)	201310	9	3	0	0	6	3	3	0	1761	852	137	1030	385	47
19752979	LTE_(telecommunication)	201311	3	1	0	0	3	2	1	0	1764	854	138	1032	386	47
19752979	LTE_(telecommunication)	201312	16	2	0	0	11	2	2	0	1780	864	140	1034	387	47
19752979	LTE_(telecommunication)	201401	15	1	0	0	12	3	1	0	1795	875	141	1038	389	47
19752979	LTE_(telecommunication)	201402	20	4	0	0	15	7	4	0	1815	887	145	1045	393	47
19752979	LTE_(telecommunication)	201403	2	1	0	0	2	0	1	0	1817	889	146	1045	393	47
19752979	LTE_(telecommunication)	201404	7	1	0	0	6	2	1	0	1824	894	147	1047	395	47
19752979	LTE_(telecommunication)	201405	13	3	0	0	11	5	3	0	1837	902	150	1054	398	47
19752979	LTE_(telecommunication)	201406	22	8	0	0	16	7	3	0	1859	915	158	1066	402	48
19752979	LTE_(telecommunication)	201407	9	1	0	0	9	4	1	0	1868	922	159	1070	404	48
19752979	LTE_(telecommunication)	201408	6	0	0	0	6	4	0	0	1874	926	159	1074	406	48
19752979	LTE_(telecommunication)	201409	11	2	0	0	9	6	2	0	1885	932	161	1082	409	48
19752979	LTE_(telecommunication)	201410	10	2	0	0	9	5	2	0	1895	941	163	1088	414	48
19752979	LTE_(telecommunication)	201411	6	1	0	0	6	4	1	0	1901	946	164	1092	417	48
19752979	LTE_(telecommunication)	201412	19	8	0	0	15	8	6	0	1920	957	172	1101	422	50
19752979	LTE_(telecommunication)	201501	10	2	0	0	10	6	2	0	1930	964	174	1107	425	50
19752979	LTE_(telecommunication)	201502	4	0	0	0	4	3	0	0	1934	968	174	1110	428	50
19752979	LTE_(telecommunication)	201503	24	0	0	0	13	6	0	0	1958	980	174	1119	433	50
19752979	LTE_(telecommunication)	201504	39	3	0	0	20	10	3	0	1997	998	177	1137	441	50
19752979	LTE_(telecommunication)	201505	22	2	0	0	14	7	2	0	2019	1009	179	1145	444	51
19752979	LTE_(telecommunication)	201506	29	2	0	0	15	6	2	0	2048	1022	181	1151	448	51
19752979	LTE_(telecommunication)	201507	17	2	0	0	13	7	2	0	2065	1035	183	1160	454	52
19752979	LTE_(telecommunication)	201508	25	0	0	0	11	1	0	0	2090	1045	183	1161	454	52
19752979	LTE_(telecommunication)	201509	7	1	0	0	7	3	1	0	2097	1051	184	1164	456	52
19752979	LTE_(telecommunication)	201510	42	4	0	0	25	15	4	0	2139	1071	188	1189	465	53
19752979	LTE_(telecommunication)	201511	9	2	0	0	6	4	1	0	2148	1075	190	1196	467	53
19752979	LTE_(telecommunication)	201512	13	4	0	0	12	8	4	0	2161	1083	194	1204	470	54
19752979	LTE_(telecommunication)	201601	11	3	0	0	9	5	3	0	2172	1089	197	1209	471	55
19752979	LTE_(telecommunication)	201602	9	2	0	0	8	5	2	0	2181	1093	199	1214	473	56
19752979	LTE_(telecommunication)	201603	22	3	0	0	12	8	3	0	2203	1101	202	1229	477	57
19752979	LTE_(telecommunication)	201604	10	3	0	0	9	4	3	0	2213	1108	205	1234	479	57
19752979	LTE_(telecommunication)	201605	11	2	0	0	10	5	2	0	2224	1114	207	1240	480	57
19752979	LTE_(telecommunication)	201606	10	0	0	0	5	3	0	0	2234	1118	207	1247	481	57
19752979	LTE_(telecommunication)	201607	10	3	0	0	8	5	3	0	2244	1123	210	1254	483	59
19752979	LTE_(telecommunication)	201608	19	2	0	0	9	3	2	0	2263	1132	212	1263	485	61
19752979	LTE_(telecommunication)	201609	11	2	0	0	8	4	1	0	2274	1139	214	1268	487	62
19752979	LTE_(telecommunication)	201610	10	1	0	0	7	3	1	0	2284	1145	215	1273	488	62
19752979	LTE_(telecommunication)	201611	7	1	0	0	6	4	1	0	2291	1150	216	1278	491	63
19752979	LTE_(telecommunication)	201612	12	3	0	0	10	8	2	0	2303	1159	219	1288	497	65
19752979	LTE_(telecommunication)	201701	3	1	0	0	3	1	1	0	2306	1162	220	1289	498	65
19752979	LTE_(telecommunication)	201702	12	4	0	0	10	8	3	0	2318	1169	224	1299	503	67
19752979	LTE_(telecommunication)	201703	11	4	0	0	9	5	3	0	2329	1177	228	1305	506	67
19752979	LTE_(telecommunication)	201704	11	3	0	0	9	7	2	0	2340	1183	231	1313	510	67
19752979	LTE_(telecommunication)	201705	9	1	0	0	9	5	1	0	2349	1191	232	1318	513	67
19752979	LTE_(telecommunication)	201706	8	1	0	0	8	3	1	0	2357	1198	233	1321	515	67
19752979	LTE_(telecommunication)	201707	8	1	0	0	7	5	1	0	2365	1205	234	1326	520	67
19752979	LTE_(telecommunication)	201708	13	0	0	0	11	6	0	0	2378	1216	234	1333	526	67
19752979	LTE_(telecommunication)	201709	16	6	0	0	15	9	6	0	2394	1228	240	1343	531	69
19752979	LTE_(telecommunication)	201710	7	0	0	0	6	3	0	0	2401	1234	240	1347	534	69
19752979	LTE_(telecommunication)	201711	6	3	0	0	4	1	1	0	2407	1237	243	1350	534	69
19752979	LTE_(telecommunication)	201712	1	0	0	0	1	1	0	0	2408	1237	243	1351	534	69
19752979	LTE_(telecommunication)	201801	7	1	0	0	6	5	1	0	2415	1241	244	1357	537	69
19752979	LTE_(telecommunication)	201802	9	1	0	0	7	5	1	0	2424	1248	245	1362	542	69
19752979	LTE_(telecommunication)	201803	5	2	0	0	5	3	2	0	2429	1252	247	1365	544	69
19752979	LTE_(telecommunication)	201804	8	2	0	0	8	5	2	0	2437	1258	249	1370	546	70
19752979	LTE_(telecommunication)	201805	17	3	1	0	5	4	3	1	2454	1263	252	1386	550	73
19752979	LTE_(telecommunication)	201806	6	3	0	0	6	5	3	0	2460	1268	255	1391	553	75
19752979	LTE_(telecommunication)	201807	7	0	0	0	6	4	0	0	2467	1274	255	1395	557	75
252008	Language_technology	200404	1	0	0	0	1	1	0	0	1	1	0	1	1	0
252008	Language_technology	200504	2	0	0	0	1	0	0	0	3	2	0	1	1	0
252008	Language_technology	200507	1	0	0	0	1	0	0	0	4	3	0	1	1	0
252008	Language_technology	200605	1	0	0	0	1	0	0	0	5	4	0	1	1	0
252008	Language_technology	200609	3	0	0	0	1	1	0	0	8	5	0	4	2	0
252008	Language_technology	200610	2	0	0	0	2	2	0	0	10	7	0	6	4	0
252008	Language_technology	200704	1	0	0	0	1	1	0	0	11	8	0	7	5	0
252008	Language_technology	200705	37	0	0	0	2	2	0	0	48	10	0	44	7	0
252008	Language_technology	200706	38	0	0	0	2	2	0	0	86	11	0	82	8	0
252008	Language_technology	200707	20	0	0	0	6	5	0	0	106	16	0	98	12	0
252008	Language_technology	200710	2	0	0	0	2	2	0	0	108	18	0	100	14	0
252008	Language_technology	200712	2	0	0	0	2	1	0	0	110	20	0	101	15	0
252008	Language_technology	200804	3	1	0	0	2	1	1	0	113	22	1	103	16	0
252008	Language_technology	200908	1	0	0	0	1	1	0	0	114	23	1	104	17	0
252008	Language_technology	201005	1	0	0	0	1	1	0	0	115	24	1	105	18	0
252008	Language_technology	201006	1	0	0	0	1	0	0	0	116	25	1	105	18	0
252008	Language_technology	201109	2	0	0	0	2	2	0	0	118	27	1	107	20	0
252008	Language_technology	201209	1	0	0	0	1	1	0	0	119	28	1	108	21	0
252008	Language_technology	201211	1	0	0	0	1	1	0	0	120	29	1	109	22	0
252008	Language_technology	201303	1	0	0	0	1	1	0	0	121	30	1	110	23	0
252008	Language_technology	201307	1	0	0	0	1	1	0	0	122	31	1	111	24	0
252008	Language_technology	201309	1	0	0	0	1	1	0	0	123	32	1	112	25	0
252008	Language_technology	201401	5	0	0	0	2	2	0	0	128	34	1	117	27	0
252008	Language_technology	201410	1	0	0	0	1	1	0	0	129	35	1	118	28	0
252008	Language_technology	201501	1	0	0	0	1	1	0	0	130	36	1	119	29	0
252008	Language_technology	201502	1	0	0	0	1	1	0	0	131	37	1	120	30	0
252008	Language_technology	201503	1	0	0	0	1	1	0	0	132	38	1	121	31	0
252008	Language_technology	201510	4	0	0	0	1	1	0	0	136	38	1	125	31	0
252008	Language_technology	201608	2	0	0	0	1	0	0	0	138	39	1	125	31	0
252008	Language_technology	201611	1	0	0	0	1	1	0	0	139	40	1	126	32	0
252008	Language_technology	201707	1	0	0	0	1	1	0	0	140	41	1	127	33	0
252008	Language_technology	201712	1	0	0	0	1	1	0	0	141	41	1	128	33	0
17933	Latency_(engineering)	200110	1	0	0	0	1	1	0	0	1	1	0	1	1	0
17933	Latency_(engineering)	200201	1	0	0	0	1	1	0	0	2	2	0	2	2	0
17933	Latency_(engineering)	200202	1	0	0	0	1	1	0	0	3	3	0	3	2	0
17933	Latency_(engineering)	200209	1	0	0	0	1	1	0	0	4	4	0	4	2	0
17933	Latency_(engineering)	200301	1	0	0	0	1	1	0	0	5	5	0	5	3	0
17933	Latency_(engineering)	200307	1	0	0	0	1	0	0	0	6	6	0	5	3	0
17933	Latency_(engineering)	200308	3	0	0	0	1	1	0	0	9	7	0	8	4	0
17933	Latency_(engineering)	200312	6	0	0	0	2	1	0	0	15	9	0	9	5	0
17933	Latency_(engineering)	200403	1	0	0	0	1	1	0	0	16	10	0	10	6	0
17933	Latency_(engineering)	200404	2	1	0	0	2	1	1	0	18	12	1	11	7	0
17933	Latency_(engineering)	200405	2	0	0	0	2	2	0	0	20	14	1	13	9	0
17933	Latency_(engineering)	200407	1	0	0	0	1	0	0	0	21	15	1	13	9	0
17933	Latency_(engineering)	200408	2	0	0	0	2	1	0	0	23	17	1	14	10	0
17933	Latency_(engineering)	200409	1	0	0	0	1	1	0	0	24	18	1	15	11	0
17933	Latency_(engineering)	200410	1	0	0	0	1	1	0	0	25	19	1	16	12	0
17933	Latency_(engineering)	200411	4	1	0	0	4	1	1	0	29	23	2	17	13	0
17933	Latency_(engineering)	200412	1	0	0	0	1	1	0	0	30	24	2	18	14	0
17933	Latency_(engineering)	200501	2	0	0	0	2	2	0	0	32	26	2	20	16	0
17933	Latency_(engineering)	200504	3	1	0	0	3	1	1	0	35	29	3	21	17	0
17933	Latency_(engineering)	200505	2	0	0	0	2	2	0	0	37	31	3	23	19	0
17933	Latency_(engineering)	200506	2	0	0	0	1	1	0	0	39	32	3	25	20	0
17933	Latency_(engineering)	200507	5	0	0	0	4	3	0	0	44	36	3	29	23	0
17933	Latency_(engineering)	200508	13	1	0	0	9	6	1	0	57	43	4	37	27	0
17933	Latency_(engineering)	200509	3	1	0	0	3	2	1	0	60	45	5	39	28	0
17933	Latency_(engineering)	200510	2	0	0	0	2	1	0	0	62	47	5	40	29	0
17933	Latency_(engineering)	200602	3	0	0	0	2	1	0	0	65	49	5	41	30	0
17933	Latency_(engineering)	200603	1	0	0	0	1	1	0	0	66	50	5	42	31	0
17933	Latency_(engineering)	200605	1	0	0	0	1	0	0	0	67	51	5	42	31	0
17933	Latency_(engineering)	200606	3	0	0	0	2	2	0	0	70	53	5	45	33	0
17933	Latency_(engineering)	200607	2	0	0	0	2	1	0	0	72	55	5	46	34	0
17933	Latency_(engineering)	200608	1	0	0	0	1	0	0	0	73	56	5	46	34	0
17933	Latency_(engineering)	200609	2	0	0	0	2	2	0	0	75	58	5	48	36	0
17933	Latency_(engineering)	200610	2	0	0	0	1	0	0	0	77	59	5	48	36	0
17933	Latency_(engineering)	200612	2	0	0	0	2	1	0	0	79	61	5	49	37	0
17933	Latency_(engineering)	200701	4	0	0	0	3	3	0	0	83	64	5	53	40	0
17933	Latency_(engineering)	200703	4	0	0	0	3	2	0	0	87	66	5	55	41	0
17933	Latency_(engineering)	200704	7	0	0	0	5	2	0	0	94	71	5	57	43	0
17933	Latency_(engineering)	200705	7	1	0	0	5	5	1	0	101	76	6	64	48	1
17933	Latency_(engineering)	200706	3	0	0	0	3	0	0	0	104	79	6	64	48	1
17933	Latency_(engineering)	200707	5	0	0	0	5	2	0	0	109	84	6	66	50	1
17933	Latency_(engineering)	200709	5	0	0	0	5	3	0	0	114	89	6	69	53	1
17933	Latency_(engineering)	200710	1	0	0	0	1	1	0	0	115	90	6	70	54	1
17933	Latency_(engineering)	200711	3	0	0	0	3	1	0	0	118	93	6	71	55	1
17933	Latency_(engineering)	200712	2	0	0	0	2	0	0	0	120	95	6	71	55	1
17933	Latency_(engineering)	200801	1	0	0	0	1	0	0	0	121	96	6	71	55	1
17933	Latency_(engineering)	200802	2	0	0	0	2	1	0	0	123	98	6	72	56	1
17933	Latency_(engineering)	200803	1	0	0	0	1	1	0	0	124	99	6	73	57	1
17933	Latency_(engineering)	200804	1	0	0	0	1	1	0	0	125	100	6	74	58	1
17933	Latency_(engineering)	200807	4	0	0	0	4	4	0	0	129	103	6	78	61	1
17933	Latency_(engineering)	200808	2	1	0	0	2	1	1	0	131	105	7	79	62	1
17933	Latency_(engineering)	200809	1	0	0	0	1	1	0	0	132	106	7	80	63	1
17933	Latency_(engineering)	200811	2	0	0	0	2	2	0	0	134	108	7	82	65	1
17933	Latency_(engineering)	200812	5	1	0	0	4	3	1	0	139	111	8	85	67	1
17933	Latency_(engineering)	200901	1	0	0	0	1	1	0	0	140	112	8	86	68	1
17933	Latency_(engineering)	200902	2	0	0	0	2	1	0	0	142	114	8	87	69	1
17933	Latency_(engineering)	200903	2	1	0	0	2	1	1	0	144	115	9	88	69	1
17933	Latency_(engineering)	200904	2	0	0	0	2	1	0	0	146	116	9	89	69	1
17933	Latency_(engineering)	200905	3	0	0	0	3	3	0	0	149	118	9	92	71	1
17933	Latency_(engineering)	200906	3	1	0	0	3	2	1	0	152	120	10	94	72	1
17933	Latency_(engineering)	200907	5	0	0	0	4	3	0	0	157	123	10	98	74	1
17933	Latency_(engineering)	200908	3	1	0	0	3	1	1	0	160	125	11	99	74	1
17933	Latency_(engineering)	200909	1	0	0	0	1	0	0	0	161	126	11	99	74	1
17933	Latency_(engineering)	200910	4	0	0	0	3	2	0	0	165	129	11	101	76	1
17933	Latency_(engineering)	200911	3	1	0	0	2	1	1	0	168	131	12	102	77	1
17933	Latency_(engineering)	200912	4	1	0	0	4	2	1	0	172	135	13	104	79	1
17933	Latency_(engineering)	201001	2	0	0	0	2	0	0	0	174	137	13	104	79	1
17933	Latency_(engineering)	201002	1	0	0	0	1	0	0	0	175	138	13	104	79	1
17933	Latency_(engineering)	201004	5	0	0	0	3	2	0	0	180	141	13	107	81	1
17933	Latency_(engineering)	201005	1	0	0	0	1	0	0	0	181	142	13	107	81	1
17933	Latency_(engineering)	201006	1	0	0	0	1	0	0	0	182	143	13	107	81	1
17933	Latency_(engineering)	201007	3	1	0	0	3	2	1	0	185	144	14	109	81	1
17933	Latency_(engineering)	201008	5	0	0	0	4	2	0	0	190	148	14	111	83	1
17933	Latency_(engineering)	201009	5	0	0	0	4	2	0	0	195	152	14	114	85	1
17933	Latency_(engineering)	201010	7	0	0	0	4	2	0	0	202	155	14	116	86	1
17933	Latency_(engineering)	201011	4	1	0	0	4	1	1	0	206	159	15	117	87	1
17933	Latency_(engineering)	201012	4	1	0	0	3	1	1	0	210	161	16	118	87	1
17933	Latency_(engineering)	201101	1	0	0	0	1	0	0	0	211	162	16	118	87	1
17933	Latency_(engineering)	201102	1	0	0	0	1	0	0	0	212	163	16	118	87	1
17933	Latency_(engineering)	201103	1	0	0	0	1	0	0	0	213	164	16	118	87	1
17933	Latency_(engineering)	201104	8	0	0	0	6	5	0	0	221	170	16	125	92	1
17933	Latency_(engineering)	201105	3	0	0	0	2	2	0	0	224	172	16	128	94	1
17933	Latency_(engineering)	201106	1	0	0	0	1	0	0	0	225	173	16	128	94	1
17933	Latency_(engineering)	201107	4	1	0	0	4	3	1	0	229	175	17	131	95	1
17933	Latency_(engineering)	201108	7	1	0	0	7	5	1	0	236	181	18	136	99	1
17933	Latency_(engineering)	201109	4	1	0	0	4	3	1	0	240	184	19	139	101	1
17933	Latency_(engineering)	201110	3	1	0	0	3	3	1	0	243	187	20	142	104	2
17933	Latency_(engineering)	201111	2	0	0	0	2	1	0	0	245	189	20	143	105	2
17933	Latency_(engineering)	201112	3	0	0	0	1	1	0	0	248	190	20	146	106	2
17933	Latency_(engineering)	201201	2	1	0	0	2	1	1	0	250	191	21	147	106	2
17933	Latency_(engineering)	201202	4	0	0	0	3	1	0	0	254	194	21	148	107	2
17933	Latency_(engineering)	201203	1	0	0	0	1	0	0	0	255	195	21	148	107	2
17933	Latency_(engineering)	201204	7	0	0	0	6	3	0	0	262	201	21	152	110	2
17933	Latency_(engineering)	201205	3	0	0	0	2	2	0	0	265	202	21	155	111	2
17933	Latency_(engineering)	201206	1	0	0	0	1	1	0	0	266	203	21	156	112	2
17933	Latency_(engineering)	201207	4	0	0	0	2	2	0	0	270	204	21	160	113	2
17933	Latency_(engineering)	201209	3	0	0	0	3	2	0	0	273	206	21	162	114	2
17933	Latency_(engineering)	201210	2	1	0	0	2	1	1	0	275	207	22	163	114	2
17933	Latency_(engineering)	201211	10	2	0	0	7	4	2	0	285	212	24	170	116	2
17933	Latency_(engineering)	201301	3	1	0	0	3	2	1	0	288	215	25	172	118	2
17933	Latency_(engineering)	201302	1	0	0	0	1	0	0	0	289	216	25	172	118	2
17933	Latency_(engineering)	201303	3	0	0	0	3	2	0	0	292	219	25	174	120	2
17933	Latency_(engineering)	201305	8	1	0	0	7	3	1	0	300	225	26	177	122	2
17933	Latency_(engineering)	201306	3	0	0	0	2	0	0	0	303	227	26	177	122	2
17933	Latency_(engineering)	201307	3	1	0	0	3	2	1	0	306	230	27	179	124	2
17933	Latency_(engineering)	201308	2	1	0	0	2	0	1	0	308	232	28	179	124	2
17933	Latency_(engineering)	201309	7	0	0	0	4	2	0	0	315	236	28	182	126	2
17933	Latency_(engineering)	201311	3	1	0	0	3	1	1	0	318	239	29	183	127	2
17933	Latency_(engineering)	201312	9	0	0	0	5	3	0	0	327	242	29	186	128	2
17933	Latency_(engineering)	201401	5	1	0	0	4	3	1	0	332	246	30	189	131	2
17933	Latency_(engineering)	201402	5	1	0	0	4	2	1	0	337	250	31	191	133	2
17933	Latency_(engineering)	201403	1	0	0	0	1	1	0	0	338	251	31	192	134	2
17933	Latency_(engineering)	201404	3	1	0	0	3	3	1	0	341	253	32	195	136	3
17933	Latency_(engineering)	201406	2	0	0	0	2	1	0	0	343	254	32	196	136	3
17933	Latency_(engineering)	201408	1	0	0	0	1	1	0	0	344	255	32	197	137	3
17933	Latency_(engineering)	201410	2	1	0	0	2	1	1	0	346	256	33	198	137	3
17933	Latency_(engineering)	201412	5	1	0	0	4	3	1	0	351	259	34	202	139	3
17933	Latency_(engineering)	201502	4	2	1	0	3	2	2	1	355	262	36	205	141	5
17933	Latency_(engineering)	201503	5	0	0	0	1	0	0	0	360	263	36	205	141	5
17933	Latency_(engineering)	201504	5	1	0	0	3	2	1	0	365	264	37	209	141	5
17933	Latency_(engineering)	201505	6	0	0	0	5	5	0	0	371	266	37	215	142	5
17933	Latency_(engineering)	201507	3	0	0	0	2	1	0	0	374	267	37	217	142	5
17933	Latency_(engineering)	201510	1	0	0	0	1	1	0	0	375	268	37	218	143	5
17933	Latency_(engineering)	201601	1	0	0	0	1	1	0	0	376	269	37	219	144	5
17933	Latency_(engineering)	201602	2	0	0	0	2	2	0	0	378	269	37	221	144	5
17933	Latency_(engineering)	201604	4	1	0	0	4	4	1	0	382	272	38	225	146	6
17933	Latency_(engineering)	201605	2	0	0	0	1	0	0	0	384	273	38	225	146	6
17933	Latency_(engineering)	201607	2	0	0	0	2	0	0	0	386	275	38	225	146	6
17933	Latency_(engineering)	201608	1	0	0	0	1	1	0	0	387	276	38	226	147	6
17933	Latency_(engineering)	201610	1	0	0	0	1	1	0	0	388	277	38	227	148	6
17933	Latency_(engineering)	201612	1	0	0	0	1	1	0	0	389	278	38	228	149	6
17933	Latency_(engineering)	201702	1	0	0	0	1	1	0	0	390	279	38	229	150	6
17933	Latency_(engineering)	201703	1	0	0	0	1	1	0	0	391	279	38	230	150	6
17933	Latency_(engineering)	201707	4	2	0	0	4	3	2	0	395	282	40	233	152	7
17933	Latency_(engineering)	201708	6	2	0	0	6	5	2	0	401	287	42	238	155	8
17933	Latency_(engineering)	201712	2	0	0	0	2	2	0	0	403	288	42	240	156	8
17933	Latency_(engineering)	201801	1	0	0	0	1	1	0	0	404	289	42	241	157	8
17933	Latency_(engineering)	201802	2	0	0	0	2	1	0	0	406	290	42	242	157	8
17933	Latency_(engineering)	201803	1	0	0	0	1	1	0	0	407	291	42	243	158	8
17933	Latency_(engineering)	201804	1	0	0	0	1	1	0	0	408	291	42	244	158	8
17933	Latency_(engineering)	201805	1	0	0	0	1	1	0	0	409	292	42	245	159	8
17933	Latency_(engineering)	201806	3	1	0	0	3	2	1	0	412	294	43	247	159	8
350705	Layer_2_Tunneling_Protocol	200311	2	0	0	0	2	1	0	0	2	2	0	1	1	0
350705	Layer_2_Tunneling_Protocol	200406	1	0	0	0	1	0	0	0	3	3	0	1	1	0
350705	Layer_2_Tunneling_Protocol	200408	3	0	0	0	1	1	0	0	6	4	0	4	2	0
350705	Layer_2_Tunneling_Protocol	200410	1	0	0	0	1	0	0	0	7	5	0	4	2	0
350705	Layer_2_Tunneling_Protocol	200411	6	0	0	0	3	2	0	0	13	8	0	9	4	0
350705	Layer_2_Tunneling_Protocol	200412	3	0	0	0	2	2	0	0	16	9	0	12	5	0
350705	Layer_2_Tunneling_Protocol	200501	4	0	0	0	2	2	0	0	20	11	0	16	7	0
350705	Layer_2_Tunneling_Protocol	200502	1	0	0	0	1	0	0	0	21	12	0	16	7	0
350705	Layer_2_Tunneling_Protocol	200503	1	0	0	0	1	0	0	0	22	13	0	16	7	0
350705	Layer_2_Tunneling_Protocol	200504	2	0	0	0	2	2	0	0	24	14	0	18	8	0
350705	Layer_2_Tunneling_Protocol	200505	1	0	0	0	1	0	0	0	25	15	0	18	8	0
350705	Layer_2_Tunneling_Protocol	200506	3	0	0	0	2	1	0	0	28	16	0	19	9	0
350705	Layer_2_Tunneling_Protocol	200509	1	0	0	0	1	1	0	0	29	17	0	20	10	0
350705	Layer_2_Tunneling_Protocol	200510	2	0	0	0	2	2	0	0	31	19	0	22	12	0
350705	Layer_2_Tunneling_Protocol	200511	2	0	0	0	2	2	0	0	33	21	0	24	14	0
350705	Layer_2_Tunneling_Protocol	200512	4	3	1	0	3	2	3	1	37	24	3	26	16	1
350705	Layer_2_Tunneling_Protocol	200601	4	0	0	0	3	2	0	0	41	26	3	28	17	1
350705	Layer_2_Tunneling_Protocol	200602	5	0	0	0	3	2	0	0	46	29	3	31	19	1
350705	Layer_2_Tunneling_Protocol	200603	3	0	0	0	3	1	0	0	49	32	3	32	20	1
350705	Layer_2_Tunneling_Protocol	200604	2	0	0	0	2	0	0	0	51	34	3	32	20	1
350705	Layer_2_Tunneling_Protocol	200605	4	1	0	0	3	1	1	0	55	37	4	33	21	1
350705	Layer_2_Tunneling_Protocol	200606	1	0	0	0	1	1	0	0	56	38	4	34	22	1
350705	Layer_2_Tunneling_Protocol	200607	2	0	0	0	2	1	0	0	58	40	4	35	23	1
350705	Layer_2_Tunneling_Protocol	200609	2	0	0	0	2	0	0	0	60	42	4	35	23	1
350705	Layer_2_Tunneling_Protocol	200610	4	0	0	0	4	2	0	0	64	46	4	37	25	1
350705	Layer_2_Tunneling_Protocol	200611	9	1	0	0	7	4	1	0	73	53	5	43	29	1
350705	Layer_2_Tunneling_Protocol	200612	5	0	0	0	3	1	0	0	78	56	5	45	30	1
350705	Layer_2_Tunneling_Protocol	200701	4	0	0	0	3	2	0	0	82	58	5	48	31	1
350705	Layer_2_Tunneling_Protocol	200702	4	0	0	0	3	3	0	0	86	61	5	52	34	1
350705	Layer_2_Tunneling_Protocol	200703	2	0	0	0	2	1	0	0	88	63	5	53	35	1
350705	Layer_2_Tunneling_Protocol	200704	8	0	0	0	7	5	0	0	96	69	5	59	39	1
350705	Layer_2_Tunneling_Protocol	200705	19	1	0	0	5	3	1	0	115	73	6	76	41	1
350705	Layer_2_Tunneling_Protocol	200706	4	0	0	0	4	2	0	0	119	75	6	78	41	1
350705	Layer_2_Tunneling_Protocol	200707	3	0	0	0	3	2	0	0	122	78	6	80	43	1
350705	Layer_2_Tunneling_Protocol	200709	3	0	0	0	3	1	0	0	125	81	6	81	44	1
350705	Layer_2_Tunneling_Protocol	200710	10	0	0	0	4	0	0	0	135	85	6	81	44	1
350705	Layer_2_Tunneling_Protocol	200711	2	0	0	0	2	0	0	0	137	87	6	81	44	1
350705	Layer_2_Tunneling_Protocol	200712	5	1	0	0	5	4	1	0	142	92	7	85	48	1
350705	Layer_2_Tunneling_Protocol	200801	2	0	0	0	2	1	0	0	144	94	7	86	49	1
350705	Layer_2_Tunneling_Protocol	200802	5	1	0	0	5	3	1	0	149	99	8	89	52	1
350705	Layer_2_Tunneling_Protocol	200803	1	0	0	0	1	0	0	0	150	100	8	89	52	1
350705	Layer_2_Tunneling_Protocol	200804	3	0	0	0	3	0	0	0	153	103	8	89	52	1
350705	Layer_2_Tunneling_Protocol	200805	1	0	0	0	1	0	0	0	154	104	8	89	52	1
350705	Layer_2_Tunneling_Protocol	200807	4	1	0	0	4	2	1	0	158	108	9	91	54	1
350705	Layer_2_Tunneling_Protocol	200808	2	0	0	0	2	1	0	0	160	110	9	92	55	1
350705	Layer_2_Tunneling_Protocol	200809	2	1	0	0	2	1	1	0	162	112	10	93	56	1
350705	Layer_2_Tunneling_Protocol	200810	2	0	0	0	2	0	0	0	164	114	10	93	56	1
350705	Layer_2_Tunneling_Protocol	200811	7	0	0	0	2	1	0	0	171	116	10	98	57	1
350705	Layer_2_Tunneling_Protocol	200812	3	1	0	0	3	2	1	0	174	119	11	100	59	1
350705	Layer_2_Tunneling_Protocol	200901	1	0	0	0	1	0	0	0	175	120	11	100	59	1
350705	Layer_2_Tunneling_Protocol	200902	5	0	0	0	1	0	0	0	180	121	11	100	59	1
350705	Layer_2_Tunneling_Protocol	200903	5	0	0	0	2	1	0	0	185	123	11	104	60	1
350705	Layer_2_Tunneling_Protocol	200904	6	1	0	0	6	5	1	0	191	128	12	109	64	2
350705	Layer_2_Tunneling_Protocol	200905	2	0	0	0	2	1	0	0	193	129	12	110	64	2
350705	Layer_2_Tunneling_Protocol	200906	2	0	0	0	2	1	0	0	195	131	12	111	65	2
350705	Layer_2_Tunneling_Protocol	200907	6	1	0	0	3	2	1	0	201	133	13	114	66	3
350705	Layer_2_Tunneling_Protocol	200908	3	0	0	0	2	2	0	0	204	135	13	117	68	3
350705	Layer_2_Tunneling_Protocol	200909	3	0	0	0	2	0	0	0	207	137	13	117	68	3
350705	Layer_2_Tunneling_Protocol	200910	2	0	0	0	2	1	0	0	209	139	13	118	69	3
350705	Layer_2_Tunneling_Protocol	200911	2	0	0	0	2	0	0	0	211	141	13	118	69	3
350705	Layer_2_Tunneling_Protocol	200912	3	0	0	0	3	2	0	0	214	144	13	120	71	3
350705	Layer_2_Tunneling_Protocol	201002	2	0	0	0	1	0	0	0	216	145	13	120	71	3
350705	Layer_2_Tunneling_Protocol	201003	2	0	0	0	2	1	0	0	218	147	13	121	72	3
350705	Layer_2_Tunneling_Protocol	201004	3	0	0	0	3	1	0	0	221	150	13	122	73	3
350705	Layer_2_Tunneling_Protocol	201006	2	0	0	0	2	0	0	0	223	152	13	122	73	3
350705	Layer_2_Tunneling_Protocol	201007	4	0	0	0	1	1	0	0	227	152	13	126	73	3
350705	Layer_2_Tunneling_Protocol	201008	7	0	0	0	4	3	0	0	234	155	13	132	75	3
350705	Layer_2_Tunneling_Protocol	201009	3	0	0	0	2	1	0	0	237	156	13	134	75	3
350705	Layer_2_Tunneling_Protocol	201012	4	0	0	0	3	1	0	0	241	159	13	135	76	3
350705	Layer_2_Tunneling_Protocol	201101	1	0	0	0	1	0	0	0	242	160	13	135	76	3
350705	Layer_2_Tunneling_Protocol	201103	8	1	0	0	5	2	1	0	250	164	14	138	77	3
350705	Layer_2_Tunneling_Protocol	201104	3	1	0	0	3	1	1	0	253	166	15	139	77	3
350705	Layer_2_Tunneling_Protocol	201105	3	1	0	0	3	2	1	0	256	169	16	141	79	3
350705	Layer_2_Tunneling_Protocol	201108	1	0	0	0	1	1	0	0	257	170	16	142	80	3
350705	Layer_2_Tunneling_Protocol	201110	1	0	0	0	1	1	0	0	258	171	16	143	81	3
350705	Layer_2_Tunneling_Protocol	201111	1	0	0	0	1	1	0	0	259	172	16	144	82	3
350705	Layer_2_Tunneling_Protocol	201112	2	0	0	0	2	1	0	0	261	174	16	145	83	3
350705	Layer_2_Tunneling_Protocol	201201	6	3	1	0	4	3	3	1	267	178	19	148	86	4
350705	Layer_2_Tunneling_Protocol	201203	2	0	0	0	2	1	0	0	269	180	19	149	87	4
350705	Layer_2_Tunneling_Protocol	201204	5	0	0	0	1	1	0	0	274	180	19	154	87	4
350705	Layer_2_Tunneling_Protocol	201205	6	0	0	0	5	3	0	0	280	185	19	157	90	4
350705	Layer_2_Tunneling_Protocol	201206	1	0	0	0	1	0	0	0	281	186	19	157	90	4
350705	Layer_2_Tunneling_Protocol	201207	5	0	0	0	3	2	0	0	286	189	19	161	92	4
350705	Layer_2_Tunneling_Protocol	201208	3	0	0	0	3	1	0	0	289	192	19	162	93	4
350705	Layer_2_Tunneling_Protocol	201209	3	0	0	0	2	0	0	0	292	194	19	162	93	4
350705	Layer_2_Tunneling_Protocol	201210	2	0	0	0	2	1	0	0	294	196	19	163	94	4
350705	Layer_2_Tunneling_Protocol	201302	4	0	0	0	2	2	0	0	298	197	19	167	95	4
350705	Layer_2_Tunneling_Protocol	201304	2	0	0	0	2	2	0	0	300	199	19	169	97	4
350705	Layer_2_Tunneling_Protocol	201307	2	1	0	0	2	1	1	0	302	201	20	170	98	4
350705	Layer_2_Tunneling_Protocol	201309	1	0	0	0	1	1	0	0	303	202	20	171	99	4
350705	Layer_2_Tunneling_Protocol	201310	1	0	0	0	1	1	0	0	304	203	20	172	100	4
350705	Layer_2_Tunneling_Protocol	201312	1	0	0	0	1	1	0	0	305	204	20	173	101	4
350705	Layer_2_Tunneling_Protocol	201403	2	0	0	0	1	1	0	0	307	205	20	175	102	4
350705	Layer_2_Tunneling_Protocol	201407	2	0	0	0	2	2	0	0	309	206	20	177	103	4
350705	Layer_2_Tunneling_Protocol	201410	1	0	0	0	1	1	0	0	310	207	20	178	104	4
350705	Layer_2_Tunneling_Protocol	201412	1	0	0	0	1	1	0	0	311	208	20	179	105	4
350705	Layer_2_Tunneling_Protocol	201506	3	1	0	0	3	3	1	0	314	211	21	182	108	5
350705	Layer_2_Tunneling_Protocol	201508	1	0	0	0	1	0	0	0	315	212	21	182	108	5
350705	Layer_2_Tunneling_Protocol	201509	2	0	0	0	1	0	0	0	317	213	21	182	108	5
350705	Layer_2_Tunneling_Protocol	201510	2	0	0	0	2	0	0	0	319	215	21	182	108	5
350705	Layer_2_Tunneling_Protocol	201511	2	1	0	0	2	1	1	0	321	217	22	183	109	5
350705	Layer_2_Tunneling_Protocol	201512	1	0	0	0	1	0	0	0	322	218	22	183	109	5
350705	Layer_2_Tunneling_Protocol	201605	3	0	0	0	1	1	0	0	325	219	22	186	110	5
350705	Layer_2_Tunneling_Protocol	201607	1	0	0	0	1	1	0	0	326	220	22	187	111	5
350705	Layer_2_Tunneling_Protocol	201608	3	1	0	0	3	1	1	0	329	223	23	188	112	5
350705	Layer_2_Tunneling_Protocol	201609	4	1	0	0	4	1	1	0	333	226	24	189	112	5
350705	Layer_2_Tunneling_Protocol	201610	1	0	0	0	1	0	0	0	334	227	24	189	112	5
350705	Layer_2_Tunneling_Protocol	201704	1	0	0	0	1	0	0	0	335	228	24	189	112	5
350705	Layer_2_Tunneling_Protocol	201706	1	0	0	0	1	0	0	0	336	229	24	189	112	5
350705	Layer_2_Tunneling_Protocol	201708	1	0	0	0	1	1	0	0	337	230	24	190	113	5
350705	Layer_2_Tunneling_Protocol	201709	1	0	0	0	1	0	0	0	338	231	24	190	113	5
350705	Layer_2_Tunneling_Protocol	201711	1	0	0	0	1	0	0	0	339	232	24	190	113	5
350705	Layer_2_Tunneling_Protocol	201712	4	2	0	0	3	2	2	0	343	235	26	193	115	7
350705	Layer_2_Tunneling_Protocol	201802	3	0	0	0	3	2	0	0	346	238	26	195	117	7
350705	Layer_2_Tunneling_Protocol	201803	1	0	0	0	1	1	0	0	347	239	26	196	118	7
18508	Lightweight_Directory_Access_Protocol	200202	4	0	0	0	4	4	0	0	4	4	0	4	3	0
18508	Lightweight_Directory_Access_Protocol	200207	1	0	0	0	1	1	0	0	5	5	0	5	4	0
18508	Lightweight_Directory_Access_Protocol	200209	2	0	0	0	2	1	0	0	7	7	0	6	5	0
18508	Lightweight_Directory_Access_Protocol	200210	1	0	0	0	1	1	0	0	8	8	0	7	6	0
18508	Lightweight_Directory_Access_Protocol	200301	1	0	0	0	1	1	0	0	9	9	0	8	7	0
18508	Lightweight_Directory_Access_Protocol	200305	1	0	0	0	1	1	0	0	10	10	0	9	8	0
18508	Lightweight_Directory_Access_Protocol	200306	3	0	0	0	2	2	0	0	13	12	0	12	10	0
18508	Lightweight_Directory_Access_Protocol	200307	1	0	0	0	1	0	0	0	14	13	0	12	10	0
18508	Lightweight_Directory_Access_Protocol	200308	1	0	0	0	1	1	0	0	15	14	0	13	11	0
18508	Lightweight_Directory_Access_Protocol	200309	4	0	0	0	2	2	0	0	19	16	0	17	13	0
18508	Lightweight_Directory_Access_Protocol	200310	1	0	0	0	1	1	0	0	20	17	0	18	14	0
18508	Lightweight_Directory_Access_Protocol	200311	2	0	0	0	2	1	0	0	22	19	0	19	15	0
18508	Lightweight_Directory_Access_Protocol	200312	1	0	0	0	1	0	0	0	23	20	0	19	15	0
18508	Lightweight_Directory_Access_Protocol	200402	2	0	0	0	1	1	0	0	25	21	0	21	16	0
18508	Lightweight_Directory_Access_Protocol	200403	2	0	0	0	1	1	0	0	27	22	0	23	17	0
18508	Lightweight_Directory_Access_Protocol	200405	3	0	0	0	2	1	0	0	30	24	0	24	18	0
18508	Lightweight_Directory_Access_Protocol	200406	3	0	0	0	2	1	0	0	33	26	0	26	19	0
18508	Lightweight_Directory_Access_Protocol	200407	4	0	0	0	4	3	0	0	37	29	0	29	22	0
18508	Lightweight_Directory_Access_Protocol	200408	1	0	0	0	1	0	0	0	38	30	0	29	22	0
18508	Lightweight_Directory_Access_Protocol	200409	3	0	0	0	3	3	0	0	41	33	0	32	25	0
18508	Lightweight_Directory_Access_Protocol	200410	4	0	0	0	4	3	0	0	45	37	0	35	28	0
18508	Lightweight_Directory_Access_Protocol	200411	3	0	0	0	3	2	0	0	48	40	0	37	30	0
18508	Lightweight_Directory_Access_Protocol	200501	5	0	0	0	4	3	0	0	53	44	0	41	33	0
18508	Lightweight_Directory_Access_Protocol	200502	4	0	0	0	4	2	0	0	57	47	0	43	34	0
18508	Lightweight_Directory_Access_Protocol	200503	5	0	0	0	4	0	0	0	62	51	0	43	34	0
18508	Lightweight_Directory_Access_Protocol	200504	1	0	0	0	1	1	0	0	63	52	0	44	35	0
18508	Lightweight_Directory_Access_Protocol	200505	8	0	0	0	7	3	0	0	71	58	0	48	37	0
18508	Lightweight_Directory_Access_Protocol	200506	7	0	0	0	4	0	0	0	78	62	0	48	37	0
18508	Lightweight_Directory_Access_Protocol	200507	6	0	0	0	5	1	0	0	84	67	0	49	38	0
18508	Lightweight_Directory_Access_Protocol	200508	12	0	0	0	9	3	0	0	96	76	0	52	41	0
18508	Lightweight_Directory_Access_Protocol	200509	13	1	0	0	10	5	1	0	109	85	1	57	45	0
18508	Lightweight_Directory_Access_Protocol	200510	13	0	0	0	8	4	0	0	122	93	1	61	49	0
18508	Lightweight_Directory_Access_Protocol	200511	11	1	0	0	10	3	1	0	133	103	2	64	52	0
18508	Lightweight_Directory_Access_Protocol	200512	12	3	0	0	7	5	2	0	145	108	5	72	55	1
18508	Lightweight_Directory_Access_Protocol	200601	23	1	0	0	13	4	1	0	168	117	6	81	57	1
18508	Lightweight_Directory_Access_Protocol	200602	38	1	0	0	20	13	1	0	206	134	7	112	67	1
18508	Lightweight_Directory_Access_Protocol	200603	14	3	0	0	11	7	2	0	220	144	10	121	73	1
18508	Lightweight_Directory_Access_Protocol	200604	26	4	0	0	18	8	3	0	246	160	14	133	79	1
18508	Lightweight_Directory_Access_Protocol	200605	30	5	0	0	18	7	4	0	276	175	19	142	83	1
18508	Lightweight_Directory_Access_Protocol	200606	19	2	0	0	14	7	2	0	295	188	21	149	89	1
18508	Lightweight_Directory_Access_Protocol	200607	34	1	0	0	19	7	1	0	329	204	22	158	93	1
18508	Lightweight_Directory_Access_Protocol	200608	22	1	0	0	18	6	1	0	351	221	23	164	98	1
18508	Lightweight_Directory_Access_Protocol	200609	20	1	0	0	15	2	1	0	371	236	24	166	100	1
18508	Lightweight_Directory_Access_Protocol	200610	23	4	1	0	15	4	3	1	394	251	28	171	104	2
18508	Lightweight_Directory_Access_Protocol	200611	36	3	0	0	27	10	3	0	430	276	31	181	112	2
18508	Lightweight_Directory_Access_Protocol	200612	10	1	0	0	8	4	1	0	440	284	32	186	116	2
18508	Lightweight_Directory_Access_Protocol	200701	35	1	0	0	15	8	1	0	475	296	33	213	121	2
18508	Lightweight_Directory_Access_Protocol	200702	36	3	0	0	20	9	1	0	511	312	36	234	127	3
18508	Lightweight_Directory_Access_Protocol	200703	44	7	2	0	17	7	5	1	555	326	43	249	131	3
18508	Lightweight_Directory_Access_Protocol	200704	18	0	0	0	12	4	0	0	573	337	43	256	134	3
18508	Lightweight_Directory_Access_Protocol	200705	15	3	0	0	13	7	3	0	588	349	46	263	140	3
18508	Lightweight_Directory_Access_Protocol	200706	29	2	0	0	20	12	2	0	617	365	48	280	148	3
18508	Lightweight_Directory_Access_Protocol	200707	20	2	0	0	15	7	2	0	637	377	50	291	152	3
18508	Lightweight_Directory_Access_Protocol	200708	8	0	0	0	8	2	0	0	645	384	50	293	153	3
18508	Lightweight_Directory_Access_Protocol	200709	9	2	0	0	7	5	2	0	654	390	52	300	157	4
18508	Lightweight_Directory_Access_Protocol	200710	6	0	0	0	5	2	0	0	660	395	52	302	159	4
18508	Lightweight_Directory_Access_Protocol	200711	14	2	0	0	12	4	2	0	674	406	54	306	162	4
18508	Lightweight_Directory_Access_Protocol	200712	4	0	0	0	3	2	0	0	678	409	54	308	164	4
18508	Lightweight_Directory_Access_Protocol	200801	18	5	0	0	15	4	5	0	696	424	59	313	168	4
18508	Lightweight_Directory_Access_Protocol	200802	23	3	0	0	16	4	3	0	719	438	62	317	171	4
18508	Lightweight_Directory_Access_Protocol	200803	15	7	0	0	8	3	3	0	734	446	69	324	174	4
18508	Lightweight_Directory_Access_Protocol	200804	10	2	0	0	8	3	2	0	744	453	71	328	176	4
18508	Lightweight_Directory_Access_Protocol	200805	5	0	0	0	3	2	0	0	749	456	71	331	178	4
18508	Lightweight_Directory_Access_Protocol	200806	28	4	0	0	22	12	4	0	777	475	75	346	187	5
18508	Lightweight_Directory_Access_Protocol	200807	8	2	0	0	7	3	2	0	785	481	77	349	189	5
18508	Lightweight_Directory_Access_Protocol	200808	13	1	0	0	10	3	1	0	798	490	78	352	191	5
18508	Lightweight_Directory_Access_Protocol	200809	6	2	0	0	6	4	2	0	804	495	80	356	194	5
18508	Lightweight_Directory_Access_Protocol	200810	9	2	0	0	8	3	2	0	813	502	82	359	196	5
18508	Lightweight_Directory_Access_Protocol	200811	9	2	0	0	8	4	2	0	822	509	84	363	199	5
18508	Lightweight_Directory_Access_Protocol	200812	5	1	0	0	4	2	1	0	827	512	85	365	200	5
18508	Lightweight_Directory_Access_Protocol	200901	10	3	0	0	9	4	3	0	837	521	88	369	204	5
18508	Lightweight_Directory_Access_Protocol	200902	6	0	0	0	5	2	0	0	843	526	88	371	206	5
18508	Lightweight_Directory_Access_Protocol	200903	11	1	0	0	7	3	1	0	854	532	89	374	208	5
18508	Lightweight_Directory_Access_Protocol	200904	13	0	0	0	8	2	0	0	867	540	89	380	210	5
18508	Lightweight_Directory_Access_Protocol	200905	13	3	0	0	12	3	3	0	880	552	92	383	213	5
18508	Lightweight_Directory_Access_Protocol	200906	6	0	0	0	5	2	0	0	886	557	92	385	215	5
18508	Lightweight_Directory_Access_Protocol	200907	6	0	0	0	6	4	0	0	892	562	92	389	218	5
18508	Lightweight_Directory_Access_Protocol	200908	3	0	0	0	3	1	0	0	895	565	92	390	219	5
18508	Lightweight_Directory_Access_Protocol	200909	9	2	0	0	9	5	2	0	904	573	94	395	223	5
18508	Lightweight_Directory_Access_Protocol	200910	5	0	0	0	5	3	0	0	909	576	94	398	224	5
18508	Lightweight_Directory_Access_Protocol	200911	21	4	0	0	11	4	2	0	930	585	98	405	226	5
18508	Lightweight_Directory_Access_Protocol	200912	13	4	0	0	8	4	3	0	943	591	102	410	228	5
18508	Lightweight_Directory_Access_Protocol	201001	6	2	0	0	6	2	2	0	949	595	104	412	229	5
18508	Lightweight_Directory_Access_Protocol	201002	9	1	0	0	8	5	1	0	958	602	105	417	233	5
18508	Lightweight_Directory_Access_Protocol	201003	15	1	0	0	11	7	1	0	973	612	106	425	239	5
18508	Lightweight_Directory_Access_Protocol	201004	8	2	0	0	7	2	2	0	981	619	108	428	241	5
18508	Lightweight_Directory_Access_Protocol	201005	7	0	0	0	6	4	0	0	988	624	108	432	244	5
18508	Lightweight_Directory_Access_Protocol	201006	6	1	0	0	6	4	1	0	994	630	109	436	248	5
18508	Lightweight_Directory_Access_Protocol	201007	4	1	0	0	3	2	1	0	998	632	110	438	249	5
18508	Lightweight_Directory_Access_Protocol	201008	7	1	0	0	6	3	1	0	1005	638	111	442	252	5
18508	Lightweight_Directory_Access_Protocol	201009	9	0	0	0	8	6	0	0	1014	644	111	448	256	5
18508	Lightweight_Directory_Access_Protocol	201010	6	2	0	0	6	2	2	0	1020	650	113	450	258	6
18508	Lightweight_Directory_Access_Protocol	201011	12	3	0	0	8	2	1	0	1032	656	116	454	258	6
18508	Lightweight_Directory_Access_Protocol	201012	6	2	0	0	5	2	2	0	1038	660	118	456	259	6
18508	Lightweight_Directory_Access_Protocol	201101	6	2	0	0	5	4	2	0	1044	665	120	460	263	7
18508	Lightweight_Directory_Access_Protocol	201102	15	2	0	0	10	4	2	0	1059	673	122	466	265	7
18508	Lightweight_Directory_Access_Protocol	201103	11	2	0	0	9	5	2	0	1070	679	124	471	267	7
18508	Lightweight_Directory_Access_Protocol	201104	2	0	0	0	2	2	0	0	1072	680	124	473	268	7
18508	Lightweight_Directory_Access_Protocol	201105	5	1	0	0	5	4	1	0	1077	685	125	477	272	7
18508	Lightweight_Directory_Access_Protocol	201106	5	1	0	0	5	4	1	0	1082	688	126	481	274	7
18508	Lightweight_Directory_Access_Protocol	201107	3	0	0	0	3	1	0	0	1085	690	126	482	274	7
18508	Lightweight_Directory_Access_Protocol	201108	11	1	0	0	5	4	1	0	1096	693	127	492	276	7
18508	Lightweight_Directory_Access_Protocol	201109	5	0	0	0	2	2	0	0	1101	694	127	497	277	7
18508	Lightweight_Directory_Access_Protocol	201110	5	0	0	0	2	1	0	0	1106	695	127	501	277	7
18508	Lightweight_Directory_Access_Protocol	201111	2	0	0	0	2	1	0	0	1108	696	127	502	277	7
18508	Lightweight_Directory_Access_Protocol	201112	4	0	0	0	3	2	0	0	1112	698	127	504	278	7
18508	Lightweight_Directory_Access_Protocol	201201	2	0	0	0	2	1	0	0	1114	700	127	505	279	7
18508	Lightweight_Directory_Access_Protocol	201202	2	0	0	0	2	1	0	0	1116	702	127	506	280	7
18508	Lightweight_Directory_Access_Protocol	201203	9	1	0	0	6	3	1	0	1125	707	128	510	282	7
18508	Lightweight_Directory_Access_Protocol	201204	8	2	0	0	6	2	1	0	1133	712	130	513	283	7
18508	Lightweight_Directory_Access_Protocol	201205	11	3	0	0	7	3	2	0	1144	716	133	517	283	7
18508	Lightweight_Directory_Access_Protocol	201206	6	1	0	0	3	2	1	0	1150	718	134	519	284	7
18508	Lightweight_Directory_Access_Protocol	201207	13	2	0	0	7	3	2	0	1163	722	136	526	284	7
18508	Lightweight_Directory_Access_Protocol	201208	8	2	0	0	8	6	2	0	1171	727	138	532	287	7
18508	Lightweight_Directory_Access_Protocol	201209	10	2	0	0	10	6	2	0	1181	735	140	538	291	7
18508	Lightweight_Directory_Access_Protocol	201210	6	0	0	0	6	2	0	0	1187	741	140	540	293	7
18508	Lightweight_Directory_Access_Protocol	201211	10	3	0	0	6	4	3	0	1197	746	143	545	296	7
18508	Lightweight_Directory_Access_Protocol	201212	3	0	0	0	2	1	0	0	1200	747	143	546	296	7
18508	Lightweight_Directory_Access_Protocol	201301	11	2	0	0	7	4	2	0	1211	752	145	551	298	7
18508	Lightweight_Directory_Access_Protocol	201302	8	1	0	0	6	3	1	0	1219	757	146	554	300	7
18508	Lightweight_Directory_Access_Protocol	201303	10	2	0	0	7	4	1	0	1229	763	148	561	303	7
18508	Lightweight_Directory_Access_Protocol	201304	1	1	0	0	1	1	1	0	1230	763	149	562	303	7
18508	Lightweight_Directory_Access_Protocol	201305	14	3	0	0	7	4	2	0	1244	768	152	568	304	8
18508	Lightweight_Directory_Access_Protocol	201306	33	20	3	0	23	7	10	2	1277	787	172	585	307	14
18508	Lightweight_Directory_Access_Protocol	201307	13	2	0	0	10	6	2	0	1290	795	174	592	311	14
18508	Lightweight_Directory_Access_Protocol	201308	10	1	0	0	8	3	1	0	1300	801	175	595	312	14
18508	Lightweight_Directory_Access_Protocol	201309	9	3	0	0	8	3	3	0	1309	807	178	598	313	14
18508	Lightweight_Directory_Access_Protocol	201310	8	2	0	0	8	4	2	0	1317	814	180	602	316	14
18508	Lightweight_Directory_Access_Protocol	201311	4	0	0	0	3	2	0	0	1321	816	180	604	317	14
18508	Lightweight_Directory_Access_Protocol	201312	3	0	0	0	2	1	0	0	1324	818	180	605	318	14
18508	Lightweight_Directory_Access_Protocol	201401	4	1	0	0	4	1	1	0	1328	821	181	606	318	14
18508	Lightweight_Directory_Access_Protocol	201402	14	3	0	0	7	3	3	0	1342	827	184	609	320	14
18508	Lightweight_Directory_Access_Protocol	201403	1	0	0	0	1	1	0	0	1343	828	184	610	321	14
18508	Lightweight_Directory_Access_Protocol	201404	7	1	0	0	4	2	1	0	1350	830	185	612	322	14
18508	Lightweight_Directory_Access_Protocol	201405	13	2	0	0	8	3	2	0	1363	837	187	618	324	14
18508	Lightweight_Directory_Access_Protocol	201406	3	0	0	0	2	2	0	0	1366	838	187	621	325	14
18508	Lightweight_Directory_Access_Protocol	201407	2	0	0	0	1	0	0	0	1368	839	187	621	325	14
18508	Lightweight_Directory_Access_Protocol	201408	4	0	0	0	4	3	0	0	1372	842	187	624	327	14
18508	Lightweight_Directory_Access_Protocol	201409	9	1	0	0	9	3	1	0	1381	850	188	627	329	14
18508	Lightweight_Directory_Access_Protocol	201410	7	0	0	0	5	4	0	0	1388	855	188	633	333	14
18508	Lightweight_Directory_Access_Protocol	201411	6	1	0	0	6	5	1	0	1394	860	189	638	337	14
18508	Lightweight_Directory_Access_Protocol	201412	1	0	0	0	1	1	0	0	1395	860	189	639	337	14
18508	Lightweight_Directory_Access_Protocol	201501	3	1	0	0	3	2	1	0	1398	862	190	641	338	14
18508	Lightweight_Directory_Access_Protocol	201502	2	0	0	0	2	0	0	0	1400	864	190	641	338	14
18508	Lightweight_Directory_Access_Protocol	201503	10	1	0	0	7	5	1	0	1410	869	191	648	341	14
18508	Lightweight_Directory_Access_Protocol	201504	2	1	0	0	2	1	1	0	1412	870	192	649	341	14
18508	Lightweight_Directory_Access_Protocol	201505	4	0	0	0	2	1	0	0	1416	872	192	652	342	14
18508	Lightweight_Directory_Access_Protocol	201507	2	0	0	0	2	2	0	0	1418	873	192	654	343	14
18508	Lightweight_Directory_Access_Protocol	201508	6	1	0	0	6	4	1	0	1424	878	193	658	346	15
18508	Lightweight_Directory_Access_Protocol	201510	5	0	0	0	3	2	0	0	1429	881	193	662	348	15
18508	Lightweight_Directory_Access_Protocol	201512	2	1	0	0	2	1	1	0	1431	883	194	663	349	15
18508	Lightweight_Directory_Access_Protocol	201601	3	1	0	0	2	1	1	0	1434	884	195	664	349	15
18508	Lightweight_Directory_Access_Protocol	201602	14	2	0	0	8	5	2	0	1448	891	197	672	353	15
18508	Lightweight_Directory_Access_Protocol	201603	3	0	0	0	3	2	0	0	1451	893	197	674	354	15
18508	Lightweight_Directory_Access_Protocol	201605	8	2	0	0	7	4	2	0	1459	898	199	678	356	15
18508	Lightweight_Directory_Access_Protocol	201606	2	0	0	0	2	1	0	0	1461	900	199	679	357	15
18508	Lightweight_Directory_Access_Protocol	201607	4	1	0	0	3	1	1	0	1465	902	200	681	357	15
18508	Lightweight_Directory_Access_Protocol	201608	5	1	0	0	5	3	1	0	1470	907	201	684	360	15
18508	Lightweight_Directory_Access_Protocol	201611	3	0	0	0	3	2	0	0	1473	910	201	686	362	15
18508	Lightweight_Directory_Access_Protocol	201612	5	1	0	0	5	3	1	0	1478	913	202	689	363	15
18508	Lightweight_Directory_Access_Protocol	201701	3	1	0	0	3	1	1	0	1481	916	203	690	364	15
18508	Lightweight_Directory_Access_Protocol	201702	1	0	0	0	1	1	0	0	1482	917	203	691	365	15
18508	Lightweight_Directory_Access_Protocol	201703	4	0	0	0	1	0	0	0	1486	918	203	691	365	15
18508	Lightweight_Directory_Access_Protocol	201704	6	2	0	0	4	3	1	0	1492	921	205	696	366	16
18508	Lightweight_Directory_Access_Protocol	201706	1	0	0	0	1	1	0	0	1493	922	205	697	367	16
18508	Lightweight_Directory_Access_Protocol	201708	3	0	0	0	2	0	0	0	1496	924	205	697	367	16
18508	Lightweight_Directory_Access_Protocol	201711	1	0	0	0	1	1	0	0	1497	925	205	698	368	16
18508	Lightweight_Directory_Access_Protocol	201801	1	0	0	0	1	1	0	0	1498	926	205	699	369	16
18508	Lightweight_Directory_Access_Protocol	201803	5	1	0	0	5	4	1	0	1503	931	206	703	372	17
18508	Lightweight_Directory_Access_Protocol	201804	3	0	0	0	2	0	0	0	1506	933	206	703	372	17
18508	Lightweight_Directory_Access_Protocol	201805	2	0	0	0	1	0	0	0	1508	934	206	703	372	17
18508	Lightweight_Directory_Access_Protocol	201807	2	0	0	0	2	2	0	0	1510	936	206	705	374	17
6097297	Linux	200112	5	1	0	0	5	5	1	0	5	5	1	5	2	1
6097297	Linux	200201	7	0	0	0	6	6	0	0	12	11	1	12	6	1
6097297	Linux	200202	1	0	0	0	1	1	0	0	13	12	1	13	6	1
6097297	Linux	200205	2	0	0	0	2	2	0	0	15	14	1	15	8	1
6097297	Linux	200206	2	1	0	0	2	2	1	0	17	16	2	17	10	2
6097297	Linux	200208	5	0	0	0	4	3	0	0	22	20	2	21	13	2
6097297	Linux	200209	2	0	0	0	2	2	0	0	24	22	2	23	15	2
6097297	Linux	200210	1	0	0	0	1	1	0	0	25	23	2	24	16	2
6097297	Linux	200211	3	0	0	0	3	1	0	0	28	26	2	25	17	2
6097297	Linux	200212	3	0	0	0	2	0	0	0	31	28	2	25	17	2
6097297	Linux	200301	9	5	2	0	7	4	4	1	40	35	7	29	21	4
6097297	Linux	200302	8	0	0	0	8	5	0	0	48	43	7	34	26	4
6097297	Linux	200303	4	0	0	0	4	3	0	0	52	47	7	37	29	4
6097297	Linux	200304	2	0	0	0	1	0	0	0	54	48	7	37	29	4
6097297	Linux	200305	3	1	0	0	3	2	1	0	57	51	8	39	31	4
6097297	Linux	200306	10	1	0	0	7	7	1	0	67	56	9	49	36	5
6097297	Linux	200307	14	0	0	0	11	7	0	0	81	65	9	59	41	5
6097297	Linux	200308	14	2	0	0	8	6	1	0	95	72	11	70	46	7
6097297	Linux	200309	8	0	0	0	7	4	0	0	103	79	11	75	50	7
6097297	Linux	200310	42	3	0	0	14	10	2	0	145	89	14	99	56	7
6097297	Linux	200311	29	0	0	0	11	5	0	0	174	96	14	116	58	7
6097297	Linux	200312	37	2	0	0	13	8	2	0	211	105	16	133	62	8
6097297	Linux	200401	45	1	0	0	20	13	1	0	256	123	17	152	73	8
6097297	Linux	200402	74	0	0	0	19	13	0	0	330	136	17	212	81	8
6097297	Linux	200403	89	3	0	0	25	14	2	0	419	156	20	289	90	9
6097297	Linux	200404	104	7	0	0	37	29	3	0	523	189	27	385	115	12
6097297	Linux	200405	46	4	0	0	29	22	4	0	569	210	31	423	129	16
6097297	Linux	200406	55	4	0	0	28	16	2	0	624	231	35	460	139	18
6097297	Linux	200407	113	7	0	0	37	22	3	0	737	259	42	556	153	22
6097297	Linux	200408	115	24	2	0	44	22	15	2	852	296	66	634	169	34
6097297	Linux	200409	63	13	0	0	39	27	9	0	915	328	79	685	189	40
6097297	Linux	200410	118	42	4	0	68	36	24	4	1033	382	121	761	211	55
6097297	Linux	200411	68	14	0	0	40	18	10	0	1101	414	135	794	221	55
6097297	Linux	200412	60	11	0	0	36	23	9	0	1161	439	146	835	233	58
6097297	Linux	200501	61	17	0	0	44	28	14	0	1222	472	163	873	251	62
6097297	Linux	200502	57	10	1	0	42	26	7	1	1279	504	173	911	267	65
6097297	Linux	200503	58	7	0	0	43	17	7	0	1337	542	180	934	279	65
6097297	Linux	200504	82	8	0	0	50	26	7	0	1419	579	188	979	295	67
6097297	Linux	200505	76	15	0	0	57	26	8	0	1495	630	203	1015	316	73
6097297	Linux	200506	61	9	0	0	41	22	9	0	1556	664	212	1039	331	74
6097297	Linux	200507	174	62	19	7	82	41	24	10	1730	727	274	1157	353	104
6097297	Linux	200508	116	25	0	0	58	32	19	0	1846	773	299	1235	373	110
6097297	Linux	200509	123	26	2	1	56	29	14	2	1969	819	325	1314	393	118
6097297	Linux	200510	116	21	1	0	63	27	13	1	2085	870	346	1385	410	123
6097297	Linux	200511	128	29	0	0	77	43	17	0	2213	933	375	1469	440	126
6097297	Linux	200512	133	22	0	0	85	42	17	0	2346	999	397	1538	466	130
6097297	Linux	200601	137	41	0	0	87	42	28	0	2483	1074	438	1605	498	134
6097297	Linux	200602	195	76	7	2	105	54	39	5	2678	1158	514	1714	532	157
6097297	Linux	200603	166	54	5	2	101	50	33	5	2844	1237	568	1805	561	167
6097297	Linux	200604	202	38	3	0	79	50	26	2	3046	1297	606	1958	593	180
6097297	Linux	200605	202	48	5	2	94	41	23	4	3248	1372	654	2079	617	192
6097297	Linux	200606	184	37	2	0	76	46	22	1	3432	1426	691	2215	644	207
6097297	Linux	200607	146	34	6	2	71	40	17	5	3578	1481	725	2315	669	218
6097297	Linux	200608	134	29	3	1	70	40	12	3	3712	1535	754	2415	694	232
6097297	Linux	200609	88	17	0	0	60	35	14	0	3800	1581	771	2471	716	236
6097297	Linux	200610	184	50	3	1	93	47	26	2	3984	1655	821	2586	745	251
6097297	Linux	200611	63	14	0	0	42	32	11	0	4047	1681	835	2634	762	259
6097297	Linux	200612	122	31	2	0	72	45	22	2	4169	1737	866	2714	791	270
6097297	Linux	200701	191	48	13	11	87	48	24	4	4360	1807	914	2840	822	295
6097297	Linux	200702	258	47	1	0	106	62	28	1	4618	1890	961	3030	861	310
6097297	Linux	200703	340	57	4	1	130	69	34	4	4958	1992	1018	3256	903	328
6097297	Linux	200704	291	34	2	1	121	65	23	2	5249	2084	1052	3463	941	337
6097297	Linux	200705	209	53	2	0	105	56	25	2	5458	2169	1105	3589	978	347
6097297	Linux	200706	236	59	2	1	120	65	28	1	5694	2268	1164	3756	1024	369
6097297	Linux	200707	132	39	4	2	82	43	23	3	5826	2331	1203	3829	1049	378
6097297	Linux	200708	225	43	5	2	89	53	25	4	6051	2401	1246	3978	1083	394
6097297	Linux	200709	142	47	3	0	77	38	24	3	6193	2460	1293	4064	1105	405
6097297	Linux	200710	121	33	3	2	73	42	23	3	6314	2520	1326	4147	1134	416
6097297	Linux	200711	114	37	0	0	74	31	19	0	6428	2576	1363	4203	1148	421
6097297	Linux	200712	103	26	0	0	65	30	18	0	6531	2628	1389	4251	1165	423
6097297	Linux	200801	85	25	0	0	51	32	14	0	6616	2662	1414	4310	1182	431
6097297	Linux	200802	156	31	0	0	76	45	20	0	6772	2721	1445	4420	1211	448
6097297	Linux	200803	147	38	3	0	80	47	25	3	6919	2779	1483	4512	1236	463
6097297	Linux	200804	140	50	11	5	76	46	29	7	7059	2836	1533	4603	1263	481
6097297	Linux	200805	126	32	1	0	78	42	22	1	7185	2901	1565	4684	1292	491
6097297	Linux	200806	177	67	11	6	86	51	28	4	7362	2972	1632	4785	1328	506
6097297	Linux	200807	41	7	0	0	28	26	7	0	7403	2988	1639	4823	1342	510
6097297	Linux	200808	138	56	12	4	87	49	29	6	7541	3057	1695	4908	1373	532
6097297	Linux	200809	53	7	1	0	24	24	5	1	7594	3072	1702	4961	1388	539
6097297	Linux	200810	64	8	2	0	28	28	6	2	7658	3084	1710	5025	1400	547
6097297	Linux	200811	69	18	3	1	37	30	15	3	7727	3110	1728	5078	1419	555
6097297	Linux	200812	100	33	3	1	53	34	17	3	7827	3151	1761	5152	1442	570
6097297	Linux	200901	111	32	0	0	71	42	21	0	7938	3200	1793	5227	1462	576
6097297	Linux	200902	117	40	5	2	60	37	22	3	8055	3244	1833	5308	1483	591
6097297	Linux	200903	113	37	2	2	67	39	22	2	8168	3292	1870	5385	1504	601
6097297	Linux	200904	141	40	0	0	84	39	22	0	8309	3358	1910	5464	1526	605
6097297	Linux	200905	74	21	3	1	44	25	14	3	8383	3387	1931	5513	1536	615
6097297	Linux	200906	78	20	0	0	54	28	13	0	8461	3425	1951	5562	1548	617
6097297	Linux	200907	74	26	2	0	56	26	19	2	8535	3469	1977	5601	1562	620
6097297	Linux	200908	89	29	5	1	47	25	15	5	8624	3503	2006	5660	1574	631
6097297	Linux	200909	83	37	18	14	38	19	11	7	8707	3532	2043	5713	1584	652
6097297	Linux	200910	127	37	7	4	58	32	18	4	8834	3575	2080	5789	1602	661
6097297	Linux	200911	95	29	1	0	59	31	17	1	8929	3617	2109	5844	1617	670
6097297	Linux	200912	116	51	10	7	66	36	28	5	9045	3665	2160	5909	1635	684
6097297	Linux	201001	100	26	0	0	59	34	14	0	9145	3705	2186	5975	1652	694
6097297	Linux	201002	98	23	1	0	52	28	14	1	9243	3739	2209	6037	1664	700
6097297	Linux	201003	71	21	0	0	50	23	15	0	9314	3773	2230	6074	1671	703
6097297	Linux	201004	86	23	1	0	47	29	14	1	9400	3810	2253	6131	1691	715
6097297	Linux	201005	63	12	0	0	44	29	9	0	9463	3843	2265	6175	1709	718
6097297	Linux	201006	50	10	0	0	38	20	9	0	9513	3871	2275	6205	1719	719
6097297	Linux	201007	33	6	0	0	28	21	5	0	9546	3890	2281	6229	1731	721
6097297	Linux	201008	60	14	0	0	46	25	11	0	9606	3921	2295	6267	1741	723
6097297	Linux	201009	45	14	0	0	28	18	9	0	9651	3937	2309	6298	1747	728
6097297	Linux	201010	70	22	1	0	45	26	15	1	9721	3969	2331	6343	1760	734
6097297	Linux	201011	67	13	0	0	43	26	8	0	9788	3999	2344	6386	1773	738
6097297	Linux	201012	91	29	0	0	54	28	13	0	9879	4042	2373	6437	1790	744
6097297	Linux	201101	102	25	2	0	47	24	15	2	9981	4073	2398	6505	1798	749
6097297	Linux	201102	59	21	0	0	43	23	16	0	10040	4103	2419	6537	1808	752
6097297	Linux	201103	54	15	0	0	39	27	9	0	10094	4130	2434	6576	1823	758
6097297	Linux	201104	71	20	0	0	52	37	16	0	10165	4167	2454	6629	1845	768
6097297	Linux	201105	59	16	1	0	33	16	9	1	10224	4192	2470	6667	1853	774
6097297	Linux	201106	56	11	2	1	35	20	8	2	10280	4217	2481	6697	1863	777
6097297	Linux	201107	68	24	0	0	41	25	14	0	10348	4247	2505	6733	1877	780
6097297	Linux	201108	47	10	0	0	26	18	8	0	10395	4262	2515	6770	1884	782
6097297	Linux	201109	86	32	19	16	33	22	12	4	10481	4284	2547	6831	1896	796
6097297	Linux	201110	34	5	1	0	13	13	4	1	10515	4289	2552	6865	1901	801
6097297	Linux	201111	8	0	0	0	6	6	0	0	10523	4292	2552	6873	1904	801
6097297	Linux	201112	13	1	0	0	9	9	1	0	10536	4298	2553	6886	1910	802
6097297	Linux	201201	16	4	0	0	12	12	3	0	10552	4305	2557	6902	1917	806
6097297	Linux	201202	18	2	0	0	14	14	2	0	10570	4311	2559	6920	1923	808
6097297	Linux	201203	27	4	0	0	16	16	3	0	10597	4319	2563	6947	1931	812
6097297	Linux	201204	15	2	0	0	12	12	2	0	10612	4324	2565	6962	1936	814
6097297	Linux	201205	6	0	0	0	6	6	0	0	10618	4329	2565	6968	1941	814
6097297	Linux	201206	12	2	0	0	11	11	2	0	10630	4336	2567	6980	1948	816
6097297	Linux	201207	3	0	0	0	3	3	0	0	10633	4337	2567	6983	1949	816
6097297	Linux	201208	3	0	0	0	3	3	0	0	10636	4339	2567	6986	1951	816
6097297	Linux	201209	1	0	0	0	1	1	0	0	10637	4340	2567	6987	1952	816
6097297	Linux	201210	18	1	0	0	13	13	1	0	10655	4348	2568	7005	1960	817
6097297	Linux	201211	14	3	0	0	13	13	3	0	10669	4355	2571	7019	1967	820
6097297	Linux	201212	11	1	0	0	9	9	1	0	10680	4360	2572	7030	1972	821
6097297	Linux	201301	22	3	0	0	14	14	3	0	10702	4370	2575	7052	1982	824
6097297	Linux	201302	21	1	0	0	7	7	1	0	10723	4372	2576	7073	1984	825
6097297	Linux	201303	13	1	0	0	9	9	1	0	10736	4376	2577	7086	1988	826
6097297	Linux	201304	16	1	0	0	12	8	1	0	10752	4385	2578	7098	1993	826
6097297	Linux	201305	35	9	0	0	26	18	8	0	10787	4404	2587	7124	2004	828
6097297	Linux	201306	25	4	0	0	21	18	4	0	10812	4417	2591	7146	2014	830
6097297	Linux	201307	31	11	0	0	24	14	8	0	10843	4437	2602	7165	2024	833
6097297	Linux	201308	29	10	0	0	23	18	9	0	10872	4451	2612	7187	2033	839
6097297	Linux	201309	36	9	0	0	27	15	5	0	10908	4469	2621	7209	2039	841
6097297	Linux	201310	43	12	0	0	32	17	9	0	10951	4491	2633	7233	2046	841
6097297	Linux	201311	43	7	0	0	20	16	7	0	10994	4506	2640	7272	2057	845
6097297	Linux	201312	51	16	0	0	30	18	10	0	11045	4530	2656	7310	2069	849
6097297	Linux	201401	26	8	0	0	15	10	5	0	11071	4540	2664	7330	2074	853
6097297	Linux	201402	49	6	0	0	19	16	5	0	11120	4552	2670	7376	2082	856
6097297	Linux	201403	76	19	1	0	33	22	10	1	11196	4574	2689	7437	2093	863
6097297	Linux	201404	28	7	0	0	16	9	5	0	11224	4585	2696	7458	2097	864
6097297	Linux	201405	29	6	1	0	19	13	6	1	11253	4597	2702	7478	2103	868
6097297	Linux	201406	24	4	0	0	17	14	4	0	11277	4608	2706	7499	2111	869
6097297	Linux	201407	33	10	0	0	26	15	9	0	11310	4624	2716	7521	2116	869
6097297	Linux	201408	55	13	1	0	34	24	9	1	11365	4646	2729	7565	2129	875
6097297	Linux	201409	55	15	3	3	27	17	9	2	11420	4667	2744	7605	2139	881
6097297	Linux	201410	40	13	0	0	30	20	9	0	11460	4685	2757	7633	2146	884
6097297	Linux	201411	64	19	0	0	29	17	11	0	11524	4707	2776	7683	2156	889
6097297	Linux	201412	58	9	1	0	24	18	4	1	11582	4723	2785	7734	2166	894
6097297	Linux	201501	40	7	0	0	20	16	7	0	11622	4734	2792	7769	2173	896
6097297	Linux	201502	31	12	0	0	21	12	6	0	11653	4748	2804	7789	2178	901
6097297	Linux	201503	28	8	0	0	19	14	6	0	11681	4758	2812	7812	2183	905
6097297	Linux	201504	77	27	13	8	26	18	11	5	11758	4777	2839	7878	2193	925
6097297	Linux	201505	33	10	0	0	23	15	8	0	11791	4790	2849	7902	2198	929
6097297	Linux	201506	35	3	0	0	16	10	3	0	11826	4801	2852	7931	2203	929
6097297	Linux	201507	61	21	0	0	35	20	12	0	11887	4827	2873	7976	2214	935
6097297	Linux	201508	44	11	0	0	26	17	7	0	11931	4844	2884	8008	2222	940
6097297	Linux	201509	51	14	0	0	23	15	8	0	11982	4859	2898	8042	2228	945
6097297	Linux	201510	48	18	0	0	24	18	10	0	12030	4872	2916	8082	2235	956
6097297	Linux	201511	17	7	0	0	13	7	5	0	12047	4879	2923	8092	2237	956
6097297	Linux	201512	42	6	0	0	18	15	6	0	12089	4890	2929	8131	2245	959
6097297	Linux	201601	28	5	0	0	17	14	5	0	12117	4898	2934	8153	2250	959
6097297	Linux	201602	38	8	0	0	25	16	7	0	12155	4914	2942	8180	2256	959
6097297	Linux	201603	64	12	2	0	26	21	8	1	12219	4931	2954	8237	2268	966
6097297	Linux	201604	26	6	0	0	21	16	6	0	12245	4943	2960	8257	2274	969
6097297	Linux	201605	33	5	0	0	15	8	4	0	12278	4952	2965	8279	2276	969
6097297	Linux	201606	38	12	0	0	24	13	10	0	12316	4970	2977	8302	2283	969
6097297	Linux	201607	20	5	0	0	14	10	4	0	12336	4979	2982	8313	2287	971
6097297	Linux	201608	21	3	1	0	13	13	3	1	12357	4985	2985	8334	2292	974
6097297	Linux	201609	39	12	1	0	25	16	6	1	12396	5005	2997	8361	2301	976
6097297	Linux	201610	27	9	0	0	19	14	6	0	12423	5017	3006	8381	2308	978
6097297	Linux	201611	19	7	0	0	13	8	5	0	12442	5025	3013	8392	2311	980
6097297	Linux	201612	33	5	0	0	15	12	5	0	12475	5032	3018	8420	2315	982
6097297	Linux	201701	27	7	0	0	22	17	7	0	12502	5047	3025	8439	2325	984
6097297	Linux	201702	34	7	0	0	21	15	7	0	12536	5064	3032	8464	2334	985
6097297	Linux	201703	32	13	0	0	29	17	12	0	12568	5084	3045	8483	2343	989
6097297	Linux	201704	23	8	0	0	18	10	6	0	12591	5097	3053	8497	2347	991
6097297	Linux	201705	10	4	0	0	10	4	4	0	12601	5104	3057	8501	2348	991
6097297	Linux	201706	28	8	0	0	18	14	6	0	12629	5115	3065	8525	2354	995
6097297	Linux	201707	15	4	0	0	13	9	4	0	12644	5123	3069	8535	2357	996
6097297	Linux	201708	13	5	0	0	12	8	4	0	12657	5132	3074	8544	2362	998
6097297	Linux	201709	25	8	0	0	20	15	5	0	12682	5150	3082	8563	2374	1004
6097297	Linux	201710	54	14	0	0	36	32	13	0	12736	5174	3096	8610	2394	1013
6097297	Linux	201711	27	8	0	0	19	17	6	0	12763	5188	3104	8634	2404	1021
6097297	Linux	201712	48	16	0	0	32	25	10	0	12811	5210	3120	8671	2419	1028
6097297	Linux	201801	17	3	0	0	13	9	3	0	12828	5220	3123	8680	2425	1029
6097297	Linux	201802	27	9	0	0	24	17	8	0	12855	5235	3132	8700	2431	1032
6097297	Linux	201803	14	6	0	0	14	10	6	0	12869	5242	3138	8710	2434	1034
6097297	Linux	201804	11	2	0	0	9	5	2	0	12880	5246	3140	8716	2435	1034
6097297	Linux	201805	7	2	0	0	7	6	2	0	12887	5252	3142	8722	2440	1035
6097297	Linux	201806	6	2	0	0	6	5	2	0	12893	5257	3144	8727	2443	1036
6097297	Linux	201807	19	6	0	0	17	14	5	0	12912	5267	3150	8743	2449	1039
9055249	Linux_Foundation	200702	14	1	0	0	11	8	1	0	14	11	1	10	8	1
9055249	Linux_Foundation	200704	1	0	0	0	1	1	0	0	15	12	1	11	9	1
9055249	Linux_Foundation	200705	3	0	0	0	3	3	0	0	18	15	1	14	12	1
9055249	Linux_Foundation	200706	7	0	0	0	3	3	0	0	25	18	1	21	15	1
9055249	Linux_Foundation	200707	1	0	0	0	1	1	0	0	26	18	1	22	15	1
9055249	Linux_Foundation	200708	1	0	0	0	1	1	0	0	27	19	1	23	16	1
9055249	Linux_Foundation	200709	23	0	0	0	4	4	0	0	50	22	1	46	19	1
9055249	Linux_Foundation	200710	3	0	0	0	2	2	0	0	53	24	1	49	21	1
9055249	Linux_Foundation	200711	3	0	0	0	3	2	0	0	56	27	1	51	23	1
9055249	Linux_Foundation	200712	11	0	0	0	4	3	0	0	67	31	1	57	26	1
9055249	Linux_Foundation	200801	5	0	0	0	3	2	0	0	72	34	1	60	28	1
9055249	Linux_Foundation	200802	1	0	0	0	1	1	0	0	73	35	1	61	29	1
9055249	Linux_Foundation	200803	1	0	0	0	1	0	0	0	74	36	1	61	29	1
9055249	Linux_Foundation	200804	4	0	0	0	2	2	0	0	78	37	1	65	30	1
9055249	Linux_Foundation	200805	12	0	0	0	5	4	0	0	90	41	1	76	33	1
9055249	Linux_Foundation	200806	4	0	0	0	3	2	0	0	94	44	1	79	35	1
9055249	Linux_Foundation	200807	2	0	0	0	1	0	0	0	96	45	1	79	35	1
9055249	Linux_Foundation	200808	1	0	0	0	1	1	0	0	97	46	1	80	36	1
9055249	Linux_Foundation	200809	2	0	0	0	2	2	0	0	99	47	1	82	37	1
9055249	Linux_Foundation	200901	5	0	0	0	4	3	0	0	104	49	1	86	38	1
9055249	Linux_Foundation	200903	1	0	0	0	1	1	0	0	105	50	1	87	39	1
9055249	Linux_Foundation	200904	2	0	0	0	2	1	0	0	107	52	1	88	40	1
9055249	Linux_Foundation	200905	1	0	0	0	1	1	0	0	108	53	1	89	41	1
9055249	Linux_Foundation	200906	1	0	0	0	1	1	0	0	109	54	1	90	42	1
9055249	Linux_Foundation	200907	2	0	0	0	2	2	0	0	111	56	1	92	44	1
9055249	Linux_Foundation	200908	2	0	0	0	2	2	0	0	113	58	1	94	46	1
9055249	Linux_Foundation	200909	5	0	0	0	3	1	0	0	118	60	1	97	46	1
9055249	Linux_Foundation	200911	3	0	0	0	3	3	0	0	121	63	1	100	49	1
9055249	Linux_Foundation	200912	2	0	0	0	2	1	0	0	123	65	1	101	50	1
9055249	Linux_Foundation	201001	1	1	0	0	1	1	1	0	124	65	2	102	50	1
9055249	Linux_Foundation	201002	1	0	0	0	1	1	0	0	125	66	2	103	51	1
9055249	Linux_Foundation	201004	3	0	0	0	2	1	0	0	128	68	2	104	52	1
9055249	Linux_Foundation	201005	1	0	0	0	1	1	0	0	129	69	2	105	53	1
9055249	Linux_Foundation	201006	2	0	0	0	2	2	0	0	131	71	2	107	55	1
9055249	Linux_Foundation	201008	1	0	0	0	1	1	0	0	132	72	2	108	56	1
9055249	Linux_Foundation	201010	2	1	0	0	2	1	1	0	134	74	3	109	57	1
9055249	Linux_Foundation	201011	3	0	0	0	3	3	0	0	137	77	3	112	60	1
9055249	Linux_Foundation	201012	3	0	0	0	3	2	0	0	140	80	3	114	62	1
9055249	Linux_Foundation	201101	7	0	0	0	3	1	0	0	147	83	3	118	63	1
9055249	Linux_Foundation	201103	2	0	0	0	2	2	0	0	149	85	3	120	65	1
9055249	Linux_Foundation	201104	1	0	0	0	1	1	0	0	150	86	3	121	66	1
9055249	Linux_Foundation	201106	6	0	0	0	5	5	0	0	156	89	3	127	69	1
9055249	Linux_Foundation	201107	1	0	0	0	1	1	0	0	157	90	3	128	70	1
9055249	Linux_Foundation	201108	1	0	0	0	1	1	0	0	158	90	3	129	70	1
9055249	Linux_Foundation	201109	38	0	0	0	3	3	0	0	196	93	3	167	73	1
9055249	Linux_Foundation	201110	9	0	0	0	7	5	0	0	205	99	3	174	77	1
9055249	Linux_Foundation	201111	1	0	0	0	1	1	0	0	206	99	3	175	77	1
9055249	Linux_Foundation	201112	1	0	0	0	1	0	0	0	207	100	3	175	77	1
9055249	Linux_Foundation	201201	1	0	0	0	1	1	0	0	208	101	3	176	78	1
9055249	Linux_Foundation	201202	6	0	0	0	4	4	0	0	214	104	3	182	81	1
9055249	Linux_Foundation	201203	2	0	0	0	2	1	0	0	216	105	3	183	81	1
9055249	Linux_Foundation	201204	2	0	0	0	2	2	0	0	218	106	3	185	82	1
9055249	Linux_Foundation	201206	1	0	0	0	1	1	0	0	219	107	3	186	83	1
9055249	Linux_Foundation	201207	2	0	0	0	1	1	0	0	221	108	3	188	84	1
9055249	Linux_Foundation	201208	1	0	0	0	1	1	0	0	222	109	3	189	85	1
9055249	Linux_Foundation	201209	1	0	0	0	1	1	0	0	223	110	3	190	86	1
9055249	Linux_Foundation	201210	1	0	0	0	1	0	0	0	224	111	3	190	86	1
9055249	Linux_Foundation	201211	9	1	0	0	7	3	1	0	233	118	4	194	89	1
9055249	Linux_Foundation	201212	9	0	0	0	3	2	0	0	242	119	4	202	89	1
9055249	Linux_Foundation	201301	1	0	0	0	1	0	0	0	243	120	4	202	89	1
9055249	Linux_Foundation	201302	5	0	0	0	5	4	0	0	248	123	4	206	91	1
9055249	Linux_Foundation	201303	12	0	0	0	8	6	0	0	260	129	4	216	95	1
9055249	Linux_Foundation	201304	1	0	0	0	1	1	0	0	261	130	4	217	96	1
9055249	Linux_Foundation	201305	5	0	0	0	4	4	0	0	266	133	4	222	99	1
9055249	Linux_Foundation	201306	1	0	0	0	1	1	0	0	267	133	4	223	99	1
9055249	Linux_Foundation	201307	3	0	0	0	2	1	0	0	270	135	4	225	100	1
9055249	Linux_Foundation	201310	2	0	0	0	2	1	0	0	272	137	4	226	101	1
9055249	Linux_Foundation	201311	7	0	0	0	2	2	0	0	279	139	4	233	103	1
9055249	Linux_Foundation	201403	11	0	0	0	9	6	0	0	290	147	4	241	108	1
9055249	Linux_Foundation	201404	3	0	0	0	3	1	0	0	293	150	4	242	109	1
9055249	Linux_Foundation	201405	5	0	0	0	3	1	0	0	298	152	4	243	109	1
9055249	Linux_Foundation	201406	4	0	0	0	3	3	0	0	302	154	4	247	111	1
9055249	Linux_Foundation	201407	5	0	0	0	2	1	0	0	307	155	4	248	111	1
9055249	Linux_Foundation	201408	1	0	0	0	1	1	0	0	308	155	4	249	111	1
9055249	Linux_Foundation	201409	3	0	0	0	3	2	0	0	311	158	4	251	113	1
9055249	Linux_Foundation	201410	1	0	0	0	1	1	0	0	312	159	4	252	114	1
9055249	Linux_Foundation	201501	2	0	0	0	2	1	0	0	314	161	4	253	115	1
9055249	Linux_Foundation	201502	2	0	0	0	2	0	0	0	316	163	4	253	115	1
9055249	Linux_Foundation	201503	3	0	0	0	2	1	0	0	319	165	4	254	116	1
9055249	Linux_Foundation	201504	4	0	0	0	2	2	0	0	323	167	4	258	118	1
9055249	Linux_Foundation	201505	4	0	0	0	3	2	0	0	327	170	4	261	120	1
9055249	Linux_Foundation	201506	3	0	0	0	2	1	0	0	330	172	4	262	121	1
9055249	Linux_Foundation	201507	2	0	0	0	2	2	0	0	332	174	4	264	123	1
9055249	Linux_Foundation	201509	1	0	0	0	1	1	0	0	333	175	4	265	124	1
9055249	Linux_Foundation	201510	5	0	0	0	4	2	0	0	338	179	4	268	126	1
9055249	Linux_Foundation	201511	1	0	0	0	1	0	0	0	339	180	4	268	126	1
9055249	Linux_Foundation	201512	6	0	0	0	6	4	0	0	345	185	4	272	129	1
9055249	Linux_Foundation	201601	6	0	0	0	5	4	0	0	351	189	4	277	132	1
9055249	Linux_Foundation	201602	2	0	0	0	2	2	0	0	353	191	4	279	134	1
9055249	Linux_Foundation	201603	10	1	0	0	4	3	1	0	363	194	5	288	136	2
9055249	Linux_Foundation	201604	8	0	0	0	3	3	0	0	371	196	5	296	138	2
9055249	Linux_Foundation	201605	7	1	0	0	5	3	1	0	378	199	6	301	139	2
9055249	Linux_Foundation	201606	2	0	0	0	1	0	0	0	380	200	6	301	139	2
9055249	Linux_Foundation	201608	5	0	0	0	4	2	0	0	385	204	6	303	141	2
9055249	Linux_Foundation	201609	4	0	0	0	4	3	0	0	389	208	6	306	144	2
9055249	Linux_Foundation	201610	5	1	0	0	4	4	1	0	394	211	7	311	147	3
9055249	Linux_Foundation	201611	2	0	0	0	1	1	0	0	396	211	7	313	147	3
9055249	Linux_Foundation	201612	11	0	0	0	9	5	0	0	407	220	7	318	152	3
9055249	Linux_Foundation	201701	10	1	0	0	7	5	1	0	417	225	8	326	154	3
9055249	Linux_Foundation	201702	1	0	0	0	1	1	0	0	418	225	8	327	154	3
9055249	Linux_Foundation	201703	5	0	0	0	5	4	0	0	423	229	8	331	156	3
9055249	Linux_Foundation	201704	11	0	0	0	6	6	0	0	434	233	8	342	160	3
9055249	Linux_Foundation	201705	7	0	0	0	2	2	0	0	441	234	8	349	161	3
9055249	Linux_Foundation	201706	16	0	0	0	7	6	0	0	457	240	8	364	165	3
9055249	Linux_Foundation	201707	17	3	1	0	9	7	3	1	474	246	11	378	169	4
9055249	Linux_Foundation	201708	19	0	0	0	8	8	0	0	493	252	11	397	175	4
9055249	Linux_Foundation	201709	3	0	0	0	3	1	0	0	496	255	11	398	176	4
9055249	Linux_Foundation	201710	46	1	0	0	10	9	1	0	542	263	12	443	183	5
9055249	Linux_Foundation	201711	21	0	0	0	9	8	0	0	563	266	12	462	184	5
9055249	Linux_Foundation	201712	12	0	0	0	2	2	0	0	575	267	12	474	185	5
9055249	Linux_Foundation	201801	7	1	0	0	6	6	1	0	582	271	13	481	189	6
9055249	Linux_Foundation	201802	5	0	0	0	4	3	0	0	587	275	13	484	192	6
9055249	Linux_Foundation	201803	6	0	0	0	5	4	0	0	593	279	13	489	195	6
9055249	Linux_Foundation	201804	3	0	0	0	3	3	0	0	596	281	13	492	197	6
9055249	Linux_Foundation	201805	4	0	0	0	3	3	0	0	600	284	13	496	200	6
9055249	Linux_Foundation	201806	1	0	0	0	1	1	0	0	601	285	13	497	201	6
9055249	Linux_Foundation	201807	8	0	0	0	4	1	0	0	609	289	13	501	202	6
18016	Lisp_(programming_language)	200112	2	0	0	0	2	2	0	0	2	2	0	2	2	0
18016	Lisp_(programming_language)	200202	3	0	0	0	2	2	0	0	5	4	0	5	3	0
18016	Lisp_(programming_language)	200205	7	0	0	0	3	3	0	0	12	7	0	12	5	0
18016	Lisp_(programming_language)	200206	3	0	0	0	3	2	0	0	15	10	0	14	7	0
18016	Lisp_(programming_language)	200207	4	0	0	0	3	1	0	0	19	13	0	16	8	0
18016	Lisp_(programming_language)	200208	1	0	0	0	1	0	0	0	20	14	0	16	8	0
18016	Lisp_(programming_language)	200209	3	0	0	0	3	2	0	0	23	16	0	18	9	0
18016	Lisp_(programming_language)	200301	6	0	0	0	6	4	0	0	29	22	0	22	13	0
18016	Lisp_(programming_language)	200302	8	0	0	0	4	3	0	0	37	24	0	29	14	0
18016	Lisp_(programming_language)	200304	4	0	0	0	4	4	0	0	41	28	0	33	18	0
18016	Lisp_(programming_language)	200306	7	1	0	0	5	3	1	0	48	32	1	38	20	1
18016	Lisp_(programming_language)	200307	3	0	0	0	3	2	0	0	51	35	1	40	22	1
18016	Lisp_(programming_language)	200308	8	0	0	0	3	3	0	0	59	36	1	48	23	1
18016	Lisp_(programming_language)	200309	4	0	0	0	4	2	0	0	63	39	1	50	24	1
18016	Lisp_(programming_language)	200310	3	0	0	0	3	3	0	0	66	42	1	53	27	1
18016	Lisp_(programming_language)	200312	3	0	0	0	3	2	0	0	69	44	1	55	28	1
18016	Lisp_(programming_language)	200401	1	0	0	0	1	1	0	0	70	45	1	56	29	1
18016	Lisp_(programming_language)	200402	3	0	0	0	3	2	0	0	73	47	1	58	30	1
18016	Lisp_(programming_language)	200403	6	0	0	0	3	2	0	0	79	50	1	62	32	1
18016	Lisp_(programming_language)	200404	7	0	0	0	5	3	0	0	86	55	1	66	35	1
18016	Lisp_(programming_language)	200405	4	0	0	0	4	3	0	0	90	58	1	69	37	1
18016	Lisp_(programming_language)	200406	17	0	0	0	6	5	0	0	107	62	1	85	40	1
18016	Lisp_(programming_language)	200407	7	0	0	0	6	4	0	0	114	67	1	90	42	1
18016	Lisp_(programming_language)	200408	7	0	0	0	7	3	0	0	121	73	1	93	44	1
18016	Lisp_(programming_language)	200409	16	0	0	0	9	7	0	0	137	81	1	107	50	1
18016	Lisp_(programming_language)	200410	17	1	0	0	15	6	1	0	154	94	2	114	54	1
18016	Lisp_(programming_language)	200411	13	0	0	0	12	7	0	0	167	101	2	122	57	1
18016	Lisp_(programming_language)	200412	13	0	0	0	7	4	0	0	180	106	2	131	60	1
18016	Lisp_(programming_language)	200501	21	1	0	0	12	7	1	0	201	117	3	142	66	1
18016	Lisp_(programming_language)	200502	9	1	0	0	7	5	1	0	210	123	4	147	70	1
18016	Lisp_(programming_language)	200503	9	0	0	0	7	5	0	0	219	129	4	154	74	1
18016	Lisp_(programming_language)	200504	14	3	0	0	11	5	3	0	233	137	7	160	76	2
18016	Lisp_(programming_language)	200505	11	0	0	0	5	3	0	0	244	141	7	167	78	2
18016	Lisp_(programming_language)	200506	32	0	0	0	15	9	0	0	276	154	7	187	85	2
18016	Lisp_(programming_language)	200507	13	1	0	0	10	8	1	0	289	162	8	198	91	2
18016	Lisp_(programming_language)	200508	28	0	0	0	17	10	0	0	317	174	8	215	96	2
18016	Lisp_(programming_language)	200509	7	0	0	0	6	5	0	0	324	180	8	221	101	2
18016	Lisp_(programming_language)	200510	11	1	0	0	8	4	1	0	335	187	9	226	104	2
18016	Lisp_(programming_language)	200511	15	3	0	0	10	4	2	0	350	195	12	235	106	2
18016	Lisp_(programming_language)	200512	24	3	0	0	14	8	3	0	374	206	15	250	112	2
18016	Lisp_(programming_language)	200601	21	2	0	0	14	9	2	0	395	216	17	266	117	3
18016	Lisp_(programming_language)	200602	33	0	0	0	21	13	0	0	428	234	17	291	127	3
18016	Lisp_(programming_language)	200603	11	2	0	0	9	5	2	0	439	240	19	296	129	3
18016	Lisp_(programming_language)	200604	53	10	0	0	29	19	7	0	492	262	29	329	141	5
18016	Lisp_(programming_language)	200605	16	2	1	0	9	5	2	1	508	270	31	339	145	7
18016	Lisp_(programming_language)	200606	14	2	0	0	13	9	2	0	522	281	33	349	152	7
18016	Lisp_(programming_language)	200607	22	4	0	0	17	10	3	0	544	295	37	363	159	8
18016	Lisp_(programming_language)	200608	16	6	2	1	13	8	5	2	560	305	43	372	164	9
18016	Lisp_(programming_language)	200609	32	3	0	0	22	12	3	0	592	323	46	393	172	10
18016	Lisp_(programming_language)	200610	22	4	0	0	18	10	2	0	614	339	50	405	180	10
18016	Lisp_(programming_language)	200611	23	5	1	0	18	14	5	1	637	352	55	423	189	14
18016	Lisp_(programming_language)	200612	28	1	0	0	17	12	1	0	665	365	56	441	197	15
18016	Lisp_(programming_language)	200701	28	1	0	0	19	10	1	0	693	380	57	455	203	15
18016	Lisp_(programming_language)	200702	18	2	0	0	12	6	2	0	711	388	59	461	205	15
18016	Lisp_(programming_language)	200703	39	2	0	0	13	9	2	0	750	400	61	494	213	16
18016	Lisp_(programming_language)	200704	8	0	0	0	6	3	0	0	758	406	61	497	216	16
18016	Lisp_(programming_language)	200705	21	3	0	0	14	8	3	0	779	417	64	511	221	17
18016	Lisp_(programming_language)	200706	22	1	0	0	14	7	1	0	801	429	65	520	226	17
18016	Lisp_(programming_language)	200707	23	2	0	0	15	7	2	0	824	443	67	535	232	17
18016	Lisp_(programming_language)	200708	19	0	0	0	13	7	0	0	843	453	67	546	236	17
18016	Lisp_(programming_language)	200709	35	4	0	0	21	7	4	0	878	472	71	560	241	18
18016	Lisp_(programming_language)	200710	18	2	0	0	14	7	2	0	896	482	73	569	244	18
18016	Lisp_(programming_language)	200711	21	3	0	0	15	6	2	0	917	494	76	581	247	19
18016	Lisp_(programming_language)	200712	20	2	0	0	16	11	2	0	937	506	78	596	254	20
18016	Lisp_(programming_language)	200801	11	0	0	0	11	6	0	0	948	516	78	602	259	20
18016	Lisp_(programming_language)	200802	13	1	0	0	12	7	1	0	961	526	79	609	264	20
18016	Lisp_(programming_language)	200803	23	5	0	0	18	11	4	0	984	541	84	621	272	22
18016	Lisp_(programming_language)	200804	17	0	0	0	13	10	0	0	1001	551	84	632	279	22
18016	Lisp_(programming_language)	200805	11	2	0	0	10	7	2	0	1012	559	86	640	284	23
18016	Lisp_(programming_language)	200806	22	3	0	0	14	10	3	0	1034	570	89	651	291	25
18016	Lisp_(programming_language)	200807	18	5	0	0	13	5	4	0	1052	582	94	657	295	25
18016	Lisp_(programming_language)	200808	7	1	0	0	7	4	1	0	1059	589	95	661	299	26
18016	Lisp_(programming_language)	200809	20	1	0	0	9	6	1	0	1079	597	96	675	304	26
18016	Lisp_(programming_language)	200810	22	4	0	0	15	7	3	0	1101	606	100	683	306	26
18016	Lisp_(programming_language)	200811	17	1	0	0	7	5	1	0	1118	612	101	698	310	27
18016	Lisp_(programming_language)	200812	11	1	0	0	9	3	1	0	1129	619	102	702	311	27
18016	Lisp_(programming_language)	200901	40	3	0	0	10	3	2	0	1169	627	105	729	312	28
18016	Lisp_(programming_language)	200902	33	4	0	0	21	9	3	0	1202	646	109	747	319	29
18016	Lisp_(programming_language)	200903	4	1	0	0	4	3	1	0	1206	650	110	750	322	29
18016	Lisp_(programming_language)	200904	5	0	0	0	5	3	0	0	1211	654	110	753	324	29
18016	Lisp_(programming_language)	200905	8	0	0	0	5	4	0	0	1219	658	110	760	327	29
18016	Lisp_(programming_language)	200906	5	0	0	0	5	3	0	0	1224	663	110	763	330	29
18016	Lisp_(programming_language)	200907	8	0	0	0	6	4	0	0	1232	666	110	768	331	29
18016	Lisp_(programming_language)	200908	8	2	0	0	7	3	2	0	1240	672	112	771	333	29
18016	Lisp_(programming_language)	200909	24	4	0	0	14	9	4	0	1264	682	116	789	338	29
18016	Lisp_(programming_language)	200910	5	1	0	0	4	2	1	0	1269	685	117	792	339	29
18016	Lisp_(programming_language)	200911	22	4	2	1	12	5	3	2	1291	694	121	805	341	30
18016	Lisp_(programming_language)	200912	14	3	2	1	6	4	2	2	1305	696	124	817	342	31
18016	Lisp_(programming_language)	201001	16	1	0	0	11	7	1	0	1321	702	125	829	344	31
18016	Lisp_(programming_language)	201002	16	3	0	0	11	6	2	0	1337	710	128	838	347	31
18016	Lisp_(programming_language)	201003	1	0	0	0	1	0	0	0	1338	711	128	838	347	31
18016	Lisp_(programming_language)	201004	25	3	0	0	19	12	3	0	1363	727	131	856	356	32
18016	Lisp_(programming_language)	201005	5	0	0	0	4	2	0	0	1368	729	131	858	356	32
18016	Lisp_(programming_language)	201006	9	1	0	0	8	6	1	0	1377	735	132	864	360	32
18016	Lisp_(programming_language)	201007	9	1	0	0	7	4	1	0	1386	741	133	869	363	33
18016	Lisp_(programming_language)	201008	13	2	0	0	9	5	1	0	1399	748	135	876	366	33
18016	Lisp_(programming_language)	201009	11	3	0	0	10	4	2	0	1410	755	138	881	367	33
18016	Lisp_(programming_language)	201010	15	2	0	0	9	7	2	0	1425	760	140	894	370	33
18016	Lisp_(programming_language)	201011	12	4	1	0	7	2	2	1	1437	765	144	899	370	34
18016	Lisp_(programming_language)	201012	15	3	0	0	11	8	3	0	1452	773	147	911	375	35
18016	Lisp_(programming_language)	201101	7	1	0	0	6	4	1	0	1459	779	148	916	379	35
18016	Lisp_(programming_language)	201102	4	0	0	0	3	2	0	0	1463	781	148	918	380	35
18016	Lisp_(programming_language)	201103	20	2	0	0	8	8	2	0	1483	783	150	938	382	37
18016	Lisp_(programming_language)	201104	25	8	1	0	17	11	6	1	1508	793	158	955	386	41
18016	Lisp_(programming_language)	201105	6	1	0	0	6	4	1	0	1514	797	159	959	388	41
18016	Lisp_(programming_language)	201106	7	2	0	0	7	3	2	0	1521	802	161	962	389	41
18016	Lisp_(programming_language)	201107	8	4	1	0	6	4	4	1	1529	805	165	968	390	44
18016	Lisp_(programming_language)	201108	5	2	0	0	5	2	2	0	1534	809	167	970	391	44
18016	Lisp_(programming_language)	201109	11	1	0	0	8	8	1	0	1545	814	168	981	396	45
18016	Lisp_(programming_language)	201110	24	7	3	2	6	4	3	2	1569	818	175	989	398	46
18016	Lisp_(programming_language)	201111	11	3	0	0	11	7	3	0	1580	826	178	996	402	47
18016	Lisp_(programming_language)	201112	7	1	0	0	6	5	1	0	1587	831	179	1002	406	47
18016	Lisp_(programming_language)	201201	13	0	0	0	5	3	0	0	1600	833	179	1013	406	47
18016	Lisp_(programming_language)	201202	3	0	0	0	3	2	0	0	1603	835	179	1015	407	47
18016	Lisp_(programming_language)	201203	12	3	0	0	10	6	3	0	1615	840	182	1023	409	48
18016	Lisp_(programming_language)	201204	14	4	1	0	10	7	4	1	1629	846	186	1034	412	49
18016	Lisp_(programming_language)	201205	12	1	0	0	9	7	1	0	1641	852	187	1043	416	50
18016	Lisp_(programming_language)	201206	8	1	0	0	8	4	1	0	1649	859	188	1047	419	50
18016	Lisp_(programming_language)	201207	5	0	0	0	3	2	0	0	1654	860	188	1049	419	50
18016	Lisp_(programming_language)	201208	7	1	0	0	5	4	1	0	1661	863	189	1055	421	51
18016	Lisp_(programming_language)	201209	7	2	0	0	6	3	2	0	1668	866	191	1058	421	51
18016	Lisp_(programming_language)	201210	4	1	0	0	4	3	1	0	1672	869	192	1061	423	51
18016	Lisp_(programming_language)	201211	5	1	0	0	5	4	1	0	1677	872	193	1065	425	51
18016	Lisp_(programming_language)	201212	10	0	0	0	4	4	0	0	1687	875	193	1075	427	51
18016	Lisp_(programming_language)	201301	12	2	0	0	12	9	2	0	1699	883	195	1084	432	51
18016	Lisp_(programming_language)	201302	15	1	0	0	12	8	1	0	1714	891	196	1095	436	51
18016	Lisp_(programming_language)	201303	8	0	0	0	6	5	0	0	1722	894	196	1101	438	51
18016	Lisp_(programming_language)	201304	3	0	0	0	3	3	0	0	1725	895	196	1104	439	51
18016	Lisp_(programming_language)	201305	15	2	0	0	8	6	1	0	1740	901	198	1117	443	51
18016	Lisp_(programming_language)	201306	11	0	0	0	7	6	0	0	1751	905	198	1127	446	51
18016	Lisp_(programming_language)	201307	4	0	0	0	3	3	0	0	1755	906	198	1131	447	51
18016	Lisp_(programming_language)	201308	13	2	0	0	8	5	1	0	1768	912	200	1141	450	51
18016	Lisp_(programming_language)	201310	10	3	0	0	7	6	3	0	1778	917	203	1150	454	53
18016	Lisp_(programming_language)	201311	6	0	0	0	3	2	0	0	1784	919	203	1153	455	53
18016	Lisp_(programming_language)	201312	8	1	0	0	7	5	1	0	1792	923	204	1158	457	53
18016	Lisp_(programming_language)	201401	7	2	0	0	6	4	2	0	1799	927	206	1163	459	54
18016	Lisp_(programming_language)	201402	6	0	0	0	4	3	0	0	1805	931	206	1168	462	54
18016	Lisp_(programming_language)	201403	10	0	0	0	7	4	0	0	1815	937	206	1172	465	54
18016	Lisp_(programming_language)	201404	6	1	0	0	5	3	1	0	1821	941	207	1175	467	54
18016	Lisp_(programming_language)	201405	2	0	0	0	2	1	0	0	1823	943	207	1176	468	54
18016	Lisp_(programming_language)	201406	8	1	0	0	3	1	1	0	1831	946	208	1181	469	54
18016	Lisp_(programming_language)	201407	15	3	1	0	9	9	3	1	1846	949	211	1196	472	57
18016	Lisp_(programming_language)	201408	7	1	0	0	4	3	1	0	1853	950	212	1202	472	57
18016	Lisp_(programming_language)	201409	10	0	0	0	6	4	0	0	1863	954	212	1208	474	57
18016	Lisp_(programming_language)	201410	8	1	0	0	6	5	1	0	1871	958	213	1214	477	58
18016	Lisp_(programming_language)	201411	6	2	0	0	6	4	2	0	1877	963	215	1218	479	59
18016	Lisp_(programming_language)	201412	8	0	0	0	5	5	0	0	1885	966	215	1226	482	59
18016	Lisp_(programming_language)	201501	1	0	0	0	1	1	0	0	1886	967	215	1227	483	59
18016	Lisp_(programming_language)	201502	22	6	0	0	17	14	5	0	1908	980	221	1244	493	60
18016	Lisp_(programming_language)	201503	13	6	1	0	10	7	4	1	1921	983	227	1254	494	63
18016	Lisp_(programming_language)	201504	15	3	0	0	9	8	3	0	1936	987	230	1268	496	65
18016	Lisp_(programming_language)	201505	7	3	0	0	6	5	2	0	1943	991	233	1274	499	67
18016	Lisp_(programming_language)	201506	69	12	5	2	11	9	6	3	2012	994	245	1341	500	78
18016	Lisp_(programming_language)	201507	7	2	0	0	6	6	2	0	2019	995	247	1348	501	80
18016	Lisp_(programming_language)	201508	4	1	0	0	4	3	1	0	2023	997	248	1351	502	81
18016	Lisp_(programming_language)	201509	14	3	0	0	9	7	3	0	2037	1004	251	1358	507	81
18016	Lisp_(programming_language)	201510	7	1	0	0	6	4	1	0	2044	1008	252	1363	509	81
18016	Lisp_(programming_language)	201511	3	1	0	0	2	1	1	0	2047	1009	253	1364	509	81
18016	Lisp_(programming_language)	201512	2	0	0	0	1	1	0	0	2049	1010	253	1366	510	81
18016	Lisp_(programming_language)	201601	12	3	0	0	7	4	2	0	2061	1016	256	1371	513	81
18016	Lisp_(programming_language)	201602	21	6	0	0	10	8	3	0	2082	1020	262	1384	516	82
18016	Lisp_(programming_language)	201603	10	2	0	0	6	4	1	0	2092	1025	264	1389	519	82
18016	Lisp_(programming_language)	201604	9	0	0	0	6	5	0	0	2101	1029	264	1397	522	82
18016	Lisp_(programming_language)	201605	11	2	0	0	10	6	2	0	2112	1037	266	1404	525	82
18016	Lisp_(programming_language)	201606	9	0	0	0	5	3	0	0	2121	1039	266	1410	526	82
18016	Lisp_(programming_language)	201608	12	0	0	0	3	3	0	0	2133	1041	266	1422	528	82
18016	Lisp_(programming_language)	201609	11	1	0	0	8	4	1	0	2144	1046	267	1429	529	82
18016	Lisp_(programming_language)	201610	12	1	0	0	7	4	1	0	2156	1051	268	1437	531	82
18016	Lisp_(programming_language)	201611	4	0	0	0	2	2	0	0	2160	1052	268	1441	532	82
18016	Lisp_(programming_language)	201612	4	0	0	0	2	1	0	0	2164	1054	268	1444	533	82
18016	Lisp_(programming_language)	201701	4	1	0	0	3	2	1	0	2168	1056	269	1447	534	82
18016	Lisp_(programming_language)	201702	6	1	0	0	6	5	1	0	2174	1061	270	1452	538	83
18016	Lisp_(programming_language)	201703	9	0	0	0	7	7	0	0	2183	1065	270	1461	542	83
18016	Lisp_(programming_language)	201704	7	1	0	0	7	4	1	0	2190	1071	271	1465	545	83
18016	Lisp_(programming_language)	201705	7	0	0	0	4	3	0	0	2197	1074	271	1471	547	83
18016	Lisp_(programming_language)	201706	11	1	0	0	9	7	1	0	2208	1079	272	1479	550	83
18016	Lisp_(programming_language)	201707	7	0	0	0	2	2	0	0	2215	1081	272	1486	552	83
18016	Lisp_(programming_language)	201708	6	2	0	0	5	3	2	0	2221	1084	274	1489	553	83
18016	Lisp_(programming_language)	201709	5	2	0	0	5	3	2	0	2226	1086	276	1492	553	83
18016	Lisp_(programming_language)	201710	8	0	0	0	6	4	0	0	2234	1091	276	1496	555	83
18016	Lisp_(programming_language)	201711	1	0	0	0	1	1	0	0	2235	1091	276	1497	555	83
18016	Lisp_(programming_language)	201712	2	0	0	0	2	0	0	0	2237	1093	276	1497	555	83
18016	Lisp_(programming_language)	201803	6	0	0	0	5	5	0	0	2243	1096	276	1503	558	83
18016	Lisp_(programming_language)	201804	4	1	0	0	4	2	1	0	2247	1099	277	1505	559	83
18016	Lisp_(programming_language)	201805	9	0	0	0	5	4	0	0	2256	1101	277	1513	560	83
18016	Lisp_(programming_language)	201806	1	0	0	0	1	1	0	0	2257	1102	277	1514	561	83
18016	Lisp_(programming_language)	201807	10	1	0	0	7	6	1	0	2267	1108	278	1523	566	83
18996908	Live_streaming	201607	1	0	0	0	1	1	0	0	1	1	0	1	1	0
18996908	Live_streaming	201609	3	0	0	0	3	3	0	0	4	4	0	4	4	0
18996908	Live_streaming	201610	5	0	0	0	2	2	0	0	9	6	0	9	6	0
18996908	Live_streaming	201611	2	0	0	0	2	2	0	0	11	7	0	11	7	0
18996908	Live_streaming	201702	21	1	0	0	5	5	1	0	32	10	1	32	10	1
18996908	Live_streaming	201703	2	1	0	0	2	2	1	0	34	12	2	34	11	2
18996908	Live_streaming	201704	2	1	0	0	2	2	1	0	36	14	3	36	13	3
18996908	Live_streaming	201705	2	0	0	0	2	2	0	0	38	15	3	38	14	3
18996908	Live_streaming	201707	1	0	0	0	1	1	0	0	39	16	3	39	15	3
18996908	Live_streaming	201708	15	1	0	0	5	4	1	0	54	19	4	53	17	4
18996908	Live_streaming	201709	13	0	0	0	3	3	0	0	67	21	4	66	19	4
18996908	Live_streaming	201710	4	0	0	0	3	3	0	0	71	23	4	70	21	4
18996908	Live_streaming	201711	1	1	0	0	1	1	1	0	72	23	5	71	21	5
18996908	Live_streaming	201801	5	2	0	0	5	4	2	0	77	28	7	75	25	6
18996908	Live_streaming	201802	10	1	0	0	4	4	1	0	87	31	8	85	28	7
18996908	Live_streaming	201803	5	2	0	0	4	4	2	0	92	35	10	90	31	9
18996908	Live_streaming	201804	10	0	0	0	2	1	0	0	102	36	10	94	31	9
18996908	Live_streaming	201806	1	0	0	0	1	0	0	0	103	37	10	94	31	9
18996908	Live_streaming	201807	7	1	0	0	4	3	1	0	110	41	11	99	34	9
20668	MAC_address	200202	7	0	0	0	1	1	0	0	7	1	0	7	1	0
20668	MAC_address	200204	1	0	0	0	1	1	0	0	8	2	0	8	2	0
20668	MAC_address	200205	1	0	0	0	1	1	0	0	9	3	0	9	3	0
20668	MAC_address	200207	5	1	0	0	2	0	1	0	14	5	1	9	3	0
20668	MAC_address	200210	1	0	0	0	1	1	0	0	15	6	1	10	4	0
20668	MAC_address	200302	2	0	0	0	2	1	0	0	17	7	1	11	4	0
20668	MAC_address	200303	1	0	0	0	1	1	0	0	18	8	1	12	5	0
20668	MAC_address	200306	1	0	0	0	1	0	0	0	19	9	1	12	5	0
20668	MAC_address	200308	1	0	0	0	1	1	0	0	20	10	1	13	6	0
20668	MAC_address	200309	3	0	0	0	3	2	0	0	23	13	1	15	8	0
20668	MAC_address	200311	2	0	0	0	2	1	0	0	25	15	1	16	9	0
20668	MAC_address	200312	1	0	0	0	1	1	0	0	26	16	1	17	10	0
20668	MAC_address	200402	2	0	0	0	1	0	0	0	28	17	1	17	10	0
20668	MAC_address	200404	3	0	0	0	3	2	0	0	31	19	1	19	11	0
20668	MAC_address	200405	3	0	0	0	3	3	0	0	34	22	1	22	14	0
20668	MAC_address	200406	1	0	0	0	1	1	0	0	35	23	1	23	15	0
20668	MAC_address	200407	1	0	0	0	1	1	0	0	36	24	1	24	16	0
20668	MAC_address	200408	15	0	0	0	8	4	0	0	51	32	1	34	20	0
20668	MAC_address	200409	4	0	0	0	4	3	0	0	55	35	1	37	22	0
20668	MAC_address	200410	7	1	0	0	7	4	1	0	62	41	2	41	25	0
20668	MAC_address	200411	13	1	0	0	9	4	1	0	75	50	3	45	29	0
20668	MAC_address	200412	6	0	0	0	5	3	0	0	81	54	3	48	31	0
20668	MAC_address	200501	2	0	0	0	2	2	0	0	83	55	3	50	32	0
20668	MAC_address	200502	13	3	0	0	7	2	2	0	96	62	6	53	34	0
20668	MAC_address	200503	2	0	0	0	2	1	0	0	98	62	6	54	34	0
20668	MAC_address	200504	3	0	0	0	3	2	0	0	101	65	6	56	36	0
20668	MAC_address	200505	2	0	0	0	2	1	0	0	103	67	6	57	37	0
20668	MAC_address	200506	8	1	0	0	7	2	1	0	111	73	7	59	38	0
20668	MAC_address	200507	5	0	0	0	5	2	0	0	116	78	7	61	40	0
20668	MAC_address	200508	8	0	0	0	7	3	0	0	124	85	7	64	43	0
20668	MAC_address	200509	18	4	0	0	14	9	4	0	142	98	11	73	51	0
20668	MAC_address	200510	9	1	0	0	8	4	1	0	151	105	12	77	54	0
20668	MAC_address	200511	64	10	0	0	26	10	4	0	215	130	22	103	63	1
20668	MAC_address	200512	91	50	16	10	26	14	16	7	306	151	72	149	73	16
20668	MAC_address	200601	28	3	0	0	17	6	3	0	334	165	75	158	77	16
20668	MAC_address	200602	18	4	0	0	15	6	3	0	352	180	79	165	83	16
20668	MAC_address	200603	11	0	0	0	9	2	0	0	363	189	79	167	85	16
20668	MAC_address	200604	20	2	0	0	16	4	1	0	383	202	81	172	87	16
20668	MAC_address	200605	14	2	0	0	10	5	2	0	397	211	83	177	91	16
20668	MAC_address	200606	10	1	0	0	10	4	1	0	407	220	84	181	94	16
20668	MAC_address	200607	22	2	0	0	15	6	1	0	429	234	86	188	100	17
20668	MAC_address	200608	108	9	5	2	26	9	5	3	537	258	95	227	109	19
20668	MAC_address	200609	47	2	0	0	21	6	2	0	584	275	97	239	113	19
20668	MAC_address	200610	46	6	1	0	22	7	4	1	630	296	103	259	120	20
20668	MAC_address	200611	26	8	0	0	21	8	7	0	656	311	111	269	123	21
20668	MAC_address	200612	35	7	1	0	24	10	6	1	691	331	118	287	130	23
20668	MAC_address	200701	27	3	0	0	18	7	2	0	718	345	121	300	134	24
20668	MAC_address	200702	21	1	0	0	21	9	1	0	739	361	122	309	140	25
20668	MAC_address	200703	18	4	0	0	15	7	4	0	757	371	126	318	143	26
20668	MAC_address	200704	29	9	1	0	17	9	7	1	786	383	135	334	147	28
20668	MAC_address	200705	19	2	0	0	16	7	2	0	805	396	137	342	151	28
20668	MAC_address	200706	15	2	0	0	14	11	2	0	820	406	139	354	158	30
20668	MAC_address	200707	7	3	0	0	7	3	3	0	827	413	142	357	161	30
20668	MAC_address	200708	7	1	0	0	5	3	1	0	834	417	143	361	163	30
20668	MAC_address	200709	6	1	0	0	3	1	1	0	840	419	144	363	163	30
20668	MAC_address	200710	16	7	1	0	12	10	5	1	856	430	151	376	172	34
20668	MAC_address	200711	11	2	0	0	9	3	2	0	867	437	153	379	173	34
20668	MAC_address	200712	22	9	0	0	17	8	6	0	889	452	162	392	179	36
20668	MAC_address	200801	3	0	0	0	3	1	0	0	892	454	162	393	179	36
20668	MAC_address	200802	9	2	0	0	8	5	2	0	901	460	164	399	182	37
20668	MAC_address	200803	11	3	0	0	7	4	2	0	912	466	167	406	185	37
20668	MAC_address	200804	13	0	0	0	9	5	0	0	925	473	167	411	188	37
20668	MAC_address	200805	5	1	0	0	5	2	1	0	930	477	168	413	189	37
20668	MAC_address	200806	18	7	0	0	14	6	6	0	948	490	175	423	194	39
20668	MAC_address	200807	15	3	0	0	13	4	3	0	963	502	178	427	197	39
20668	MAC_address	200808	10	1	0	0	9	3	1	0	973	511	179	430	200	39
20668	MAC_address	200809	14	2	0	0	9	5	1	0	987	519	181	439	204	39
20668	MAC_address	200810	34	11	5	4	14	6	5	2	1021	533	192	455	210	40
20668	MAC_address	200811	23	7	0	0	16	9	6	0	1044	549	199	464	219	40
20668	MAC_address	200812	7	4	0	0	7	3	4	0	1051	555	203	467	221	41
20668	MAC_address	200901	16	4	0	0	14	11	4	0	1067	568	207	480	231	43
20668	MAC_address	200902	3	0	0	0	3	0	0	0	1070	570	207	480	231	43
20668	MAC_address	200903	32	9	0	0	17	11	7	0	1102	586	216	497	241	44
20668	MAC_address	200904	7	2	0	0	6	2	2	0	1109	592	218	499	243	45
20668	MAC_address	200905	10	4	0	0	9	2	3	0	1119	599	222	502	243	45
20668	MAC_address	200906	10	2	0	0	8	6	2	0	1129	605	224	508	247	45
20668	MAC_address	200907	6	2	0	0	6	2	2	0	1135	610	226	510	248	45
20668	MAC_address	200908	4	1	0	0	4	2	1	0	1139	614	227	512	250	45
20668	MAC_address	200909	6	1	0	0	5	2	1	0	1145	616	228	514	250	45
20668	MAC_address	200910	6	1	0	0	4	1	1	0	1151	620	229	515	251	45
20668	MAC_address	200911	4	2	0	0	4	3	2	0	1155	622	231	518	252	46
20668	MAC_address	200912	12	6	0	0	11	4	6	0	1167	632	237	523	255	47
20668	MAC_address	201001	4	0	0	0	3	2	0	0	1171	635	237	525	257	47
20668	MAC_address	201002	14	4	0	0	9	5	3	0	1185	642	241	532	261	47
20668	MAC_address	201003	4	1	0	0	4	3	1	0	1189	644	242	535	262	47
20668	MAC_address	201004	14	6	0	0	10	6	4	0	1203	652	248	543	266	47
20668	MAC_address	201005	11	4	0	0	10	4	4	0	1214	661	252	547	269	48
20668	MAC_address	201006	8	1	0	0	8	4	1	0	1222	668	253	551	272	48
20668	MAC_address	201007	9	3	0	0	8	4	3	0	1231	675	256	556	275	48
20668	MAC_address	201008	4	1	0	0	4	2	1	0	1235	678	257	558	276	48
20668	MAC_address	201009	5	1	0	0	5	3	1	0	1240	682	258	561	278	48
20668	MAC_address	201010	26	4	0	0	18	11	4	0	1266	697	262	578	286	49
20668	MAC_address	201011	27	12	0	0	18	12	8	0	1293	712	274	596	295	52
20668	MAC_address	201012	11	3	0	0	11	10	3	0	1304	720	277	606	302	54
20668	MAC_address	201101	16	5	1	0	13	5	4	1	1320	731	282	613	305	55
20668	MAC_address	201102	3	0	0	0	3	2	0	0	1323	734	282	615	307	55
20668	MAC_address	201103	7	1	0	0	5	3	1	0	1330	739	283	619	310	55
20668	MAC_address	201104	5	1	0	0	5	1	1	0	1335	744	284	620	311	55
20668	MAC_address	201105	3	1	0	0	3	3	1	0	1338	746	285	623	313	56
20668	MAC_address	201106	3	0	0	0	3	1	0	0	1341	749	285	624	314	56
20668	MAC_address	201107	22	5	0	0	12	7	4	0	1363	756	290	640	316	57
20668	MAC_address	201108	11	2	0	0	9	6	2	0	1374	763	292	647	320	57
20668	MAC_address	201109	14	3	0	0	8	4	3	0	1388	768	295	655	321	57
20668	MAC_address	201110	26	3	0	0	11	4	3	0	1414	775	298	659	321	57
20668	MAC_address	201111	5	2	0	0	5	2	2	0	1419	778	300	661	321	57
20668	MAC_address	201112	13	5	0	0	10	6	4	0	1432	786	305	668	325	60
20668	MAC_address	201201	6	1	0	0	4	1	1	0	1438	789	306	670	325	60
20668	MAC_address	201203	4	1	0	0	3	1	1	0	1442	791	307	672	325	60
20668	MAC_address	201204	6	2	0	0	6	4	2	0	1448	795	309	676	327	60
20668	MAC_address	201205	7	2	0	0	6	3	2	0	1455	799	311	679	328	60
20668	MAC_address	201206	4	2	0	0	4	2	2	0	1459	801	313	681	328	60
20668	MAC_address	201207	2	1	0	0	2	1	1	0	1461	802	314	682	328	60
20668	MAC_address	201208	10	2	0	0	9	4	2	0	1471	809	316	686	330	60
20668	MAC_address	201209	6	1	0	0	4	2	1	0	1477	812	317	689	331	60
20668	MAC_address	201210	4	0	0	0	2	1	0	0	1481	812	317	692	331	60
20668	MAC_address	201211	4	1	0	0	4	2	1	0	1485	814	318	694	331	60
20668	MAC_address	201212	2	1	0	0	2	2	1	0	1487	815	319	696	332	61
20668	MAC_address	201302	6	2	0	0	5	2	2	0	1493	819	321	698	333	61
20668	MAC_address	201303	6	0	0	0	5	3	0	0	1499	823	321	702	336	61
20668	MAC_address	201304	3	1	0	0	3	2	1	0	1502	826	322	704	337	61
20668	MAC_address	201305	18	6	0	0	15	11	5	0	1520	837	328	716	344	62
20668	MAC_address	201306	2	1	0	0	2	2	1	0	1522	838	329	718	345	63
20668	MAC_address	201307	1	0	0	0	1	1	0	0	1523	839	329	719	346	63
20668	MAC_address	201308	7	2	0	0	6	5	2	0	1530	842	331	725	348	64
20668	MAC_address	201309	9	2	0	0	8	4	2	0	1539	848	333	729	350	64
20668	MAC_address	201310	12	2	0	0	10	4	2	0	1551	857	335	733	353	64
20668	MAC_address	201311	10	4	0	0	7	3	2	0	1561	862	339	738	354	64
20668	MAC_address	201312	4	1	0	0	4	3	1	0	1565	865	340	741	356	64
20668	MAC_address	201401	13	3	0	0	11	9	3	0	1578	871	343	751	360	64
20668	MAC_address	201402	8	3	0	0	8	3	3	0	1586	878	346	754	362	64
20668	MAC_address	201403	6	3	0	0	5	3	3	0	1592	880	349	757	362	64
20668	MAC_address	201404	8	4	0	0	6	4	3	0	1600	884	353	762	364	65
20668	MAC_address	201405	4	1	0	0	4	3	1	0	1604	887	354	765	366	65
20668	MAC_address	201407	4	1	0	0	3	2	1	0	1608	889	355	767	367	66
20668	MAC_address	201408	3	1	0	0	2	1	1	0	1611	890	356	768	367	66
20668	MAC_address	201409	4	2	0	0	4	2	2	0	1615	893	358	770	368	66
20668	MAC_address	201410	13	6	0	0	10	5	6	0	1628	901	364	775	371	66
20668	MAC_address	201411	8	1	0	0	7	5	1	0	1636	906	365	781	374	66
20668	MAC_address	201412	3	1	0	0	3	1	1	0	1639	909	366	782	375	66
20668	MAC_address	201501	9	1	0	0	6	5	1	0	1648	912	367	790	377	66
20668	MAC_address	201502	4	1	0	0	4	2	1	0	1652	915	368	792	378	66
20668	MAC_address	201503	9	3	0	0	7	3	3	0	1661	920	371	796	379	67
20668	MAC_address	201504	4	1	0	0	2	2	1	0	1665	921	372	800	380	68
20668	MAC_address	201505	5	1	0	0	5	3	1	0	1670	925	373	803	382	68
20668	MAC_address	201506	2	0	0	0	2	1	0	0	1672	926	373	804	382	68
20668	MAC_address	201508	4	2	0	0	4	2	2	0	1676	929	375	806	383	68
20668	MAC_address	201509	1	0	0	0	1	1	0	0	1677	929	375	807	383	68
20668	MAC_address	201510	9	3	0	0	8	6	3	0	1686	935	378	814	384	69
20668	MAC_address	201511	17	2	0	0	13	8	2	0	1703	944	380	826	388	69
20668	MAC_address	201512	4	3	1	0	3	2	3	1	1707	946	383	828	389	70
20668	MAC_address	201602	8	3	0	0	6	3	3	0	1715	950	386	831	390	70
20668	MAC_address	201603	2	1	0	0	2	1	1	0	1717	951	387	832	390	70
20668	MAC_address	201605	5	1	0	0	3	2	1	0	1722	953	388	834	391	70
20668	MAC_address	201606	1	0	0	0	1	1	0	0	1723	954	388	835	392	70
20668	MAC_address	201607	5	0	0	0	4	2	0	0	1728	958	388	838	394	70
20668	MAC_address	201608	9	3	0	0	7	3	3	0	1737	963	391	841	395	70
20668	MAC_address	201609	13	5	0	0	9	4	4	0	1750	969	396	848	396	70
20668	MAC_address	201610	10	1	0	0	8	6	1	0	1760	974	397	856	399	70
20668	MAC_address	201611	9	3	0	0	8	5	3	0	1769	979	400	862	400	71
20668	MAC_address	201612	4	1	0	0	4	3	1	0	1773	981	401	865	401	71
20668	MAC_address	201701	13	4	0	0	9	5	4	0	1786	987	405	871	403	71
20668	MAC_address	201702	9	2	0	0	6	4	2	0	1795	992	407	878	406	71
20668	MAC_address	201703	2	0	0	0	2	1	0	0	1797	994	407	879	407	71
20668	MAC_address	201704	5	1	0	0	5	5	1	0	1802	998	408	884	411	72
20668	MAC_address	201705	3	1	0	0	3	2	1	0	1805	1001	409	886	413	72
20668	MAC_address	201706	1	0	0	0	1	1	0	0	1806	1002	409	887	414	72
20668	MAC_address	201707	2	0	0	0	2	2	0	0	1808	1003	409	889	415	72
20668	MAC_address	201708	3	1	0	0	3	2	1	0	1811	1005	410	891	416	72
20668	MAC_address	201709	2	1	0	0	2	2	1	0	1813	1006	411	893	417	73
20668	MAC_address	201710	15	4	0	0	11	6	3	0	1828	1015	415	900	420	73
20668	MAC_address	201711	6	2	0	0	4	3	1	0	1834	1017	417	905	421	74
20668	MAC_address	201712	4	0	0	0	4	4	0	0	1838	1021	417	909	425	74
20668	MAC_address	201801	2	1	0	0	2	2	1	0	1840	1022	418	911	425	75
20668	MAC_address	201802	1	0	0	0	1	0	0	0	1841	1023	418	911	425	75
20668	MAC_address	201803	16	5	0	0	8	4	3	0	1857	1028	423	917	426	75
20668	MAC_address	201805	8	3	0	0	5	4	2	0	1865	1031	426	923	427	76
20668	MAC_address	201806	3	0	0	0	2	1	0	0	1868	1033	426	924	428	76
20668	MAC_address	201807	6	2	0	0	5	2	1	0	1874	1037	428	927	429	76
2156560	MARID	200602	1	0	0	0	1	1	0	0	1	1	0	1	1	0
2156560	MARID	200603	10	0	0	0	1	1	0	0	11	2	0	11	2	0
2156560	MARID	200604	6	0	0	0	1	1	0	0	17	2	0	17	2	0
2156560	MARID	200605	2	0	0	0	2	1	0	0	19	3	0	18	2	0
2156560	MARID	200606	1	0	0	0	1	1	0	0	20	4	0	19	3	0
2156560	MARID	200611	1	0	0	0	1	1	0	0	21	5	0	20	4	0
2156560	MARID	200701	4	2	0	0	3	1	1	0	25	8	2	22	5	0
2156560	MARID	200709	1	0	0	0	1	1	0	0	26	8	2	23	5	0
2156560	MARID	200710	1	0	0	0	1	1	0	0	27	9	2	24	6	0
2156560	MARID	200712	5	0	0	0	2	2	0	0	32	11	2	29	8	0
2156560	MARID	200801	1	0	0	0	1	0	0	0	33	12	2	29	8	0
2156560	MARID	200805	1	0	0	0	1	0	0	0	34	13	2	29	8	0
2156560	MARID	200806	1	0	0	0	1	1	0	0	35	13	2	30	8	0
2156560	MARID	200809	3	0	0	0	2	0	0	0	38	15	2	30	8	0
2156560	MARID	201002	1	0	0	0	1	1	0	0	39	16	2	31	9	0
2156560	MARID	201009	1	0	0	0	1	1	0	0	40	17	2	32	10	0
2156560	MARID	201107	1	0	0	0	1	1	0	0	41	18	2	33	11	0
2156560	MARID	201310	1	0	0	0	1	0	0	0	42	19	2	33	11	0
2156560	MARID	201404	2	0	0	0	1	0	0	0	44	20	2	33	11	0
2156560	MARID	201408	1	0	0	0	1	1	0	0	45	21	2	34	12	0
2156560	MARID	201609	1	0	0	0	1	1	0	0	46	22	2	35	13	0
2156560	MARID	201705	1	0	0	0	1	1	0	0	47	23	2	36	14	0
2156560	MARID	201706	1	0	0	0	1	1	0	0	48	24	2	37	15	0
2156560	MARID	201801	3	0	0	0	1	1	0	0	51	25	2	40	16	0
2156560	MARID	201802	1	0	0	0	1	1	0	0	52	25	2	41	16	0
13544419	MIMO	200504	1	0	0	0	1	0	0	0	1	1	0	0	0	0
13544419	MIMO	200505	4	0	0	0	4	3	0	0	5	5	0	3	3	0
13544419	MIMO	200507	8	0	0	0	3	1	0	0	13	8	0	9	4	0
13544419	MIMO	200508	10	0	0	0	8	4	0	0	23	16	0	14	8	0
13544419	MIMO	200509	3	1	0	0	3	1	1	0	26	19	1	15	9	0
13544419	MIMO	200510	7	2	0	0	6	1	2	0	33	24	3	16	9	0
13544419	MIMO	200511	5	0	0	0	3	0	0	0	38	27	3	16	9	0
13544419	MIMO	200512	1	0	0	0	1	1	0	0	39	28	3	17	10	0
13544419	MIMO	200601	11	1	0	0	5	3	1	0	50	32	4	25	12	0
13544419	MIMO	200602	5	0	0	0	4	2	0	0	55	36	4	27	14	0
13544419	MIMO	200603	10	2	0	0	9	4	2	0	65	44	6	31	17	0
13544419	MIMO	200604	9	0	0	0	6	5	0	0	74	48	6	39	20	0
13544419	MIMO	200605	9	1	0	0	6	3	1	0	83	53	7	44	22	0
13544419	MIMO	200606	4	0	0	0	4	0	0	0	87	57	7	44	22	0
13544419	MIMO	200607	2	0	0	0	1	1	0	0	89	58	7	46	23	0
13544419	MIMO	200608	2	0	0	0	2	2	0	0	91	60	7	48	25	0
13544419	MIMO	200609	4	1	0	0	3	1	1	0	95	62	8	49	25	0
13544419	MIMO	200611	5	1	0	0	4	1	1	0	100	66	9	50	26	0
13544419	MIMO	200612	20	0	0	0	6	3	0	0	120	71	9	66	28	0
13544419	MIMO	200701	7	1	0	0	4	1	1	0	127	75	10	67	29	0
13544419	MIMO	200702	9	1	0	0	8	3	1	0	136	82	11	70	31	0
13544419	MIMO	200703	11	0	0	0	8	4	0	0	147	89	11	76	34	0
13544419	MIMO	200704	17	0	0	0	10	5	0	0	164	99	11	86	39	0
13544419	MIMO	200705	56	0	0	0	9	3	0	0	220	108	11	129	42	0
13544419	MIMO	200706	10	0	0	0	5	3	0	0	230	112	11	137	44	0
13544419	MIMO	200707	16	0	0	0	4	2	0	0	246	115	11	151	45	0
13544419	MIMO	200708	4	0	0	0	4	2	0	0	250	119	11	153	47	0
13544419	MIMO	200709	18	1	0	0	4	3	1	0	268	122	12	170	49	0
13544419	MIMO	200710	56	0	0	0	12	5	0	0	324	131	12	218	51	0
13544419	MIMO	200711	77	4	0	0	17	9	3	0	401	144	16	286	57	3
13544419	MIMO	200712	15	0	0	0	10	3	0	0	416	152	16	289	59	3
13544419	MIMO	200802	17	0	0	0	8	4	0	0	433	158	16	301	61	3
13544419	MIMO	200803	11	1	0	0	8	7	1	0	444	163	17	311	65	3
13544419	MIMO	200804	1	0	0	0	1	1	0	0	445	163	17	312	65	3
13544419	MIMO	200805	12	0	0	0	5	2	0	0	457	167	17	320	66	3
13544419	MIMO	200806	6	1	0	0	4	3	1	0	463	170	18	325	68	4
13544419	MIMO	200807	5	0	0	0	5	3	0	0	468	175	18	328	71	4
13544419	MIMO	200808	6	2	0	0	5	4	1	0	474	180	20	333	75	5
13544419	MIMO	200809	3	0	0	0	2	2	0	0	477	181	20	336	76	5
13544419	MIMO	200810	7	2	0	0	3	1	1	0	484	184	22	338	77	5
13544419	MIMO	200811	18	4	0	0	8	2	2	0	502	191	26	342	78	5
13544419	MIMO	200812	6	2	0	0	6	2	2	0	508	197	28	344	80	5
13544419	MIMO	200901	9	0	0	0	4	2	0	0	517	200	28	351	81	5
13544419	MIMO	200902	6	0	0	0	3	1	0	0	523	203	28	353	82	5
13544419	MIMO	200903	5	1	0	0	3	3	1	0	528	206	29	358	85	6
13544419	MIMO	200904	3	0	0	0	3	1	0	0	531	207	29	359	85	6
13544419	MIMO	200905	4	1	0	0	3	2	1	0	535	210	30	361	87	6
13544419	MIMO	200906	15	5	0	0	8	7	2	0	550	217	35	375	93	10
13544419	MIMO	200907	9	1	0	0	8	5	1	0	559	223	36	381	96	10
13544419	MIMO	200908	6	2	0	0	4	4	2	0	565	227	38	387	100	12
13544419	MIMO	200909	7	0	0	0	4	3	0	0	572	229	38	392	101	12
13544419	MIMO	200910	1	0	0	0	1	0	0	0	573	230	38	392	101	12
13544419	MIMO	200911	7	0	0	0	7	2	0	0	580	236	38	394	102	12
13544419	MIMO	200912	3	0	0	0	3	2	0	0	583	239	38	396	104	12
13544419	MIMO	201001	3	0	0	0	3	1	0	0	586	242	38	397	105	12
13544419	MIMO	201002	1	0	0	0	1	1	0	0	587	243	38	398	106	12
13544419	MIMO	201003	4	0	0	0	3	2	0	0	591	246	38	400	108	12
13544419	MIMO	201004	6	0	0	0	5	2	0	0	597	251	38	402	110	12
13544419	MIMO	201005	7	1	0	0	6	3	1	0	604	256	39	405	112	12
13544419	MIMO	201007	17	0	0	0	8	2	0	0	621	262	39	407	112	12
13544419	MIMO	201008	14	2	0	0	8	6	2	0	635	268	41	414	117	14
13544419	MIMO	201009	9	1	0	0	5	3	1	0	644	273	42	421	120	14
13544419	MIMO	201010	1	0	0	0	1	1	0	0	645	274	42	422	121	14
13544419	MIMO	201011	4	0	0	0	4	3	0	0	649	278	42	425	124	14
13544419	MIMO	201012	7	1	0	0	4	1	1	0	656	281	43	426	124	14
13544419	MIMO	201101	4	0	0	0	3	1	0	0	660	284	43	427	125	14
13544419	MIMO	201102	4	2	0	0	4	2	2	0	664	287	45	429	126	14
13544419	MIMO	201103	6	0	0	0	4	2	0	0	670	289	45	432	126	14
13544419	MIMO	201104	1	0	0	0	1	0	0	0	671	290	45	432	126	14
13544419	MIMO	201105	2	0	0	0	2	1	0	0	673	292	45	433	127	14
13544419	MIMO	201106	3	0	0	0	3	2	0	0	676	295	45	435	129	14
13544419	MIMO	201107	13	1	0	0	7	3	1	0	689	301	46	440	131	14
13544419	MIMO	201108	4	0	0	0	4	4	0	0	693	304	46	444	134	14
13544419	MIMO	201109	1	0	0	0	1	0	0	0	694	304	46	444	134	14
13544419	MIMO	201110	5	0	0	0	5	4	0	0	699	307	46	448	136	14
13544419	MIMO	201111	5	1	0	0	4	2	1	0	704	310	47	450	137	14
13544419	MIMO	201112	3	0	0	0	3	2	0	0	707	312	47	452	138	14
13544419	MIMO	201201	3	0	0	0	2	1	0	0	710	314	47	453	139	14
13544419	MIMO	201202	7	0	0	0	4	1	0	0	717	317	47	454	139	14
13544419	MIMO	201203	12	0	0	0	8	6	0	0	729	323	47	464	143	14
13544419	MIMO	201204	8	0	0	0	2	1	0	0	737	325	47	465	144	14
13544419	MIMO	201205	4	1	0	0	4	2	1	0	741	329	48	467	146	14
13544419	MIMO	201207	8	0	0	0	5	3	0	0	749	334	48	471	149	14
13544419	MIMO	201208	5	0	0	0	2	2	0	0	754	335	48	476	150	14
13544419	MIMO	201209	1	0	0	0	1	1	0	0	755	336	48	477	151	14
13544419	MIMO	201210	1	0	0	0	1	1	0	0	756	337	48	478	152	14
13544419	MIMO	201211	4	0	0	0	3	2	0	0	760	340	48	481	154	14
13544419	MIMO	201212	3	0	0	0	2	0	0	0	763	342	48	481	154	14
13544419	MIMO	201301	1	0	0	0	1	1	0	0	764	342	48	482	154	14
13544419	MIMO	201302	1	0	0	0	1	0	0	0	765	343	48	482	154	14
13544419	MIMO	201303	5	1	0	0	5	3	1	0	770	347	49	485	156	14
13544419	MIMO	201304	5	0	0	0	1	1	0	0	775	348	49	490	157	14
13544419	MIMO	201305	10	0	0	0	3	1	0	0	785	351	49	491	158	14
13544419	MIMO	201306	3	0	0	0	2	1	0	0	788	353	49	492	159	14
13544419	MIMO	201307	8	0	0	0	4	4	0	0	796	357	49	500	163	14
13544419	MIMO	201308	1	0	0	0	1	1	0	0	797	357	49	501	163	14
13544419	MIMO	201309	1	0	0	0	1	0	0	0	798	358	49	501	163	14
13544419	MIMO	201310	1	0	0	0	1	1	0	0	799	359	49	502	164	14
13544419	MIMO	201311	3	0	0	0	2	1	0	0	802	361	49	504	165	14
13544419	MIMO	201312	9	1	0	0	5	2	1	0	811	366	50	507	167	14
13544419	MIMO	201401	2	0	0	0	2	2	0	0	813	368	50	509	169	14
13544419	MIMO	201402	6	1	0	0	5	3	1	0	819	372	51	513	171	14
13544419	MIMO	201403	5	0	0	0	5	3	0	0	824	376	51	516	173	14
13544419	MIMO	201404	2	0	0	0	2	2	0	0	826	378	51	518	175	14
13544419	MIMO	201405	14	0	0	0	5	4	0	0	840	382	51	531	178	14
13544419	MIMO	201406	13	0	0	0	9	8	0	0	853	388	51	542	183	14
13544419	MIMO	201407	7	0	0	0	3	3	0	0	860	389	51	549	184	14
13544419	MIMO	201408	4	0	0	0	3	2	0	0	864	390	51	552	184	14
13544419	MIMO	201409	2	0	0	0	2	1	0	0	866	392	51	553	185	14
13544419	MIMO	201410	6	0	0	0	2	1	0	0	872	393	51	558	185	14
13544419	MIMO	201411	2	0	0	0	1	1	0	0	874	393	51	560	185	14
13544419	MIMO	201412	2	0	0	0	1	0	0	0	876	394	51	560	185	14
13544419	MIMO	201501	1	0	0	0	1	1	0	0	877	394	51	561	185	14
13544419	MIMO	201502	42	1	0	0	2	1	1	0	919	395	52	602	185	14
13544419	MIMO	201503	3	0	0	0	2	2	0	0	922	396	52	605	186	14
13544419	MIMO	201504	2	0	0	0	1	0	0	0	924	397	52	605	186	14
13544419	MIMO	201505	5	0	0	0	2	1	0	0	929	399	52	608	187	14
13544419	MIMO	201506	3	1	0	0	3	1	1	0	932	401	53	609	187	14
13544419	MIMO	201507	2	0	0	0	1	1	0	0	934	402	53	611	188	14
13544419	MIMO	201508	1	0	0	0	1	1	0	0	935	402	53	612	188	14
13544419	MIMO	201509	1	0	0	0	1	1	0	0	936	403	53	613	189	14
13544419	MIMO	201510	4	0	0	0	4	2	0	0	940	406	53	615	190	14
13544419	MIMO	201511	1	0	0	0	1	1	0	0	941	406	53	616	190	14
13544419	MIMO	201512	2	0	0	0	1	1	0	0	943	407	53	618	191	14
13544419	MIMO	201601	1	0	0	0	1	1	0	0	944	408	53	619	192	14
13544419	MIMO	201602	3	0	0	0	1	0	0	0	947	409	53	619	192	14
13544419	MIMO	201603	2	0	0	0	1	1	0	0	949	410	53	621	193	14
13544419	MIMO	201604	4	1	0	0	4	2	1	0	953	413	54	623	194	14
13544419	MIMO	201605	5	0	0	0	4	2	0	0	958	415	54	626	194	14
13544419	MIMO	201606	1	0	0	0	1	1	0	0	959	415	54	627	194	14
13544419	MIMO	201607	6	0	0	0	3	3	0	0	965	418	54	633	197	14
13544419	MIMO	201608	1	0	0	0	1	1	0	0	966	419	54	634	198	14
13544419	MIMO	201609	3	1	0	0	3	1	1	0	969	421	55	635	198	14
13544419	MIMO	201610	9	1	0	0	6	2	1	0	978	427	56	637	200	14
13544419	MIMO	201611	5	1	0	0	4	2	1	0	983	431	57	639	202	15
13544419	MIMO	201612	1	0	0	0	1	1	0	0	984	432	57	640	203	15
13544419	MIMO	201701	1	0	0	0	1	1	0	0	985	433	57	641	204	15
13544419	MIMO	201703	3	0	0	0	2	2	0	0	988	434	57	644	205	15
13544419	MIMO	201704	10	0	0	0	5	3	0	0	998	438	57	647	207	15
13544419	MIMO	201705	2	0	0	0	2	0	0	0	1000	440	57	647	207	15
13544419	MIMO	201707	2	0	0	0	2	2	0	0	1002	442	57	649	209	15
13544419	MIMO	201708	1	0	0	0	1	0	0	0	1003	443	57	649	209	15
13544419	MIMO	201710	2	0	0	0	2	2	0	0	1005	445	57	651	211	15
13544419	MIMO	201711	2	0	0	0	1	1	0	0	1007	445	57	653	211	15
13544419	MIMO	201712	6	1	0	0	5	5	1	0	1013	448	58	659	213	16
13544419	MIMO	201801	1	0	0	0	1	1	0	0	1014	449	58	660	214	16
13544419	MIMO	201802	2	0	0	0	2	2	0	0	1016	449	58	662	214	16
13544419	MIMO	201803	1	0	0	0	1	0	0	0	1017	450	58	662	214	16
13544419	MIMO	201805	1	0	0	0	1	1	0	0	1018	450	58	663	214	16
13544419	MIMO	201806	2	0	0	0	2	2	0	0	1020	452	58	665	216	16
13544419	MIMO	201807	1	0	0	0	1	1	0	0	1021	453	58	666	217	16
18977	MINIX	200112	1	0	0	0	1	1	0	0	1	1	0	1	1	0
18977	MINIX	200201	2	0	0	0	2	2	0	0	3	3	0	3	2	0
18977	MINIX	200202	1	0	0	0	1	1	0	0	4	4	0	4	3	0
18977	MINIX	200209	1	0	0	0	1	1	0	0	5	5	0	5	3	0
18977	MINIX	200211	1	0	0	0	1	1	0	0	6	6	0	6	4	0
18977	MINIX	200306	2	0	0	0	2	1	0	0	8	8	0	7	5	0
18977	MINIX	200308	1	0	0	0	1	0	0	0	9	9	0	7	5	0
18977	MINIX	200309	1	0	0	0	1	1	0	0	10	10	0	8	6	0
18977	MINIX	200310	7	0	0	0	3	1	0	0	17	13	0	10	7	0
18977	MINIX	200311	2	0	0	0	2	1	0	0	19	15	0	11	8	0
18977	MINIX	200403	4	0	0	0	4	4	0	0	23	19	0	15	12	0
18977	MINIX	200404	2	0	0	0	1	1	0	0	25	20	0	17	13	0
18977	MINIX	200405	1	0	0	0	1	1	0	0	26	21	0	18	14	0
18977	MINIX	200406	3	0	0	0	3	3	0	0	29	23	0	21	16	0
18977	MINIX	200407	5	0	0	0	3	2	0	0	34	26	0	23	18	0
18977	MINIX	200408	4	0	0	0	2	2	0	0	38	28	0	27	20	0
18977	MINIX	200409	1	0	0	0	1	1	0	0	39	29	0	28	21	0
18977	MINIX	200410	3	0	0	0	1	1	0	0	42	30	0	31	22	0
18977	MINIX	200411	6	2	0	0	5	4	2	0	48	33	2	36	24	1
18977	MINIX	200501	1	0	0	0	1	1	0	0	49	34	2	37	25	1
18977	MINIX	200502	3	0	0	0	3	2	0	0	52	37	2	39	27	1
18977	MINIX	200503	3	0	0	0	3	3	0	0	55	40	2	42	30	1
18977	MINIX	200504	1	0	0	0	1	1	0	0	56	41	2	43	31	1
18977	MINIX	200506	1	0	0	0	1	1	0	0	57	42	2	44	32	1
18977	MINIX	200507	1	0	0	0	1	1	0	0	58	43	2	45	33	1
18977	MINIX	200508	9	0	0	0	6	3	0	0	67	47	2	50	34	1
18977	MINIX	200509	6	0	0	0	4	4	0	0	73	50	2	56	37	1
18977	MINIX	200510	2	0	0	0	2	1	0	0	75	52	2	57	38	1
18977	MINIX	200511	5	0	0	0	5	4	0	0	80	55	2	61	40	1
18977	MINIX	200512	9	0	0	0	8	6	0	0	89	62	2	67	45	1
18977	MINIX	200601	8	1	0	0	7	3	1	0	97	68	3	71	47	1
18977	MINIX	200603	2	0	0	0	2	2	0	0	99	69	3	73	48	1
18977	MINIX	200604	3	0	0	0	3	2	0	0	102	72	3	75	50	1
18977	MINIX	200605	7	1	0	0	6	2	1	0	109	78	4	78	52	1
18977	MINIX	200606	6	0	0	0	5	2	0	0	115	83	4	81	54	1
18977	MINIX	200607	5	0	0	0	5	3	0	0	120	88	4	84	57	1
18977	MINIX	200608	22	0	0	0	8	6	0	0	142	93	4	98	60	1
18977	MINIX	200609	11	0	0	0	4	2	0	0	153	96	4	107	61	1
18977	MINIX	200610	8	0	0	0	7	3	0	0	161	101	4	111	63	1
18977	MINIX	200611	2	0	0	0	2	1	0	0	163	103	4	112	64	1
18977	MINIX	200612	4	0	0	0	4	3	0	0	167	106	4	115	66	1
18977	MINIX	200701	5	0	0	0	2	1	0	0	172	108	4	118	67	1
18977	MINIX	200702	5	0	0	0	4	2	0	0	177	112	4	120	69	1
18977	MINIX	200703	9	1	0	0	7	3	1	0	186	118	5	124	71	1
18977	MINIX	200704	10	2	0	0	8	8	2	0	196	125	7	134	78	3
18977	MINIX	200705	5	0	0	0	5	4	0	0	201	130	7	138	82	3
18977	MINIX	200706	3	0	0	0	3	2	0	0	204	133	7	140	84	3
18977	MINIX	200707	2	0	0	0	2	0	0	0	206	135	7	140	84	3
18977	MINIX	200708	4	0	0	0	4	3	0	0	210	139	7	143	87	3
18977	MINIX	200709	3	0	0	0	2	2	0	0	213	140	7	146	88	3
18977	MINIX	200710	5	0	0	0	5	4	0	0	218	144	7	150	91	3
18977	MINIX	200711	2	0	0	0	2	1	0	0	220	146	7	151	92	3
18977	MINIX	200712	1	0	0	0	1	1	0	0	221	147	7	152	93	3
18977	MINIX	200801	2	0	0	0	2	1	0	0	223	149	7	153	94	3
18977	MINIX	200802	4	0	0	0	3	1	0	0	227	152	7	154	95	3
18977	MINIX	200803	2	0	0	0	1	0	0	0	229	152	7	154	95	3
18977	MINIX	200804	2	0	0	0	2	1	0	0	231	153	7	155	95	3
18977	MINIX	200805	4	0	0	0	2	1	0	0	235	155	7	158	96	3
18977	MINIX	200806	1	0	0	0	1	1	0	0	236	156	7	159	97	3
18977	MINIX	200807	2	0	0	0	2	1	0	0	238	158	7	160	98	3
18977	MINIX	200808	8	0	0	0	7	4	0	0	246	163	7	164	101	3
18977	MINIX	200809	4	1	0	0	4	3	1	0	250	167	8	167	104	3
18977	MINIX	200810	1	0	0	0	1	0	0	0	251	168	8	167	104	3
18977	MINIX	200811	5	0	0	0	4	1	0	0	256	171	8	168	104	3
18977	MINIX	200812	6	0	0	0	5	3	0	0	262	175	8	172	106	3
18977	MINIX	200901	3	0	0	0	3	2	0	0	265	176	8	174	107	3
18977	MINIX	200903	2	0	0	0	2	2	0	0	267	178	8	176	109	3
18977	MINIX	200904	2	0	0	0	2	2	0	0	269	180	8	178	111	3
18977	MINIX	200905	3	0	0	0	3	1	0	0	272	183	8	179	112	3
18977	MINIX	200906	2	0	0	0	2	1	0	0	274	185	8	180	113	3
18977	MINIX	200907	7	0	0	0	4	4	0	0	281	189	8	187	117	3
18977	MINIX	200908	2	0	0	0	2	2	0	0	283	191	8	189	119	3
18977	MINIX	200909	7	0	0	0	2	1	0	0	290	193	8	195	120	3
18977	MINIX	200910	1	0	0	0	1	1	0	0	291	194	8	196	121	3
18977	MINIX	200911	1	0	0	0	1	1	0	0	292	195	8	197	122	3
18977	MINIX	200912	2	0	0	0	2	0	0	0	294	197	8	197	122	3
18977	MINIX	201001	1	0	0	0	1	0	0	0	295	198	8	197	122	3
18977	MINIX	201002	2	0	0	0	2	2	0	0	297	200	8	199	124	3
18977	MINIX	201003	3	0	0	0	3	3	0	0	300	202	8	202	126	3
18977	MINIX	201004	4	1	0	0	4	4	1	0	304	205	9	206	129	4
18977	MINIX	201005	3	0	0	0	1	0	0	0	307	206	9	206	129	4
18977	MINIX	201006	1	0	0	0	1	1	0	0	308	206	9	207	129	4
18977	MINIX	201007	15	0	0	0	9	8	0	0	323	213	9	221	135	4
18977	MINIX	201008	3	0	0	0	3	0	0	0	326	216	9	221	135	4
18977	MINIX	201009	4	0	0	0	2	2	0	0	330	218	9	225	137	4
18977	MINIX	201010	2	0	0	0	2	2	0	0	332	220	9	227	139	4
18977	MINIX	201011	3	0	0	0	3	0	0	0	335	223	9	227	139	4
18977	MINIX	201012	1	0	0	0	1	1	0	0	336	224	9	228	140	4
18977	MINIX	201101	3	1	0	0	3	1	1	0	339	227	10	229	141	4
18977	MINIX	201102	3	0	0	0	2	2	0	0	342	229	10	232	143	4
18977	MINIX	201103	1	0	0	0	1	1	0	0	343	230	10	233	144	4
18977	MINIX	201104	4	0	0	0	2	2	0	0	347	231	10	237	145	4
18977	MINIX	201105	2	0	0	0	2	2	0	0	349	233	10	239	147	4
18977	MINIX	201107	1	0	0	0	1	0	0	0	350	234	10	239	147	4
18977	MINIX	201108	7	0	0	0	6	1	0	0	357	240	10	240	148	4
18977	MINIX	201109	6	0	0	0	4	3	0	0	363	243	10	245	150	4
18977	MINIX	201110	2	1	0	0	2	1	1	0	365	244	11	246	150	4
18977	MINIX	201111	1	0	0	0	1	0	0	0	366	245	11	246	150	4
18977	MINIX	201112	1	0	0	0	1	1	0	0	367	245	11	247	150	4
18977	MINIX	201202	1	0	0	0	1	1	0	0	368	246	11	248	151	4
18977	MINIX	201203	2	0	0	0	2	0	0	0	370	248	11	248	151	4
18977	MINIX	201204	1	0	0	0	1	1	0	0	371	249	11	249	152	4
18977	MINIX	201205	1	0	0	0	1	1	0	0	372	250	11	250	153	4
18977	MINIX	201206	4	0	0	0	3	2	0	0	376	253	11	252	155	4
18977	MINIX	201207	1	0	0	0	1	0	0	0	377	254	11	252	155	4
18977	MINIX	201212	3	0	0	0	3	2	0	0	380	257	11	254	157	4
18977	MINIX	201301	1	0	0	0	1	1	0	0	381	258	11	255	158	4
18977	MINIX	201302	1	0	0	0	1	1	0	0	382	258	11	256	158	4
18977	MINIX	201303	2	0	0	0	2	1	0	0	384	260	11	257	159	4
18977	MINIX	201304	2	0	0	0	2	2	0	0	386	262	11	259	161	4
18977	MINIX	201306	1	0	0	0	1	1	0	0	387	263	11	260	162	4
18977	MINIX	201309	1	0	0	0	1	1	0	0	388	264	11	261	163	4
18977	MINIX	201310	2	1	0	0	2	1	1	0	390	266	12	262	164	5
18977	MINIX	201311	2	0	0	0	2	1	0	0	392	268	12	263	165	5
18977	MINIX	201312	1	0	0	0	1	1	0	0	393	269	12	264	166	5
18977	MINIX	201401	2	0	0	0	2	2	0	0	395	271	12	266	168	5
18977	MINIX	201402	2	0	0	0	1	1	0	0	397	272	12	268	169	5
18977	MINIX	201403	3	0	0	0	1	1	0	0	400	272	12	271	169	5
18977	MINIX	201405	1	0	0	0	1	0	0	0	401	273	12	271	169	5
18977	MINIX	201408	4	1	0	0	4	3	1	0	405	276	13	274	171	5
18977	MINIX	201409	5	0	0	0	3	1	0	0	410	278	13	276	171	5
18977	MINIX	201410	2	0	0	0	2	2	0	0	412	280	13	278	173	5
18977	MINIX	201501	2	0	0	0	2	1	0	0	414	282	13	279	174	5
18977	MINIX	201505	1	0	0	0	1	1	0	0	415	283	13	280	174	5
18977	MINIX	201506	1	0	0	0	1	1	0	0	416	284	13	281	175	5
18977	MINIX	201508	2	0	0	0	2	2	0	0	418	285	13	283	176	5
18977	MINIX	201511	6	0	0	0	5	4	0	0	424	290	13	288	180	5
18977	MINIX	201512	2	1	0	0	2	1	1	0	426	292	14	289	181	5
18977	MINIX	201601	3	0	0	0	3	2	0	0	429	295	14	291	183	5
18977	MINIX	201605	6	0	0	0	3	2	0	0	435	297	14	296	184	5
18977	MINIX	201607	1	0	0	0	1	0	0	0	436	298	14	296	184	5
18977	MINIX	201608	2	1	0	0	2	2	1	0	438	300	15	298	186	6
18977	MINIX	201609	5	0	0	0	3	3	0	0	443	303	15	303	189	6
18977	MINIX	201610	1	0	0	0	1	1	0	0	444	304	15	304	190	6
18977	MINIX	201612	2	0	0	0	2	2	0	0	446	306	15	306	192	6
18977	MINIX	201701	1	0	0	0	1	0	0	0	447	307	15	306	192	6
18977	MINIX	201703	1	0	0	0	1	1	0	0	448	308	15	307	193	6
18977	MINIX	201704	2	0	0	0	2	2	0	0	450	309	15	309	194	6
18977	MINIX	201705	3	0	0	0	2	1	0	0	453	309	15	310	194	6
18977	MINIX	201707	1	0	0	0	1	1	0	0	454	309	15	311	194	6
18977	MINIX	201708	2	0	0	0	2	1	0	0	456	311	15	312	195	6
18977	MINIX	201709	1	0	0	0	1	1	0	0	457	312	15	313	196	6
18977	MINIX	201711	2	0	0	0	2	1	0	0	459	314	15	314	197	6
18977	MINIX	201712	7	2	0	0	6	4	2	0	466	320	17	318	200	6
18977	MINIX	201801	2	1	0	0	2	2	1	0	468	322	18	320	202	7
18977	MINIX	201802	2	0	0	0	2	2	0	0	470	323	18	322	203	7
18977	MINIX	201803	1	0	0	0	1	1	0	0	471	324	18	323	204	7
18977	MINIX	201804	1	0	0	0	1	1	0	0	472	325	18	324	204	7
18977	MINIX	201805	1	0	0	0	1	1	0	0	473	326	18	325	205	7
18977	MINIX	201806	1	0	0	0	1	1	0	0	474	326	18	326	205	7
18977	MINIX	201807	2	0	0	0	1	1	0	0	476	327	18	328	206	7
233488	Machine_learning	200306	3	0	0	0	1	1	0	0	3	1	0	3	1	0
233488	Machine_learning	200312	1	0	0	0	1	0	0	0	4	2	0	3	1	0
233488	Machine_learning	200401	2	0	0	0	2	1	0	0	6	4	0	4	2	0
233488	Machine_learning	200402	2	0	0	0	2	2	0	0	8	5	0	6	3	0
233488	Machine_learning	200403	1	0	0	0	1	1	0	0	9	5	0	7	3	0
233488	Machine_learning	200404	1	0	0	0	1	1	0	0	10	6	0	8	4	0
233488	Machine_learning	200406	1	0	0	0	1	1	0	0	11	7	0	9	5	0
233488	Machine_learning	200407	1	0	0	0	1	1	0	0	12	7	0	10	5	0
233488	Machine_learning	200408	2	0	0	0	2	2	0	0	14	9	0	12	7	0
233488	Machine_learning	200409	5	2	0	0	3	2	1	0	19	12	2	15	9	0
233488	Machine_learning	200410	6	0	0	0	4	3	0	0	25	15	2	20	11	0
233488	Machine_learning	200411	9	0	0	0	6	4	0	0	34	20	2	26	14	0
233488	Machine_learning	200412	1	0	0	0	1	1	0	0	35	21	2	27	15	0
233488	Machine_learning	200501	4	0	0	0	4	2	0	0	39	24	2	29	16	0
233488	Machine_learning	200502	3	0	0	0	3	2	0	0	42	26	2	31	17	0
233488	Machine_learning	200503	12	0	0	0	5	2	0	0	54	29	2	35	17	0
233488	Machine_learning	200504	14	0	0	0	6	3	0	0	68	34	2	46	19	0
233488	Machine_learning	200505	19	0	0	0	10	4	0	0	87	42	2	55	22	0
233488	Machine_learning	200506	1	0	0	0	1	0	0	0	88	43	2	55	22	0
233488	Machine_learning	200507	4	0	0	0	3	1	0	0	92	45	2	57	22	0
233488	Machine_learning	200508	13	1	0	0	11	5	1	0	105	54	3	63	25	1
233488	Machine_learning	200509	2	0	0	0	1	0	0	0	107	55	3	63	25	1
233488	Machine_learning	200510	9	0	0	0	6	1	0	0	116	61	3	64	26	1
233488	Machine_learning	200511	8	0	0	0	5	2	0	0	124	66	3	68	28	1
233488	Machine_learning	200512	7	0	0	0	6	2	0	0	131	72	3	70	30	1
233488	Machine_learning	200601	11	0	0	0	7	5	0	0	142	78	3	77	34	1
233488	Machine_learning	200602	6	1	0	0	5	4	1	0	148	83	4	82	38	2
233488	Machine_learning	200603	16	0	0	0	9	6	0	0	164	91	4	94	44	2
233488	Machine_learning	200604	11	0	0	0	9	2	0	0	175	100	4	96	46	2
233488	Machine_learning	200605	10	1	0	0	9	5	1	0	185	108	5	102	50	2
233488	Machine_learning	200606	10	1	0	0	6	2	1	0	195	113	6	104	51	2
233488	Machine_learning	200607	13	0	0	0	10	3	0	0	208	122	6	110	54	2
233488	Machine_learning	200608	11	0	0	0	8	3	0	0	219	130	6	115	57	2
233488	Machine_learning	200609	13	1	0	0	10	5	1	0	232	139	7	122	62	2
233488	Machine_learning	200610	19	0	0	0	9	5	0	0	251	146	7	135	66	2
233488	Machine_learning	200611	5	0	0	0	5	4	0	0	256	151	7	139	70	2
233488	Machine_learning	200612	14	1	0	0	11	4	1	0	270	160	8	145	73	2
233488	Machine_learning	200701	10	1	0	0	6	5	1	0	280	165	9	154	77	2
233488	Machine_learning	200702	19	1	0	0	14	7	1	0	299	177	10	163	82	2
233488	Machine_learning	200703	13	2	0	0	10	9	2	0	312	185	12	173	89	2
233488	Machine_learning	200704	18	3	0	0	11	6	3	0	330	195	15	180	94	3
233488	Machine_learning	200705	22	0	0	0	10	7	0	0	352	203	15	198	99	3
233488	Machine_learning	200706	14	0	0	0	12	6	0	0	366	213	15	205	103	3
233488	Machine_learning	200707	7	1	0	0	6	1	1	0	373	218	16	207	103	3
233488	Machine_learning	200708	10	1	0	0	7	3	1	0	383	225	17	213	106	3
233488	Machine_learning	200709	3	0	0	0	2	2	0	0	386	227	17	216	108	3
233488	Machine_learning	200710	1	0	0	0	1	1	0	0	387	228	17	217	109	3
233488	Machine_learning	200711	9	0	0	0	9	5	0	0	396	236	17	222	113	3
233488	Machine_learning	200712	9	2	0	0	9	4	2	0	405	244	19	226	116	3
233488	Machine_learning	200801	5	0	0	0	4	2	0	0	410	248	19	228	118	3
233488	Machine_learning	200802	5	1	0	0	5	3	1	0	415	253	20	231	121	3
233488	Machine_learning	200803	6	0	0	0	5	2	0	0	421	256	20	233	121	3
233488	Machine_learning	200804	2	0	0	0	2	1	0	0	423	258	20	234	122	3
233488	Machine_learning	200805	2	0	0	0	2	1	0	0	425	260	20	235	123	3
233488	Machine_learning	200806	14	2	0	0	8	6	1	0	439	266	22	247	127	4
233488	Machine_learning	200807	5	1	0	0	5	4	1	0	444	271	23	251	131	5
233488	Machine_learning	200808	5	2	0	0	4	3	1	0	449	274	25	255	133	7
233488	Machine_learning	200809	14	5	0	0	12	9	5	0	463	283	30	264	139	9
233488	Machine_learning	200810	6	1	0	0	6	4	1	0	469	288	31	268	142	9
233488	Machine_learning	200811	4	1	0	0	3	3	1	0	473	290	32	272	144	10
233488	Machine_learning	200812	6	2	0	0	5	3	2	0	479	294	34	276	146	11
233488	Machine_learning	200901	2	0	0	0	2	0	0	0	481	296	34	276	146	11
233488	Machine_learning	200902	5	0	0	0	3	1	0	0	486	299	34	277	147	11
233488	Machine_learning	200903	6	1	0	0	6	4	1	0	492	304	35	281	150	11
233488	Machine_learning	200904	6	0	0	0	6	3	0	0	498	310	35	284	153	11
233488	Machine_learning	200905	11	1	0	0	7	6	1	0	509	315	36	294	157	12
233488	Machine_learning	200906	9	2	0	0	6	3	1	0	518	321	38	298	160	14
233488	Machine_learning	200907	2	0	0	0	2	1	0	0	520	323	38	299	161	14
233488	Machine_learning	200908	7	0	0	0	6	1	0	0	527	329	38	300	162	14
233488	Machine_learning	200909	10	2	0	0	8	2	1	0	537	336	40	303	163	14
233488	Machine_learning	200910	1	0	0	0	1	1	0	0	538	337	40	304	164	14
233488	Machine_learning	200912	10	2	0	0	8	2	2	0	548	345	42	306	166	14
233488	Machine_learning	201001	7	1	0	0	5	3	1	0	555	350	43	310	169	15
233488	Machine_learning	201002	8	1	0	0	7	4	1	0	563	357	44	314	173	15
233488	Machine_learning	201003	11	0	0	0	6	3	0	0	574	362	44	319	175	15
233488	Machine_learning	201004	2	0	0	0	2	1	0	0	576	364	44	320	176	15
233488	Machine_learning	201005	26	5	2	1	7	5	2	2	602	369	49	343	179	19
233488	Machine_learning	201006	17	2	0	0	7	3	1	0	619	375	51	354	181	19
233488	Machine_learning	201007	6	2	0	0	6	5	2	0	625	378	53	359	184	21
233488	Machine_learning	201008	22	9	1	0	12	9	6	1	647	386	62	378	189	28
233488	Machine_learning	201009	9	2	0	0	8	5	2	0	656	394	64	384	194	29
233488	Machine_learning	201010	11	2	0	0	8	4	2	0	667	401	66	390	197	29
233488	Machine_learning	201011	5	2	0	0	5	4	2	0	672	405	68	394	200	31
233488	Machine_learning	201012	7	2	0	0	5	3	2	0	679	409	70	398	202	31
233488	Machine_learning	201101	8	1	0	0	6	5	1	0	687	414	71	405	206	32
233488	Machine_learning	201102	13	3	0	0	10	9	3	0	700	421	74	417	212	34
233488	Machine_learning	201103	6	1	0	0	5	2	1	0	706	426	75	419	214	34
233488	Machine_learning	201104	15	2	0	0	10	7	2	0	721	432	77	431	217	34
233488	Machine_learning	201105	24	1	0	0	13	7	1	0	745	443	78	446	222	35
233488	Machine_learning	201106	8	2	0	0	5	4	2	0	753	447	80	452	225	36
233488	Machine_learning	201107	4	1	0	0	2	2	1	0	757	448	81	456	226	37
233488	Machine_learning	201108	2	0	0	0	2	1	0	0	759	450	81	457	227	37
233488	Machine_learning	201109	8	2	0	0	7	4	2	0	767	455	83	462	229	37
233488	Machine_learning	201110	17	0	0	0	10	6	0	0	784	465	83	473	235	37
233488	Machine_learning	201111	8	0	0	0	7	4	0	0	792	471	83	477	238	37
233488	Machine_learning	201112	12	4	0	0	10	8	3	0	804	478	87	487	243	39
233488	Machine_learning	201201	12	3	0	0	10	7	2	0	816	485	90	496	247	40
233488	Machine_learning	201202	1	0	0	0	1	1	0	0	817	486	90	497	248	40
233488	Machine_learning	201203	12	1	0	0	9	6	1	0	829	494	91	506	253	40
233488	Machine_learning	201204	8	0	0	0	5	3	0	0	837	498	91	511	255	40
233488	Machine_learning	201205	12	2	0	0	9	5	1	0	849	506	93	518	259	41
233488	Machine_learning	201206	5	2	0	0	4	2	1	0	854	509	95	521	260	41
233488	Machine_learning	201207	6	1	0	0	5	3	1	0	860	514	96	525	263	41
233488	Machine_learning	201208	4	0	0	0	3	2	0	0	864	517	96	528	265	41
233488	Machine_learning	201209	10	1	0	0	6	3	1	0	874	522	97	535	267	41
233488	Machine_learning	201210	11	2	0	0	9	6	1	0	885	530	99	543	272	41
233488	Machine_learning	201211	7	1	0	0	6	2	1	0	892	536	100	545	274	41
233488	Machine_learning	201212	24	1	0	0	7	5	1	0	916	541	101	566	277	41
233488	Machine_learning	201301	13	1	0	0	11	6	1	0	929	549	102	573	280	41
233488	Machine_learning	201302	7	2	0	0	5	1	2	0	936	554	104	574	281	41
233488	Machine_learning	201303	14	1	0	0	11	8	1	0	950	563	105	584	287	41
233488	Machine_learning	201304	6	0	0	0	6	4	0	0	956	568	105	588	290	41
233488	Machine_learning	201305	12	2	0	0	11	9	2	0	968	577	107	598	297	41
233488	Machine_learning	201306	4	1	0	0	3	2	1	0	972	580	108	600	299	41
233488	Machine_learning	201307	11	1	0	0	9	4	1	0	983	587	109	606	301	41
233488	Machine_learning	201308	3	1	0	0	2	2	1	0	986	588	110	609	302	42
233488	Machine_learning	201309	12	1	0	0	8	6	1	0	998	594	111	618	306	42
233488	Machine_learning	201310	8	1	0	0	5	3	1	0	1006	598	112	622	308	43
233488	Machine_learning	201311	6	1	0	0	6	4	1	0	1012	603	113	626	311	43
233488	Machine_learning	201312	9	2	0	0	4	1	1	0	1021	606	115	628	311	43
233488	Machine_learning	201401	4	1	0	0	3	2	1	0	1025	608	116	631	312	43
233488	Machine_learning	201402	5	0	0	0	4	3	0	0	1030	611	116	634	314	43
233488	Machine_learning	201403	4	0	0	0	4	3	0	0	1034	614	116	637	316	43
233488	Machine_learning	201404	9	2	0	0	8	4	2	0	1043	620	118	641	318	43
233488	Machine_learning	201405	3	1	0	0	3	2	1	0	1046	622	119	643	319	43
233488	Machine_learning	201406	15	1	0	0	10	6	1	0	1061	629	120	651	322	43
233488	Machine_learning	201407	3	0	0	0	1	1	0	0	1064	630	120	654	323	43
233488	Machine_learning	201408	20	1	0	0	14	12	1	0	1084	639	121	672	327	43
233488	Machine_learning	201409	8	0	0	0	6	4	0	0	1092	643	121	676	329	43
233488	Machine_learning	201410	15	5	0	0	13	8	5	0	1107	653	126	684	333	44
233488	Machine_learning	201411	33	4	0	0	17	12	3	0	1140	666	130	711	341	45
233488	Machine_learning	201412	18	4	0	0	11	6	1	0	1158	675	134	724	345	46
233488	Machine_learning	201501	19	1	0	0	9	6	1	0	1177	682	135	740	348	47
233488	Machine_learning	201502	18	5	0	0	16	5	5	0	1195	695	140	746	350	47
233488	Machine_learning	201503	16	1	0	0	8	6	1	0	1211	700	141	760	354	48
233488	Machine_learning	201504	10	1	0	0	7	5	1	0	1221	706	142	766	358	48
233488	Machine_learning	201505	24	3	0	0	15	9	3	0	1245	716	145	783	362	50
233488	Machine_learning	201506	22	2	0	0	10	8	2	0	1267	722	147	802	366	51
233488	Machine_learning	201507	25	10	4	3	14	9	4	2	1292	733	157	816	371	54
233488	Machine_learning	201508	11	2	0	0	8	4	2	0	1303	739	159	821	373	54
233488	Machine_learning	201509	14	3	2	1	9	8	2	2	1317	745	162	834	378	57
233488	Machine_learning	201510	39	10	0	0	12	7	7	0	1356	754	172	864	382	63
233488	Machine_learning	201511	10	1	0	0	6	4	1	0	1366	759	173	871	385	63
233488	Machine_learning	201512	12	2	0	0	9	7	2	0	1378	766	175	881	390	65
233488	Machine_learning	201601	18	2	0	0	13	8	2	0	1396	776	177	890	395	65
233488	Machine_learning	201602	21	3	0	0	13	5	2	0	1417	785	180	900	396	65
233488	Machine_learning	201603	17	2	0	0	13	9	2	0	1434	794	182	912	401	66
233488	Machine_learning	201604	24	7	0	0	18	13	7	0	1458	807	189	928	409	70
233488	Machine_learning	201605	30	4	0	0	20	13	4	0	1488	823	193	946	417	72
233488	Machine_learning	201606	4	0	0	0	4	2	0	0	1492	827	193	948	419	72
233488	Machine_learning	201607	18	1	0	0	15	9	1	0	1510	840	194	960	425	73
233488	Machine_learning	201608	34	6	0	0	15	7	3	0	1544	851	200	981	428	76
233488	Machine_learning	201609	23	2	0	0	14	9	2	0	1567	862	202	997	434	77
233488	Machine_learning	201610	18	4	0	0	16	13	4	0	1585	875	206	1011	441	79
233488	Machine_learning	201611	29	2	0	0	14	13	2	0	1614	887	208	1030	449	81
233488	Machine_learning	201612	34	2	0	0	18	17	2	0	1648	897	210	1062	458	83
233488	Machine_learning	201701	9	1	0	0	9	7	1	0	1657	903	211	1069	461	84
233488	Machine_learning	201702	12	2	0	0	10	7	2	0	1669	910	213	1076	465	85
233488	Machine_learning	201703	20	5	0	0	14	10	4	0	1689	918	218	1091	469	88
233488	Machine_learning	201704	39	9	0	0	27	18	9	0	1728	939	227	1121	481	91
233488	Machine_learning	201705	26	4	0	0	17	11	4	0	1754	951	231	1138	486	93
233488	Machine_learning	201706	14	2	0	0	13	9	2	0	1768	958	233	1147	489	93
233488	Machine_learning	201707	20	4	0	0	16	12	4	0	1788	972	237	1160	497	95
233488	Machine_learning	201708	22	3	0	0	17	8	3	0	1810	986	240	1170	502	95
233488	Machine_learning	201709	34	3	0	0	18	11	3	0	1844	998	243	1195	507	97
233488	Machine_learning	201710	29	2	0	0	21	16	2	0	1873	1016	245	1217	520	97
233488	Machine_learning	201711	13	4	0	0	11	8	3	0	1886	1024	249	1226	525	99
233488	Machine_learning	201712	22	4	0	0	17	10	4	0	1908	1037	253	1238	531	100
233488	Machine_learning	201801	12	3	0	0	12	7	3	0	1920	1048	256	1245	537	101
233488	Machine_learning	201802	20	5	0	0	15	9	4	0	1940	1059	261	1257	542	103
233488	Machine_learning	201803	17	3	0	0	13	10	2	0	1957	1069	264	1271	549	104
233488	Machine_learning	201804	20	6	0	0	17	9	4	0	1977	1084	270	1282	555	106
233488	Machine_learning	201805	23	2	0	0	19	14	2	0	2000	1100	272	1300	565	106
233488	Machine_learning	201806	37	6	1	0	21	15	4	1	2037	1117	278	1330	575	111
233488	Machine_learning	201807	29	8	0	0	19	12	5	0	2066	1128	286	1350	580	113
19980	Machine_translation	200111	1	0	0	0	1	1	0	0	1	1	0	1	1	0
19980	Machine_translation	200201	1	0	0	0	1	1	0	0	2	2	0	2	2	0
19980	Machine_translation	200202	6	0	0	0	3	3	0	0	8	5	0	8	4	0
19980	Machine_translation	200205	1	0	0	0	1	1	0	0	9	6	0	9	4	0
19980	Machine_translation	200206	2	0	0	0	2	2	0	0	11	7	0	11	5	0
19980	Machine_translation	200209	1	0	0	0	1	1	0	0	12	7	0	12	5	0
19980	Machine_translation	200210	1	0	0	0	1	0	0	0	13	8	0	12	5	0
19980	Machine_translation	200301	1	0	0	0	1	1	0	0	14	8	0	13	5	0
19980	Machine_translation	200302	2	0	0	0	2	1	0	0	16	10	0	14	6	0
19980	Machine_translation	200303	1	0	0	0	1	1	0	0	17	11	0	15	7	0
19980	Machine_translation	200304	2	0	0	0	2	2	0	0	19	12	0	17	8	0
19980	Machine_translation	200305	1	0	0	0	1	1	0	0	20	12	0	18	8	0
19980	Machine_translation	200306	3	0	0	0	3	1	0	0	23	15	0	19	9	0
19980	Machine_translation	200308	2	0	0	0	1	1	0	0	25	16	0	21	10	0
19980	Machine_translation	200309	4	0	0	0	2	2	0	0	29	17	0	25	11	0
19980	Machine_translation	200310	8	0	0	0	4	2	0	0	37	20	0	29	12	0
19980	Machine_translation	200311	2	0	0	0	1	1	0	0	39	20	0	31	12	0
19980	Machine_translation	200312	2	0	0	0	2	2	0	0	41	22	0	33	14	0
19980	Machine_translation	200401	2	0	0	0	2	2	0	0	43	24	0	35	16	0
19980	Machine_translation	200402	1	0	0	0	1	1	0	0	44	24	0	36	16	0
19980	Machine_translation	200403	2	0	0	0	2	1	0	0	46	26	0	37	17	0
19980	Machine_translation	200404	1	0	0	0	1	0	0	0	47	27	0	37	17	0
19980	Machine_translation	200405	6	0	0	0	4	4	0	0	53	31	0	43	21	0
19980	Machine_translation	200406	55	4	2	1	12	8	2	2	108	42	4	93	28	4
19980	Machine_translation	200407	2	0	0	0	2	2	0	0	110	43	4	95	29	4
19980	Machine_translation	200408	3	0	0	0	3	3	0	0	113	46	4	98	32	4
19980	Machine_translation	200410	8	0	0	0	5	4	0	0	121	49	4	105	34	4
19980	Machine_translation	200411	9	0	0	0	9	5	0	0	130	57	4	110	38	4
19980	Machine_translation	200412	4	0	0	0	3	1	0	0	134	60	4	111	39	4
19980	Machine_translation	200501	1	0	0	0	1	1	0	0	135	61	4	112	40	4
19980	Machine_translation	200502	6	2	0	0	5	3	2	0	141	65	6	116	42	4
19980	Machine_translation	200503	2	0	0	0	2	2	0	0	143	66	6	118	43	4
19980	Machine_translation	200504	18	0	0	0	4	3	0	0	161	69	6	135	45	4
19980	Machine_translation	200505	7	2	0	0	7	2	2	0	168	75	8	137	46	4
19980	Machine_translation	200506	7	1	0	0	7	3	1	0	175	80	9	140	47	4
19980	Machine_translation	200507	4	0	0	0	3	2	0	0	179	83	9	142	49	4
19980	Machine_translation	200508	11	1	0	0	8	6	1	0	190	90	10	151	54	4
19980	Machine_translation	200509	10	2	0	0	7	4	2	0	200	95	12	155	57	4
19980	Machine_translation	200510	10	1	0	0	9	7	1	0	210	103	13	163	63	4
19980	Machine_translation	200511	23	0	0	0	11	7	0	0	233	112	13	180	68	4
19980	Machine_translation	200512	23	3	0	0	12	4	2	0	256	122	16	186	70	4
19980	Machine_translation	200601	7	1	0	0	7	5	1	0	263	129	17	191	75	4
19980	Machine_translation	200602	29	1	0	0	11	8	1	0	292	137	18	216	80	4
19980	Machine_translation	200603	27	2	0	0	15	11	2	0	319	147	20	235	86	4
19980	Machine_translation	200604	31	0	0	0	9	5	0	0	350	153	20	261	88	4
19980	Machine_translation	200605	35	5	1	0	11	10	2	1	385	162	25	294	96	8
19980	Machine_translation	200606	29	10	4	0	17	13	5	2	414	177	35	319	107	16
19980	Machine_translation	200607	38	3	0	0	12	8	3	0	452	187	38	346	113	18
19980	Machine_translation	200608	4	1	0	0	4	3	1	0	456	189	39	349	115	18
19980	Machine_translation	200609	15	4	1	0	11	7	3	1	471	198	43	358	120	19
19980	Machine_translation	200610	26	3	0	0	13	5	3	0	497	210	46	363	124	19
19980	Machine_translation	200611	20	5	0	0	17	10	5	0	517	226	51	375	133	21
19980	Machine_translation	200612	12	1	0	0	8	6	1	0	529	233	52	383	138	22
19980	Machine_translation	200701	21	2	0	0	8	5	2	0	550	239	54	394	141	23
19980	Machine_translation	200702	30	3	0	0	13	5	3	0	580	251	57	408	145	23
19980	Machine_translation	200703	12	0	0	0	7	5	0	0	592	255	57	416	147	23
19980	Machine_translation	200704	9	0	0	0	6	5	0	0	601	259	57	424	150	23
19980	Machine_translation	200705	27	2	0	0	12	9	2	0	628	267	59	448	155	23
19980	Machine_translation	200706	13	0	0	0	8	6	0	0	641	271	59	457	157	23
19980	Machine_translation	200707	7	0	0	0	5	3	0	0	648	274	59	462	158	23
19980	Machine_translation	200708	5	0	0	0	5	2	0	0	653	278	59	464	160	23
19980	Machine_translation	200709	8	2	0	0	8	4	2	0	661	285	61	468	163	23
19980	Machine_translation	200710	10	1	0	0	7	4	1	0	671	292	62	474	167	23
19980	Machine_translation	200711	11	1	0	0	8	6	1	0	682	298	63	483	171	24
19980	Machine_translation	200712	2	0	0	0	2	0	0	0	684	300	63	483	171	24
19980	Machine_translation	200801	8	2	0	0	7	5	2	0	692	306	65	489	175	24
19980	Machine_translation	200802	16	1	0	0	13	10	1	0	708	316	66	502	182	24
19980	Machine_translation	200803	4	0	0	0	4	2	0	0	712	320	66	504	184	24
19980	Machine_translation	200804	1	0	0	0	1	1	0	0	713	320	66	505	184	24
19980	Machine_translation	200805	10	3	0	0	8	6	2	0	723	328	69	512	190	27
19980	Machine_translation	200806	12	2	0	0	7	2	1	0	735	335	71	514	192	27
19980	Machine_translation	200807	4	0	0	0	2	1	0	0	739	336	71	517	193	27
19980	Machine_translation	200808	7	0	0	0	4	4	0	0	746	338	71	524	195	27
19980	Machine_translation	200809	7	0	0	0	6	5	0	0	753	343	71	530	199	27
19980	Machine_translation	200810	13	0	0	0	4	3	0	0	766	346	71	542	201	27
19980	Machine_translation	200811	5	0	0	0	4	0	0	0	771	350	71	542	201	27
19980	Machine_translation	200812	11	0	0	0	7	6	0	0	782	355	71	552	205	27
19980	Machine_translation	200901	9	2	0	0	7	6	1	0	791	361	73	560	210	29
19980	Machine_translation	200902	4	0	0	0	2	2	0	0	795	362	73	564	211	29
19980	Machine_translation	200903	4	0	0	0	2	0	0	0	799	364	73	564	211	29
19980	Machine_translation	200904	10	1	0	0	6	4	1	0	809	369	74	571	214	29
19980	Machine_translation	200905	9	0	0	0	8	6	0	0	818	376	74	578	219	29
19980	Machine_translation	200906	11	1	0	0	8	5	1	0	829	382	75	584	222	29
19980	Machine_translation	200907	7	0	0	0	2	2	0	0	836	383	75	591	223	29
19980	Machine_translation	200908	14	1	0	0	9	8	1	0	850	389	76	604	228	30
19980	Machine_translation	200909	11	1	0	0	6	6	1	0	861	394	77	615	233	31
19980	Machine_translation	200910	13	1	0	0	7	5	1	0	874	400	78	620	237	31
19980	Machine_translation	200911	4	1	0	0	4	3	1	0	878	404	79	623	240	31
19980	Machine_translation	200912	4	0	0	0	4	1	0	0	882	408	79	624	241	31
19980	Machine_translation	201001	7	1	0	0	6	5	1	0	889	413	80	630	245	32
19980	Machine_translation	201002	14	0	0	0	10	4	0	0	903	423	80	634	249	32
19980	Machine_translation	201003	5	0	0	0	5	4	0	0	908	427	80	638	252	32
19980	Machine_translation	201004	5	1	0	0	5	3	1	0	913	432	81	641	255	32
19980	Machine_translation	201005	8	1	0	0	6	5	1	0	921	437	82	648	259	32
19980	Machine_translation	201006	5	0	0	0	4	2	0	0	926	441	82	651	261	32
19980	Machine_translation	201007	2	0	0	0	2	1	0	0	928	443	82	652	262	32
19980	Machine_translation	201008	6	0	0	0	4	2	0	0	934	447	82	656	264	32
19980	Machine_translation	201009	5	1	0	0	5	3	1	0	939	451	83	659	266	32
19980	Machine_translation	201010	1	0	0	0	1	1	0	0	940	452	83	660	267	32
19980	Machine_translation	201011	13	1	0	0	9	6	1	0	953	460	84	669	272	32
19980	Machine_translation	201012	3	0	0	0	2	2	0	0	956	460	84	672	272	32
19980	Machine_translation	201101	7	0	0	0	4	2	0	0	963	464	84	676	274	32
19980	Machine_translation	201102	13	0	0	0	8	3	0	0	976	472	84	680	277	32
19980	Machine_translation	201103	9	0	0	0	7	4	0	0	985	478	84	685	280	32
19980	Machine_translation	201104	7	0	0	0	7	5	0	0	992	484	84	690	284	32
19980	Machine_translation	201105	8	1	0	0	5	5	1	0	1000	488	85	698	288	33
19980	Machine_translation	201106	6	0	0	0	5	2	0	0	1006	492	85	700	290	33
19980	Machine_translation	201107	10	1	0	0	9	4	1	0	1016	498	86	704	291	33
19980	Machine_translation	201108	4	0	0	0	4	2	0	0	1020	501	86	706	292	33
19980	Machine_translation	201109	2	0	0	0	2	0	0	0	1022	503	86	706	292	33
19980	Machine_translation	201110	4	0	0	0	4	4	0	0	1026	507	86	710	296	33
19980	Machine_translation	201111	8	0	0	0	8	6	0	0	1034	511	86	716	298	33
19980	Machine_translation	201112	8	0	0	0	5	2	0	0	1042	515	86	720	299	33
19980	Machine_translation	201201	6	1	0	0	4	2	1	0	1048	519	87	723	301	33
19980	Machine_translation	201202	10	3	0	0	10	7	3	0	1058	528	90	730	307	34
19980	Machine_translation	201203	1	0	0	0	1	1	0	0	1059	529	90	731	308	34
19980	Machine_translation	201204	2	0	0	0	2	2	0	0	1061	530	90	733	309	34
19980	Machine_translation	201205	1	0	0	0	1	1	0	0	1062	531	90	734	310	34
19980	Machine_translation	201206	26	6	3	2	6	5	3	2	1088	535	96	759	313	40
19980	Machine_translation	201207	19	3	2	2	11	10	2	2	1107	543	99	777	320	43
19980	Machine_translation	201208	12	0	0	0	6	3	0	0	1119	548	99	780	322	43
19980	Machine_translation	201209	22	4	0	0	13	9	2	0	1141	556	103	796	326	45
19980	Machine_translation	201210	3	0	0	0	3	2	0	0	1144	557	103	798	327	45
19980	Machine_translation	201211	5	2	0	0	4	3	2	0	1149	559	105	802	328	46
19980	Machine_translation	201212	18	4	0	0	11	9	3	0	1167	566	109	817	333	48
19980	Machine_translation	201301	8	1	0	0	6	5	1	0	1175	572	110	824	338	48
19980	Machine_translation	201302	5	0	0	0	3	1	0	0	1180	574	110	825	338	48
19980	Machine_translation	201303	2	0	0	0	2	2	0	0	1182	576	110	827	340	48
19980	Machine_translation	201304	6	1	0	0	6	4	1	0	1188	581	111	831	343	48
19980	Machine_translation	201305	3	1	0	0	3	2	1	0	1191	583	112	833	344	48
19980	Machine_translation	201306	3	0	0	0	3	2	0	0	1194	585	112	835	345	48
19980	Machine_translation	201307	4	1	0	0	3	2	1	0	1198	587	113	838	346	48
19980	Machine_translation	201308	4	1	0	0	3	2	1	0	1202	589	114	840	347	49
19980	Machine_translation	201309	2	0	0	0	2	2	0	0	1204	591	114	842	349	49
19980	Machine_translation	201310	10	0	0	0	8	7	0	0	1214	597	114	851	354	49
19980	Machine_translation	201311	6	1	0	0	5	4	1	0	1220	600	115	856	356	49
19980	Machine_translation	201312	21	2	0	0	14	9	2	0	1241	609	117	871	360	49
19980	Machine_translation	201401	7	1	0	0	4	2	1	0	1248	612	118	876	361	49
19980	Machine_translation	201402	3	1	0	0	2	2	1	0	1251	614	119	879	363	50
19980	Machine_translation	201403	4	1	0	0	3	1	1	0	1255	616	120	880	363	50
19980	Machine_translation	201404	7	0	0	0	6	5	0	0	1262	620	120	886	366	50
19980	Machine_translation	201405	11	0	0	0	8	4	0	0	1273	626	120	893	369	50
19980	Machine_translation	201406	21	5	0	0	12	8	4	0	1294	636	125	904	376	50
19980	Machine_translation	201407	3	1	0	0	3	3	1	0	1297	637	126	907	377	51
19980	Machine_translation	201408	6	0	0	0	6	6	0	0	1303	639	126	913	379	51
19980	Machine_translation	201409	3	0	0	0	3	3	0	0	1306	642	126	916	382	51
19980	Machine_translation	201410	8	1	0	0	7	6	1	0	1314	649	127	923	388	52
19980	Machine_translation	201411	9	0	0	0	7	4	0	0	1323	655	127	927	391	52
19980	Machine_translation	201412	3	1	0	0	3	1	1	0	1326	657	128	928	391	52
19980	Machine_translation	201501	3	0	0	0	3	2	0	0	1329	660	128	930	392	52
19980	Machine_translation	201502	8	1	0	0	4	3	1	0	1337	663	129	937	394	52
19980	Machine_translation	201503	6	0	0	0	4	2	0	0	1343	666	129	940	395	52
19980	Machine_translation	201504	4	0	0	0	3	3	0	0	1347	667	129	944	396	52
19980	Machine_translation	201505	3	0	0	0	3	2	0	0	1350	669	129	946	397	52
19980	Machine_translation	201506	9	3	0	0	6	5	2	0	1359	672	132	954	399	54
19980	Machine_translation	201507	2	0	0	0	2	2	0	0	1361	674	132	956	401	54
19980	Machine_translation	201509	1	0	0	0	1	1	0	0	1362	675	132	957	402	54
19980	Machine_translation	201510	3	0	0	0	1	1	0	0	1365	675	132	960	402	54
19980	Machine_translation	201511	6	2	0	0	3	3	1	0	1371	676	134	966	403	56
19980	Machine_translation	201512	3	1	0	0	3	1	1	0	1374	678	135	967	403	56
19980	Machine_translation	201602	2	0	0	0	2	2	0	0	1376	679	135	969	403	56
19980	Machine_translation	201603	8	1	0	0	4	3	1	0	1384	682	136	972	405	56
19980	Machine_translation	201604	4	0	0	0	4	4	0	0	1388	685	136	976	407	56
19980	Machine_translation	201605	1	0	0	0	1	0	0	0	1389	686	136	976	407	56
19980	Machine_translation	201607	9	2	0	0	6	5	2	0	1398	691	138	984	411	57
19980	Machine_translation	201608	4	2	0	0	3	2	1	0	1402	693	140	987	412	58
19980	Machine_translation	201609	2	1	0	0	2	1	1	0	1404	694	141	988	412	58
19980	Machine_translation	201610	2	1	0	0	2	2	1	0	1406	695	142	990	413	59
19980	Machine_translation	201611	1	0	0	0	1	1	0	0	1407	695	142	991	413	59
19980	Machine_translation	201612	1	0	0	0	1	1	0	0	1408	696	142	992	414	59
19980	Machine_translation	201702	10	2	0	0	9	6	2	0	1418	702	144	998	416	60
19980	Machine_translation	201703	4	1	0	0	4	3	1	0	1422	703	145	1001	417	60
19980	Machine_translation	201704	7	0	0	0	4	3	0	0	1429	706	145	1004	419	60
19980	Machine_translation	201705	7	2	0	0	5	4	2	0	1436	709	147	1008	421	62
19980	Machine_translation	201706	3	1	0	0	3	3	1	0	1439	710	148	1011	422	63
19980	Machine_translation	201707	4	0	0	0	2	2	0	0	1443	712	148	1015	424	63
19980	Machine_translation	201709	8	2	0	0	8	6	2	0	1451	719	150	1021	429	64
19980	Machine_translation	201710	8	3	0	0	6	6	1	0	1459	724	153	1029	434	67
19980	Machine_translation	201711	2	0	0	0	1	0	0	0	1461	724	153	1029	434	67
19980	Machine_translation	201712	5	1	0	0	5	3	1	0	1466	727	154	1032	436	67
19980	Machine_translation	201801	7	0	0	0	7	5	0	0	1473	733	154	1037	440	67
19980	Machine_translation	201802	10	1	0	0	8	7	1	0	1483	739	155	1046	445	67
19980	Machine_translation	201803	1	0	0	0	1	0	0	0	1484	740	155	1046	445	67
19980	Machine_translation	201805	8	0	0	0	5	5	0	0	1492	743	155	1054	448	67
19980	Machine_translation	201806	5	0	0	0	3	3	0	0	1497	746	155	1059	451	67
19980	Machine_translation	201807	2	0	0	0	1	1	0	0	1499	747	155	1061	452	67
28266343	Malvertising	201102	6	0	0	0	2	2	0	0	6	2	0	6	2	0
28266343	Malvertising	201106	1	0	0	0	1	1	0	0	7	3	0	7	3	0
28266343	Malvertising	201107	6	0	0	0	4	2	0	0	13	7	0	9	5	0
28266343	Malvertising	201210	2	0	0	0	1	1	0	0	15	8	0	11	6	0
28266343	Malvertising	201303	1	0	0	0	1	0	0	0	16	9	0	11	6	0
28266343	Malvertising	201304	6	0	0	0	4	3	0	0	22	13	0	16	9	0
28266343	Malvertising	201305	7	0	0	0	6	3	0	0	29	19	0	19	12	0
28266343	Malvertising	201309	1	0	0	0	1	1	0	0	30	20	0	20	13	0
28266343	Malvertising	201401	1	0	0	0	1	0	0	0	31	21	0	20	13	0
28266343	Malvertising	201402	1	0	0	0	1	1	0	0	32	22	0	21	14	0
28266343	Malvertising	201404	1	0	0	0	1	1	0	0	33	23	0	22	15	0
28266343	Malvertising	201407	2	0	0	0	2	2	0	0	35	25	0	24	17	0
28266343	Malvertising	201409	1	0	0	0	1	1	0	0	36	25	0	25	17	0
28266343	Malvertising	201501	2	0	0	0	2	1	0	0	38	26	0	26	17	0
28266343	Malvertising	201502	3	0	0	0	2	0	0	0	41	28	0	26	17	0
28266343	Malvertising	201506	2	0	0	0	1	1	0	0	43	29	0	28	18	0
28266343	Malvertising	201507	7	1	0	0	3	2	1	0	50	32	1	32	20	0
28266343	Malvertising	201508	3	0	0	0	3	2	0	0	53	35	1	34	22	0
28266343	Malvertising	201510	4	1	0	0	3	2	1	0	57	38	2	36	24	1
28266343	Malvertising	201511	11	0	0	0	4	2	0	0	68	42	2	39	26	1
28266343	Malvertising	201512	2	0	0	0	2	1	0	0	70	44	2	40	27	1
28266343	Malvertising	201601	3	0	0	0	3	3	0	0	73	47	2	43	30	1
28266343	Malvertising	201604	3	1	0	0	3	2	1	0	76	50	3	45	32	1
28266343	Malvertising	201608	5	1	0	0	4	3	1	0	81	54	4	49	34	1
28266343	Malvertising	201609	3	0	0	0	2	2	0	0	84	56	4	52	36	1
28266343	Malvertising	201610	1	0	0	0	1	1	0	0	85	57	4	53	37	1
28266343	Malvertising	201611	1	0	0	0	1	1	0	0	86	57	4	54	37	1
28266343	Malvertising	201612	4	0	0	0	4	3	0	0	90	60	4	57	39	1
28266343	Malvertising	201701	2	0	0	0	2	2	0	0	92	62	4	59	41	1
28266343	Malvertising	201702	3	0	0	0	3	3	0	0	95	65	4	62	44	1
28266343	Malvertising	201703	1	0	0	0	1	1	0	0	96	65	4	63	44	1
28266343	Malvertising	201707	3	1	0	0	3	2	1	0	99	68	5	65	44	2
28266343	Malvertising	201709	1	0	0	0	1	1	0	0	100	68	5	66	44	2
28266343	Malvertising	201801	1	0	0	0	1	1	0	0	101	69	5	67	45	2
28266343	Malvertising	201802	5	2	0	0	3	2	1	0	106	71	7	70	46	2
28266343	Malvertising	201805	1	0	0	0	1	1	0	0	107	72	7	71	46	2
28266343	Malvertising	201806	1	0	0	0	1	0	0	0	108	73	7	71	46	2
28266343	Malvertising	201807	1	0	0	0	1	1	0	0	109	74	7	72	47	2
20901	Malware	200202	2	0	0	0	1	1	0	0	2	1	0	2	1	0
20901	Malware	200206	1	0	0	0	1	1	0	0	3	2	0	3	1	0
20901	Malware	200301	1	0	0	0	1	1	0	0	4	3	0	4	2	0
20901	Malware	200311	1	0	0	0	1	1	0	0	5	4	0	5	3	0
20901	Malware	200401	1	0	0	0	1	1	0	0	6	5	0	6	4	0
20901	Malware	200402	2	0	0	0	2	2	0	0	8	7	0	8	6	0
20901	Malware	200403	2	0	0	0	2	2	0	0	10	9	0	10	8	0
20901	Malware	200404	1	0	0	0	1	1	0	0	11	10	0	11	9	0
20901	Malware	200405	1	0	0	0	1	0	0	0	12	11	0	11	9	0
20901	Malware	200406	1	0	0	0	1	0	0	0	13	12	0	11	9	0
20901	Malware	200407	4	0	0	0	3	2	0	0	17	15	0	13	11	0
20901	Malware	200408	5	0	0	0	5	5	0	0	22	20	0	18	16	0
20901	Malware	200409	3	0	0	0	3	2	0	0	25	23	0	20	18	0
20901	Malware	200410	12	1	0	0	8	5	1	0	37	30	1	28	22	0
20901	Malware	200411	10	1	0	0	9	5	1	0	47	38	2	33	26	0
20901	Malware	200412	4	0	0	0	4	4	0	0	51	41	2	37	29	0
20901	Malware	200501	7	2	0	0	6	4	2	0	58	47	4	41	33	0
20901	Malware	200502	7	1	0	0	5	2	1	0	65	52	5	44	35	0
20901	Malware	200503	4	1	0	0	3	2	1	0	69	55	6	46	37	0
20901	Malware	200504	29	1	0	0	16	6	1	0	98	70	7	58	42	0
20901	Malware	200505	19	5	0	0	13	7	4	0	117	82	12	68	48	0
20901	Malware	200506	14	6	0	0	11	5	4	0	131	92	18	75	52	1
20901	Malware	200507	16	1	0	0	12	4	1	0	147	104	19	80	56	1
20901	Malware	200508	13	3	0	0	12	6	3	0	160	115	22	86	61	1
20901	Malware	200509	14	1	0	0	13	7	1	0	174	127	23	93	67	1
20901	Malware	200510	7	1	0	0	6	5	1	0	181	131	24	98	70	2
20901	Malware	200511	40	8	0	0	23	12	5	0	221	152	32	122	80	4
20901	Malware	200512	37	5	0	0	20	10	4	0	258	167	37	145	85	5
20901	Malware	200601	37	6	0	0	23	9	4	0	295	187	43	164	91	6
20901	Malware	200602	34	8	0	0	24	12	4	0	329	207	51	183	99	7
20901	Malware	200603	18	1	0	0	13	7	1	0	347	217	52	192	103	7
20901	Malware	200604	39	12	0	0	22	13	7	0	386	235	64	212	112	10
20901	Malware	200605	14	2	0	0	13	9	2	0	400	245	66	222	118	10
20901	Malware	200606	32	7	0	0	25	15	5	0	432	263	73	242	126	12
20901	Malware	200607	16	7	3	0	12	6	5	1	448	273	80	248	130	15
20901	Malware	200608	16	3	0	0	12	4	2	0	464	284	83	254	133	15
20901	Malware	200609	49	4	0	0	20	11	3	0	513	302	87	289	142	16
20901	Malware	200610	19	2	0	0	13	6	2	0	532	312	89	301	145	16
20901	Malware	200611	27	5	0	0	19	11	5	0	559	329	94	314	154	16
20901	Malware	200612	25	3	0	0	21	16	3	0	584	346	97	333	166	18
20901	Malware	200701	20	4	0	0	14	9	4	0	604	358	101	346	173	18
20901	Malware	200702	30	8	0	0	20	14	6	0	634	374	109	365	183	21
20901	Malware	200703	29	7	0	0	22	15	7	0	663	393	116	384	195	22
20901	Malware	200704	15	1	0	0	14	9	1	0	678	403	117	393	200	22
20901	Malware	200705	8	1	0	0	6	2	1	0	686	408	118	397	201	22
20901	Malware	200706	16	5	0	0	15	11	5	0	702	421	123	408	210	24
20901	Malware	200707	5	2	0	0	5	2	2	0	707	425	125	410	212	24
20901	Malware	200708	13	8	1	0	11	6	6	1	720	434	133	417	216	27
20901	Malware	200709	8	2	0	0	7	4	1	0	728	441	135	422	220	27
20901	Malware	200710	20	3	0	0	14	8	2	0	748	454	138	433	227	27
20901	Malware	200711	33	14	2	1	22	13	11	2	781	471	152	450	235	31
20901	Malware	200712	24	7	0	0	17	7	5	0	805	484	159	463	238	31
20901	Malware	200801	20	7	0	0	13	5	5	0	825	495	166	470	241	31
20901	Malware	200802	21	8	0	0	14	9	6	0	846	506	174	482	247	32
20901	Malware	200803	26	5	0	0	17	12	4	0	872	521	179	496	257	33
20901	Malware	200804	30	7	0	0	23	18	7	0	902	540	186	521	271	36
20901	Malware	200805	33	3	0	0	16	13	3	0	935	554	189	549	282	37
20901	Malware	200806	20	4	0	0	14	6	2	0	955	566	193	560	286	37
20901	Malware	200807	11	3	0	0	11	5	3	0	966	576	196	565	290	37
20901	Malware	200808	21	7	0	0	17	8	6	0	987	591	203	574	296	38
20901	Malware	200809	12	6	0	0	10	3	4	0	999	599	209	579	297	39
20901	Malware	200810	23	6	0	0	20	13	6	0	1022	617	215	594	308	39
20901	Malware	200811	29	9	0	0	23	12	8	0	1051	638	224	610	318	40
20901	Malware	200812	37	10	0	0	25	16	8	0	1088	657	234	635	328	42
20901	Malware	200901	18	5	0	0	16	10	5	0	1106	672	239	646	337	42
20901	Malware	200902	33	14	0	0	26	13	11	0	1139	693	253	662	345	43
20901	Malware	200903	58	15	0	0	31	17	13	0	1197	716	268	698	354	44
20901	Malware	200904	63	41	26	19	34	26	17	7	1260	745	309	738	375	62
20901	Malware	200905	26	8	0	0	18	11	6	0	1286	760	317	754	383	64
20901	Malware	200906	23	7	0	0	15	11	5	0	1309	772	324	770	391	66
20901	Malware	200907	23	9	0	0	18	10	8	0	1332	786	333	782	397	67
20901	Malware	200908	19	2	0	0	14	12	1	0	1351	799	335	799	408	68
20901	Malware	200909	30	8	2	1	20	12	5	2	1381	816	343	819	417	70
20901	Malware	200910	55	20	0	0	32	20	14	0	1436	841	363	852	430	73
20901	Malware	200911	25	11	0	0	18	13	10	0	1461	854	374	867	438	78
20901	Malware	200912	23	7	0	0	19	11	5	0	1484	867	381	881	443	79
20901	Malware	201001	33	10	0	0	23	18	7	0	1517	883	391	902	454	81
20901	Malware	201002	26	8	0	0	21	10	8	0	1543	898	399	915	458	81
20901	Malware	201003	15	4	0	0	12	7	3	0	1558	907	403	925	462	83
20901	Malware	201004	47	19	1	0	33	17	12	1	1605	932	422	952	471	86
20901	Malware	201005	13	3	0	0	7	3	3	0	1618	936	425	956	471	86
20901	Malware	201006	24	4	0	0	17	11	4	0	1642	949	429	970	479	87
20901	Malware	201007	23	9	0	0	18	11	8	0	1665	962	438	983	485	89
20901	Malware	201008	19	7	0	0	17	12	6	0	1684	975	445	997	493	92
20901	Malware	201009	17	2	0	0	15	6	2	0	1701	988	447	1004	497	92
20901	Malware	201010	39	16	0	0	30	18	13	0	1740	1015	463	1025	512	94
20901	Malware	201011	31	11	0	0	22	12	8	0	1771	1032	474	1040	519	95
20901	Malware	201012	37	7	0	0	23	10	6	0	1808	1049	481	1058	523	96
20901	Malware	201101	23	6	0	0	16	9	4	0	1831	1063	487	1071	530	96
20901	Malware	201102	34	13	2	1	21	12	9	2	1865	1079	500	1089	537	97
20901	Malware	201103	30	12	0	0	21	10	7	0	1895	1097	512	1107	544	100
20901	Malware	201104	21	9	0	0	17	7	6	0	1916	1111	521	1117	548	101
20901	Malware	201105	28	8	0	0	21	11	6	0	1944	1127	529	1131	554	101
20901	Malware	201106	34	4	0	0	16	11	4	0	1978	1136	533	1154	558	101
20901	Malware	201107	16	6	0	0	15	8	5	0	1994	1146	539	1163	561	103
20901	Malware	201108	13	7	2	1	7	3	3	2	2007	1151	546	1170	562	104
20901	Malware	201109	15	5	0	0	14	9	5	0	2022	1162	551	1180	568	104
20901	Malware	201110	6	1	0	0	5	3	1	0	2028	1164	552	1183	568	104
20901	Malware	201111	15	4	0	0	10	6	3	0	2043	1171	556	1192	571	104
20901	Malware	201112	23	6	0	0	16	6	5	0	2066	1183	562	1199	573	104
20901	Malware	201201	21	5	0	0	16	9	4	0	2087	1195	567	1212	578	104
20901	Malware	201202	39	9	0	0	25	15	5	0	2126	1214	576	1238	587	106
20901	Malware	201203	42	11	0	0	25	14	7	0	2168	1233	587	1264	596	108
20901	Malware	201204	14	3	0	0	12	9	3	0	2182	1241	590	1275	601	109
20901	Malware	201205	26	8	0	0	16	9	6	0	2208	1255	598	1288	608	111
20901	Malware	201206	30	7	0	0	22	14	6	0	2238	1273	605	1307	618	112
20901	Malware	201207	35	4	0	0	14	9	2	0	2273	1282	609	1334	622	113
20901	Malware	201208	22	5	0	0	18	10	5	0	2295	1295	614	1348	627	114
20901	Malware	201209	15	3	0	0	13	7	3	0	2310	1303	617	1356	629	114
20901	Malware	201210	9	3	0	0	9	5	3	0	2319	1307	620	1361	629	114
20901	Malware	201211	18	7	0	0	15	8	5	0	2337	1316	627	1371	631	114
20901	Malware	201212	28	8	0	0	17	8	6	0	2365	1330	635	1387	636	116
20901	Malware	201301	16	2	0	0	11	10	2	0	2381	1337	637	1402	642	117
20901	Malware	201302	84	7	0	0	18	10	3	0	2465	1351	644	1477	648	117
20901	Malware	201303	35	9	0	0	23	15	7	0	2500	1371	653	1499	659	118
20901	Malware	201304	22	6	0	0	18	13	4	0	2522	1384	659	1516	667	121
20901	Malware	201305	52	16	1	0	21	11	6	1	2574	1401	675	1546	674	122
20901	Malware	201306	8	2	0	0	7	4	2	0	2582	1406	677	1550	676	122
20901	Malware	201307	17	5	0	0	16	12	5	0	2599	1417	682	1563	683	126
20901	Malware	201308	15	4	0	0	13	8	4	0	2614	1427	686	1572	688	127
20901	Malware	201309	14	0	0	0	4	3	0	0	2628	1431	686	1584	691	127
20901	Malware	201310	27	11	0	0	21	10	8	0	2655	1448	697	1597	697	128
20901	Malware	201311	13	5	0	0	10	4	4	0	2668	1456	702	1602	699	128
20901	Malware	201312	25	6	0	0	15	7	3	0	2693	1467	708	1618	702	129
20901	Malware	201401	19	7	0	0	15	9	7	0	2712	1480	715	1627	709	129
20901	Malware	201402	21	6	0	0	16	11	5	0	2733	1490	721	1641	714	131
20901	Malware	201403	24	8	0	0	15	10	5	0	2757	1499	729	1657	718	134
20901	Malware	201404	16	5	0	0	14	7	4	0	2773	1508	734	1666	720	134
20901	Malware	201405	15	6	0	0	11	7	5	0	2788	1516	740	1674	724	135
20901	Malware	201406	5	1	0	0	5	3	1	0	2793	1520	741	1677	726	135
20901	Malware	201407	38	2	0	0	10	7	2	0	2831	1525	743	1709	729	136
20901	Malware	201408	28	10	1	0	16	11	9	1	2859	1536	753	1724	735	138
20901	Malware	201409	3	0	0	0	3	3	0	0	2862	1539	753	1727	738	138
20901	Malware	201410	27	6	0	0	17	10	4	0	2889	1552	759	1739	744	139
20901	Malware	201411	11	5	0	0	8	4	3	0	2900	1558	764	1746	746	141
20901	Malware	201412	31	9	0	0	16	11	8	0	2931	1570	773	1768	753	142
20901	Malware	201501	18	3	0	0	11	4	2	0	2949	1578	776	1777	754	142
20901	Malware	201502	21	11	1	0	16	9	9	1	2970	1591	787	1788	760	144
20901	Malware	201503	30	6	0	0	20	14	5	0	3000	1607	793	1804	770	146
20901	Malware	201504	17	5	0	0	11	4	2	0	3017	1617	798	1811	773	146
20901	Malware	201505	18	5	0	0	13	9	4	0	3035	1626	803	1824	777	148
20901	Malware	201506	21	7	0	0	17	13	6	0	3056	1640	810	1839	787	151
20901	Malware	201507	26	7	0	0	21	15	6	0	3082	1656	817	1857	795	154
20901	Malware	201508	27	8	0	0	16	8	7	0	3109	1667	825	1866	798	154
20901	Malware	201509	25	12	1	0	17	9	9	1	3134	1679	837	1879	802	157
20901	Malware	201510	5	2	0	0	5	3	2	0	3139	1682	839	1882	803	158
20901	Malware	201511	35	11	0	0	22	14	8	0	3174	1698	850	1901	811	160
20901	Malware	201512	15	5	0	0	11	7	4	0	3189	1705	855	1911	814	161
20901	Malware	201601	8	2	0	0	7	5	2	0	3197	1709	857	1917	816	161
20901	Malware	201602	11	3	0	0	9	6	3	0	3208	1712	860	1925	816	162
20901	Malware	201603	19	7	0	0	13	8	4	0	3227	1721	867	1937	820	163
20901	Malware	201604	3	0	0	0	3	3	0	0	3230	1723	867	1940	822	163
20901	Malware	201605	18	3	0	0	12	11	3	0	3248	1730	870	1956	828	165
20901	Malware	201606	7	2	0	0	7	6	2	0	3255	1733	872	1962	829	166
20901	Malware	201607	7	3	0	0	6	4	2	0	3262	1737	875	1967	831	167
20901	Malware	201608	14	4	0	0	13	6	4	0	3276	1747	879	1973	834	168
20901	Malware	201609	8	3	0	0	8	7	3	0	3284	1752	882	1980	837	170
20901	Malware	201610	11	2	0	0	6	4	2	0	3295	1756	884	1984	838	172
20901	Malware	201611	28	12	0	0	17	11	7	0	3323	1769	896	2003	845	176
20901	Malware	201612	13	4	0	0	11	6	4	0	3336	1776	900	2010	847	176
20901	Malware	201701	18	7	0	0	12	8	6	0	3354	1785	907	2019	852	176
20901	Malware	201702	10	5	0	0	9	6	5	0	3364	1791	912	2026	854	178
20901	Malware	201703	14	3	0	0	9	7	3	0	3378	1797	915	2037	858	178
20901	Malware	201704	7	3	0	0	7	6	3	0	3385	1802	918	2043	862	180
20901	Malware	201705	6	1	0	0	6	6	1	0	3391	1806	919	2049	866	181
20901	Malware	201706	53	20	4	1	28	20	13	3	3444	1825	939	2089	876	190
20901	Malware	201707	18	6	0	0	15	14	5	0	3462	1835	945	2106	885	195
20901	Malware	201708	8	4	0	0	7	5	3	0	3470	1839	949	2112	885	197
20901	Malware	201709	15	5	0	0	9	7	3	0	3485	1847	954	2123	891	201
20901	Malware	201710	19	7	0	0	13	9	4	0	3504	1857	961	2135	897	203
20901	Malware	201711	14	4	0	0	9	6	2	0	3518	1864	965	2144	901	204
20901	Malware	201712	10	3	0	0	7	6	2	0	3528	1869	968	2152	905	206
20901	Malware	201801	4	1	0	0	3	3	1	0	3532	1872	969	2156	907	207
20901	Malware	201802	9	3	0	0	8	6	3	0	3541	1877	972	2162	910	209
20901	Malware	201803	7	3	0	0	5	3	2	0	3548	1881	975	2166	912	209
20901	Malware	201804	14	3	0	0	9	7	2	0	3562	1888	978	2178	915	210
20901	Malware	201805	6	3	0	0	6	5	3	0	3568	1892	981	2183	917	212
20901	Malware	201806	17	4	0	0	10	7	3	0	3585	1899	985	2197	920	214
20901	Malware	201807	14	4	0	0	12	7	4	0	3599	1908	989	2205	923	214
24960699	MariaDB	200912	4	0	0	0	1	1	0	0	4	1	0	4	1	0
24960699	MariaDB	201001	2	0	0	0	2	2	0	0	6	3	0	6	3	0
24960699	MariaDB	201002	4	0	0	0	4	2	0	0	10	7	0	8	5	0
24960699	MariaDB	201003	2	0	0	0	2	0	0	0	12	9	0	8	5	0
24960699	MariaDB	201004	1	0	0	0	1	1	0	0	13	10	0	9	6	0
24960699	MariaDB	201005	3	0	0	0	3	3	0	0	16	13	0	12	9	0
24960699	MariaDB	201006	3	0	0	0	2	1	0	0	19	15	0	13	10	0
24960699	MariaDB	201007	1	0	0	0	1	1	0	0	20	16	0	14	11	0
24960699	MariaDB	201008	2	0	0	0	2	1	0	0	22	18	0	15	12	0
24960699	MariaDB	201009	5	0	0	0	2	2	0	0	27	20	0	20	14	0
24960699	MariaDB	201010	4	0	0	0	4	3	0	0	31	24	0	23	17	0
24960699	MariaDB	201011	1	0	0	0	1	1	0	0	32	24	0	24	17	0
24960699	MariaDB	201012	3	0	0	0	3	3	0	0	35	27	0	27	20	0
24960699	MariaDB	201101	3	0	0	0	1	1	0	0	38	27	0	30	20	0
24960699	MariaDB	201102	1	0	0	0	1	1	0	0	39	28	0	31	21	0
24960699	MariaDB	201105	1	0	0	0	1	1	0	0	40	28	0	32	21	0
24960699	MariaDB	201106	3	1	0	0	3	2	1	0	43	30	1	34	22	0
24960699	MariaDB	201108	5	0	0	0	3	1	0	0	48	33	1	35	23	0
24960699	MariaDB	201109	3	0	0	0	2	2	0	0	51	35	1	38	25	0
24960699	MariaDB	201110	5	0	0	0	4	2	0	0	56	38	1	41	26	0
24960699	MariaDB	201201	1	0	0	0	1	1	0	0	57	39	1	42	27	0
24960699	MariaDB	201202	5	0	0	0	5	4	0	0	62	44	1	46	31	0
24960699	MariaDB	201203	1	0	0	0	1	1	0	0	63	45	1	47	32	0
24960699	MariaDB	201204	4	0	0	0	3	2	0	0	67	48	1	50	34	0
24960699	MariaDB	201205	1	0	0	0	1	1	0	0	68	48	1	51	34	0
24960699	MariaDB	201206	4	0	0	0	4	3	0	0	72	52	1	54	37	0
24960699	MariaDB	201208	5	2	0	0	5	3	2	0	77	56	3	57	39	0
24960699	MariaDB	201209	10	2	0	0	9	5	2	0	87	63	5	62	42	0
24960699	MariaDB	201210	1	0	0	0	1	1	0	0	88	64	5	63	43	0
24960699	MariaDB	201211	10	0	0	0	5	4	0	0	98	69	5	72	47	0
24960699	MariaDB	201212	6	0	0	0	6	4	0	0	104	74	5	76	50	0
24960699	MariaDB	201301	16	1	0	0	11	11	1	0	120	85	6	92	61	1
24960699	MariaDB	201302	12	0	0	0	12	9	0	0	132	96	6	101	69	1
24960699	MariaDB	201303	15	1	0	0	11	6	1	0	147	105	7	109	73	1
24960699	MariaDB	201304	9	0	0	0	8	5	0	0	156	112	7	115	77	1
24960699	MariaDB	201305	22	0	0	0	13	8	0	0	178	123	7	131	83	1
24960699	MariaDB	201306	9	1	0	0	7	4	1	0	187	129	8	135	86	1
24960699	MariaDB	201307	12	0	0	0	8	6	0	0	199	136	8	145	91	1
24960699	MariaDB	201308	12	0	0	0	6	4	0	0	211	140	8	155	93	1
24960699	MariaDB	201309	3	0	0	0	3	1	0	0	214	143	8	156	94	1
24960699	MariaDB	201310	12	1	0	0	7	6	1	0	226	149	9	167	99	2
24960699	MariaDB	201311	10	0	0	0	5	2	0	0	236	153	9	171	100	2
24960699	MariaDB	201312	7	0	0	0	6	3	0	0	243	157	9	175	101	2
24960699	MariaDB	201401	6	1	0	0	4	2	1	0	249	161	10	179	103	2
24960699	MariaDB	201402	5	0	0	0	5	4	0	0	254	165	10	183	106	2
24960699	MariaDB	201403	1	0	0	0	1	0	0	0	255	166	10	183	106	2
24960699	MariaDB	201404	1	0	0	0	1	1	0	0	256	167	10	184	107	2
24960699	MariaDB	201405	9	0	0	0	8	6	0	0	265	172	10	190	110	2
24960699	MariaDB	201406	4	0	0	0	1	1	0	0	269	173	10	194	111	2
24960699	MariaDB	201407	2	0	0	0	2	1	0	0	271	175	10	195	112	2
24960699	MariaDB	201408	7	0	0	0	4	2	0	0	278	178	10	197	113	2
24960699	MariaDB	201409	7	1	0	0	7	6	1	0	285	182	11	203	116	3
24960699	MariaDB	201410	12	0	0	0	7	5	0	0	297	186	11	213	118	3
24960699	MariaDB	201411	13	1	0	0	9	3	1	0	310	192	12	217	119	3
24960699	MariaDB	201412	6	1	0	0	5	3	1	0	316	196	13	221	121	3
24960699	MariaDB	201502	3	1	0	0	3	2	1	0	319	197	14	223	121	3
24960699	MariaDB	201503	3	0	0	0	3	3	0	0	322	199	14	226	123	3
24960699	MariaDB	201504	3	0	0	0	3	2	0	0	325	202	14	228	125	3
24960699	MariaDB	201505	3	0	0	0	1	1	0	0	328	202	14	231	125	3
24960699	MariaDB	201506	2	0	0	0	1	0	0	0	330	203	14	231	125	3
24960699	MariaDB	201507	1	1	0	0	1	1	1	0	331	203	15	232	125	3
24960699	MariaDB	201508	4	0	0	0	2	1	0	0	335	205	15	233	126	3
24960699	MariaDB	201509	1	0	0	0	1	0	0	0	336	206	15	233	126	3
24960699	MariaDB	201510	3	0	0	0	3	2	0	0	339	209	15	235	128	3
24960699	MariaDB	201511	3	0	0	0	2	2	0	0	342	210	15	238	129	3
24960699	MariaDB	201512	8	2	0	0	7	5	2	0	350	214	17	244	131	3
24960699	MariaDB	201601	7	0	0	0	3	2	0	0	357	216	17	250	132	3
24960699	MariaDB	201602	4	0	0	0	4	2	0	0	361	219	17	252	133	3
24960699	MariaDB	201603	6	0	0	0	3	3	0	0	367	221	17	258	135	3
24960699	MariaDB	201604	1	0	0	0	1	1	0	0	368	222	17	259	136	3
24960699	MariaDB	201605	4	0	0	0	3	2	0	0	372	224	17	262	136	3
24960699	MariaDB	201606	4	0	0	0	3	3	0	0	376	226	17	266	138	3
24960699	MariaDB	201607	4	0	0	0	2	2	0	0	380	227	17	270	139	3
24960699	MariaDB	201608	6	0	0	0	4	4	0	0	386	229	17	276	141	3
24960699	MariaDB	201609	5	0	0	0	3	3	0	0	391	231	17	281	143	3
24960699	MariaDB	201610	5	1	0	0	4	3	1	0	396	234	18	285	145	3
24960699	MariaDB	201611	15	0	0	0	7	5	0	0	411	239	18	298	147	3
24960699	MariaDB	201612	3	1	0	0	3	2	1	0	414	241	19	300	148	3
24960699	MariaDB	201701	4	0	0	0	3	3	0	0	418	242	19	304	149	3
24960699	MariaDB	201702	7	0	0	0	5	5	0	0	425	245	19	311	151	3
24960699	MariaDB	201703	9	2	0	0	4	4	1	0	434	248	21	320	154	5
24960699	MariaDB	201704	6	0	0	0	5	3	0	0	440	251	21	324	155	5
24960699	MariaDB	201705	4	1	0	0	3	2	1	0	444	252	22	327	155	5
24960699	MariaDB	201706	7	0	0	0	2	2	0	0	451	253	22	334	156	5
24960699	MariaDB	201707	2	0	0	0	2	1	0	0	453	255	22	335	157	5
24960699	MariaDB	201708	4	0	0	0	3	2	0	0	457	257	22	338	158	5
24960699	MariaDB	201709	3	0	0	0	1	1	0	0	460	257	22	341	158	5
24960699	MariaDB	201710	7	0	0	0	6	5	0	0	467	261	22	346	161	5
24960699	MariaDB	201711	7	2	0	0	5	2	1	0	474	264	24	349	162	5
24960699	MariaDB	201712	3	0	0	0	2	2	0	0	477	265	24	352	163	5
24960699	MariaDB	201801	2	0	0	0	2	2	0	0	479	266	24	354	164	5
24960699	MariaDB	201802	7	0	0	0	5	4	0	0	486	269	24	360	166	5
24960699	MariaDB	201803	3	0	0	0	2	1	0	0	489	270	24	362	166	5
24960699	MariaDB	201804	1	0	0	0	1	1	0	0	490	270	24	363	166	5
24960699	MariaDB	201805	6	0	0	0	4	3	0	0	496	272	24	367	167	5
24960699	MariaDB	201806	5	0	0	0	2	2	0	0	501	272	24	372	167	5
24960699	MariaDB	201807	17	1	0	0	4	3	1	0	518	274	25	388	168	5
331195	Mass_surveillance	200407	1	0	0	0	1	0	0	0	1	1	0	0	0	0
331195	Mass_surveillance	200408	1	0	0	0	1	0	0	0	2	2	0	0	0	0
331195	Mass_surveillance	200409	9	0	0	0	5	4	0	0	11	7	0	4	4	0
331195	Mass_surveillance	200410	1	0	0	0	1	0	0	0	12	8	0	4	4	0
331195	Mass_surveillance	200411	2	0	0	0	2	2	0	0	14	10	0	6	6	0
331195	Mass_surveillance	200501	3	0	0	0	3	2	0	0	17	13	0	8	8	0
331195	Mass_surveillance	200502	1	0	0	0	1	0	0	0	18	14	0	8	8	0
331195	Mass_surveillance	200503	21	1	0	0	8	4	1	0	39	22	1	13	12	0
331195	Mass_surveillance	200504	1	0	0	0	1	0	0	0	40	23	1	13	12	0
331195	Mass_surveillance	200505	6	1	0	0	5	3	1	0	46	28	2	16	15	0
331195	Mass_surveillance	200506	10	0	0	0	7	4	0	0	56	35	2	23	19	0
331195	Mass_surveillance	200508	2	0	0	0	2	1	0	0	58	37	2	24	20	0
331195	Mass_surveillance	200509	8	0	0	0	4	2	0	0	66	41	2	26	22	0
331195	Mass_surveillance	200510	3	0	0	0	3	1	0	0	69	44	2	27	23	0
331195	Mass_surveillance	200512	5	1	0	0	4	1	1	0	74	47	3	28	23	0
331195	Mass_surveillance	200601	6	0	0	0	6	4	0	0	80	53	3	32	27	0
331195	Mass_surveillance	200602	6	0	0	0	4	2	0	0	86	57	3	34	29	0
331195	Mass_surveillance	200603	8	0	0	0	4	3	0	0	94	60	3	37	31	0
331195	Mass_surveillance	200604	18	0	0	0	11	5	0	0	112	70	3	42	35	0
331195	Mass_surveillance	200605	8	0	0	0	6	4	0	0	120	76	3	47	39	0
331195	Mass_surveillance	200606	10	0	0	0	6	3	0	0	130	82	3	54	42	0
331195	Mass_surveillance	200607	11	1	0	0	6	4	1	0	141	87	4	61	45	1
331195	Mass_surveillance	200608	7	0	0	0	7	4	0	0	148	93	4	65	48	1
331195	Mass_surveillance	200609	13	1	0	0	10	7	1	0	161	102	5	75	54	2
331195	Mass_surveillance	200610	2	0	0	0	2	1	0	0	163	104	5	76	55	2
331195	Mass_surveillance	200611	8	0	0	0	6	3	0	0	171	110	5	80	58	2
331195	Mass_surveillance	200612	6	0	0	0	5	4	0	0	177	114	5	85	61	2
331195	Mass_surveillance	200701	1	0	0	0	1	0	0	0	178	115	5	85	61	2
331195	Mass_surveillance	200702	12	1	0	0	9	5	1	0	190	124	6	91	66	2
331195	Mass_surveillance	200703	5	1	0	0	5	4	1	0	195	127	7	95	68	2
331195	Mass_surveillance	200704	9	1	0	0	8	6	1	0	204	135	8	102	74	2
331195	Mass_surveillance	200705	17	1	0	0	8	5	1	0	221	142	9	108	78	2
331195	Mass_surveillance	200706	6	0	0	0	6	4	0	0	227	148	9	112	82	2
331195	Mass_surveillance	200707	2	0	0	0	2	2	0	0	229	150	9	114	84	2
331195	Mass_surveillance	200708	11	2	0	0	6	2	2	0	240	156	11	116	86	2
331195	Mass_surveillance	200709	9	0	0	0	4	4	0	0	249	160	11	125	90	2
331195	Mass_surveillance	200710	14	0	0	0	5	3	0	0	263	165	11	137	93	2
331195	Mass_surveillance	200711	7	1	0	0	5	3	1	0	270	169	12	141	95	2
331195	Mass_surveillance	200712	1	0	0	0	1	0	0	0	271	169	12	141	95	2
331195	Mass_surveillance	200801	6	0	0	0	4	1	0	0	277	172	12	142	96	2
331195	Mass_surveillance	200802	8	0	0	0	5	5	0	0	285	175	12	150	99	2
331195	Mass_surveillance	200803	7	1	0	0	5	1	1	0	292	180	13	151	100	2
331195	Mass_surveillance	200804	4	0	0	0	4	1	0	0	296	184	13	152	101	2
331195	Mass_surveillance	200805	4	1	0	0	4	4	1	0	300	188	14	156	105	3
331195	Mass_surveillance	200806	5	1	0	0	5	3	1	0	305	192	15	159	107	3
331195	Mass_surveillance	200807	6	0	0	0	4	3	0	0	311	196	15	164	110	3
331195	Mass_surveillance	200808	9	0	0	0	5	2	0	0	320	201	15	167	112	3
331195	Mass_surveillance	200809	11	1	0	0	7	3	1	0	331	207	16	170	114	3
331195	Mass_surveillance	200810	5	0	0	0	4	3	0	0	336	210	16	174	116	3
331195	Mass_surveillance	200811	8	0	0	0	3	2	0	0	344	213	16	181	118	3
331195	Mass_surveillance	200812	12	0	0	0	6	3	0	0	356	218	16	186	120	3
331195	Mass_surveillance	200901	16	3	0	0	11	7	2	0	372	227	19	197	125	3
331195	Mass_surveillance	200902	6	0	0	0	5	4	0	0	378	232	19	202	129	3
331195	Mass_surveillance	200903	9	0	0	0	5	3	0	0	387	236	19	206	131	3
331195	Mass_surveillance	200904	29	0	0	0	8	7	0	0	416	242	19	234	136	3
331195	Mass_surveillance	200905	15	0	0	0	7	7	0	0	431	249	19	249	143	3
331195	Mass_surveillance	200906	2	0	0	0	2	1	0	0	433	250	19	250	143	3
331195	Mass_surveillance	200907	4	0	0	0	4	3	0	0	437	254	19	253	146	3
331195	Mass_surveillance	200908	4	0	0	0	4	1	0	0	441	257	19	254	147	3
331195	Mass_surveillance	200909	5	2	0	0	4	2	2	0	446	261	21	256	149	3
331195	Mass_surveillance	200910	8	0	0	0	3	2	0	0	454	264	21	262	151	3
331195	Mass_surveillance	200911	9	1	0	0	8	5	1	0	463	270	22	267	154	3
331195	Mass_surveillance	200912	3	0	0	0	2	1	0	0	466	271	22	269	154	3
331195	Mass_surveillance	201001	11	0	0	0	5	3	0	0	477	275	22	278	156	3
331195	Mass_surveillance	201002	23	0	0	0	13	5	0	0	500	284	22	283	157	3
331195	Mass_surveillance	201003	9	0	0	0	4	1	0	0	509	286	22	285	157	3
331195	Mass_surveillance	201004	11	1	0	0	6	4	1	0	520	292	23	289	161	3
331195	Mass_surveillance	201005	10	0	0	0	7	4	0	0	530	297	23	293	163	3
331195	Mass_surveillance	201006	5	0	0	0	5	4	0	0	535	301	23	297	166	3
331195	Mass_surveillance	201007	4	0	0	0	3	1	0	0	539	303	23	299	166	3
331195	Mass_surveillance	201008	5	0	0	0	4	3	0	0	544	306	23	302	168	3
331195	Mass_surveillance	201009	5	0	0	0	3	2	0	0	549	308	23	305	169	3
331195	Mass_surveillance	201010	8	0	0	0	5	3	0	0	557	311	23	308	170	3
331195	Mass_surveillance	201011	12	2	0	0	5	3	2	0	569	316	25	313	173	3
331195	Mass_surveillance	201012	9	4	0	0	7	4	4	0	578	321	29	317	176	3
331195	Mass_surveillance	201101	4	0	0	0	3	3	0	0	582	322	29	321	177	3
331195	Mass_surveillance	201102	4	0	0	0	4	3	0	0	586	324	29	324	178	3
331195	Mass_surveillance	201103	1	0	0	0	1	0	0	0	587	325	29	324	178	3
331195	Mass_surveillance	201104	4	0	0	0	2	1	0	0	591	327	29	325	179	3
331195	Mass_surveillance	201105	2	0	0	0	2	0	0	0	593	329	29	325	179	3
331195	Mass_surveillance	201106	3	0	0	0	3	2	0	0	596	332	29	327	181	3
331195	Mass_surveillance	201107	3	0	0	0	3	3	0	0	599	335	29	330	184	3
331195	Mass_surveillance	201108	5	0	0	0	4	4	0	0	604	338	29	335	187	3
331195	Mass_surveillance	201109	5	0	0	0	3	3	0	0	609	341	29	340	190	3
331195	Mass_surveillance	201110	2	1	0	0	2	1	1	0	611	343	30	341	191	3
331195	Mass_surveillance	201111	9	0	0	0	6	5	0	0	620	347	30	347	194	3
331195	Mass_surveillance	201112	3	0	0	0	3	3	0	0	623	350	30	350	197	3
331195	Mass_surveillance	201201	7	0	0	0	5	2	0	0	630	355	30	352	199	3
331195	Mass_surveillance	201202	1	0	0	0	1	1	0	0	631	356	30	353	200	3
331195	Mass_surveillance	201203	7	0	0	0	6	4	0	0	638	361	30	358	203	3
331195	Mass_surveillance	201204	3	0	0	0	2	1	0	0	641	363	30	359	204	3
331195	Mass_surveillance	201205	4	1	0	0	4	2	1	0	645	367	31	361	206	4
331195	Mass_surveillance	201206	1	0	0	0	1	0	0	0	646	368	31	361	206	4
331195	Mass_surveillance	201207	13	0	0	0	5	3	0	0	659	372	31	369	208	4
331195	Mass_surveillance	201208	8	0	0	0	2	2	0	0	667	374	31	377	210	4
331195	Mass_surveillance	201209	1	0	0	0	1	1	0	0	668	374	31	378	210	4
331195	Mass_surveillance	201210	2	0	0	0	2	1	0	0	670	376	31	379	211	4
331195	Mass_surveillance	201211	6	0	0	0	4	2	0	0	676	380	31	381	213	4
331195	Mass_surveillance	201212	3	0	0	0	3	3	0	0	679	383	31	384	216	4
331195	Mass_surveillance	201301	2	0	0	0	2	1	0	0	681	384	31	385	216	4
331195	Mass_surveillance	201302	1	0	0	0	1	0	0	0	682	385	31	385	216	4
331195	Mass_surveillance	201303	5	1	0	0	4	2	1	0	687	389	32	387	218	4
331195	Mass_surveillance	201304	4	0	0	0	4	3	0	0	691	393	32	390	221	4
331195	Mass_surveillance	201305	1	0	0	0	1	1	0	0	692	394	32	391	222	4
331195	Mass_surveillance	201306	6	0	0	0	5	3	0	0	698	398	32	394	224	4
331195	Mass_surveillance	201307	20	0	0	0	15	8	0	0	718	412	32	405	231	4
331195	Mass_surveillance	201308	17	2	0	0	11	7	1	0	735	420	34	418	235	5
331195	Mass_surveillance	201309	7	0	0	0	4	4	0	0	742	423	34	425	238	5
331195	Mass_surveillance	201310	42	0	0	0	8	7	0	0	784	430	34	466	244	5
331195	Mass_surveillance	201311	10	1	0	0	5	4	1	0	794	434	35	475	247	5
331195	Mass_surveillance	201312	4	0	0	0	4	4	0	0	798	437	35	479	250	5
331195	Mass_surveillance	201401	16	1	0	0	9	9	1	0	814	444	36	495	257	6
331195	Mass_surveillance	201402	9	0	0	0	6	6	0	0	823	449	36	504	262	6
331195	Mass_surveillance	201403	5	1	0	0	4	3	1	0	828	452	37	508	264	6
331195	Mass_surveillance	201404	9	2	0	0	6	4	2	0	837	458	39	513	268	6
331195	Mass_surveillance	201405	7	1	0	0	6	3	1	0	844	463	40	516	270	6
331195	Mass_surveillance	201406	10	2	0	0	6	5	2	0	854	467	42	525	273	7
331195	Mass_surveillance	201407	2	0	0	0	1	1	0	0	856	467	42	527	273	7
331195	Mass_surveillance	201408	2	0	0	0	1	1	0	0	858	467	42	529	273	7
331195	Mass_surveillance	201409	1	0	0	0	1	1	0	0	859	467	42	530	273	7
331195	Mass_surveillance	201410	14	1	0	0	5	4	1	0	873	470	43	543	275	7
331195	Mass_surveillance	201411	15	2	0	0	10	5	2	0	888	478	45	549	278	7
331195	Mass_surveillance	201412	7	2	0	0	6	4	2	0	895	483	47	554	281	9
331195	Mass_surveillance	201501	3	0	0	0	2	1	0	0	898	484	47	556	281	9
331195	Mass_surveillance	201502	5	0	0	0	5	4	0	0	903	487	47	560	283	9
331195	Mass_surveillance	201503	13	0	0	0	3	3	0	0	916	488	47	573	284	9
331195	Mass_surveillance	201505	1	0	0	0	1	1	0	0	917	489	47	574	285	9
331195	Mass_surveillance	201506	21	1	0	0	9	8	1	0	938	495	48	594	290	9
331195	Mass_surveillance	201507	2	0	0	0	2	2	0	0	940	497	48	596	292	9
331195	Mass_surveillance	201508	2	0	0	0	2	2	0	0	942	499	48	598	294	9
331195	Mass_surveillance	201509	1	0	0	0	1	1	0	0	943	499	48	599	294	9
331195	Mass_surveillance	201510	2	1	0	0	2	1	1	0	945	500	49	600	294	9
331195	Mass_surveillance	201511	3	0	0	0	3	2	0	0	948	502	49	602	295	9
331195	Mass_surveillance	201512	6	0	0	0	3	3	0	0	954	504	49	608	297	9
331195	Mass_surveillance	201601	2	0	0	0	2	1	0	0	956	506	49	609	298	9
331195	Mass_surveillance	201602	7	0	0	0	5	4	0	0	963	510	49	613	301	9
331195	Mass_surveillance	201603	2	0	0	0	1	1	0	0	965	510	49	615	301	9
331195	Mass_surveillance	201604	2	0	0	0	2	2	0	0	967	511	49	617	302	9
331195	Mass_surveillance	201605	3	0	0	0	3	3	0	0	970	513	49	620	304	9
331195	Mass_surveillance	201606	3	1	0	0	3	2	1	0	973	514	50	622	304	9
331195	Mass_surveillance	201607	2	0	0	0	2	2	0	0	975	515	50	624	305	9
331195	Mass_surveillance	201608	7	0	0	0	4	3	0	0	982	517	50	630	306	9
331195	Mass_surveillance	201609	3	0	0	0	3	2	0	0	985	520	50	632	308	9
331195	Mass_surveillance	201610	6	1	0	0	3	2	1	0	991	523	51	637	310	9
331195	Mass_surveillance	201611	1	0	0	0	1	1	0	0	992	523	51	638	310	9
331195	Mass_surveillance	201612	8	1	0	0	6	4	1	0	1000	528	52	644	313	9
331195	Mass_surveillance	201701	8	2	0	0	6	5	2	0	1008	532	54	650	316	9
331195	Mass_surveillance	201702	3	0	0	0	1	1	0	0	1011	533	54	653	317	9
331195	Mass_surveillance	201703	5	0	0	0	5	5	0	0	1016	535	54	658	319	9
331195	Mass_surveillance	201704	2	0	0	0	2	2	0	0	1018	536	54	660	320	9
331195	Mass_surveillance	201705	3	1	0	0	3	3	1	0	1021	539	55	663	322	10
331195	Mass_surveillance	201706	1	0	0	0	1	1	0	0	1022	540	55	664	323	10
331195	Mass_surveillance	201707	3	0	0	0	3	3	0	0	1025	542	55	667	325	10
331195	Mass_surveillance	201708	5	0	0	0	4	3	0	0	1030	545	55	671	327	10
331195	Mass_surveillance	201709	3	0	0	0	3	2	0	0	1033	548	55	673	329	10
331195	Mass_surveillance	201801	2	0	0	0	2	2	0	0	1035	549	55	675	330	10
331195	Mass_surveillance	201802	4	0	0	0	2	1	0	0	1039	550	55	676	330	10
331195	Mass_surveillance	201803	4	0	0	0	3	2	0	0	1043	553	55	679	332	10
331195	Mass_surveillance	201804	11	2	0	0	10	7	2	0	1054	561	57	687	337	10
331195	Mass_surveillance	201805	17	0	0	0	9	7	0	0	1071	567	57	702	341	10
331195	Mass_surveillance	201806	2	0	0	0	2	2	0	0	1073	569	57	704	342	10
331195	Mass_surveillance	201807	6	0	0	0	6	5	0	0	1079	574	57	709	345	10
225160	Matroska	200306	3	0	0	0	2	2	0	0	3	2	0	3	2	0
225160	Matroska	200307	1	0	0	0	1	1	0	0	4	3	0	4	3	0
225160	Matroska	200308	1	0	0	0	1	0	0	0	5	4	0	4	3	0
225160	Matroska	200309	3	0	0	0	2	1	0	0	8	6	0	5	4	0
225160	Matroska	200311	1	0	0	0	1	1	0	0	9	7	0	6	5	0
225160	Matroska	200403	1	0	0	0	1	1	0	0	10	8	0	7	6	0
225160	Matroska	200404	3	0	0	0	3	3	0	0	13	11	0	10	9	0
225160	Matroska	200405	5	0	0	0	3	2	0	0	18	14	0	12	11	0
225160	Matroska	200406	2	0	0	0	2	0	0	0	20	16	0	12	11	0
225160	Matroska	200407	3	0	0	0	3	2	0	0	23	18	0	14	12	0
225160	Matroska	200409	1	0	0	0	1	0	0	0	24	19	0	14	12	0
225160	Matroska	200410	6	0	0	0	2	1	0	0	30	21	0	19	13	0
225160	Matroska	200411	1	0	0	0	1	1	0	0	31	21	0	20	13	0
225160	Matroska	200412	1	0	0	0	1	1	0	0	32	22	0	21	14	0
225160	Matroska	200502	2	0	0	0	2	1	0	0	34	23	0	22	14	0
225160	Matroska	200503	2	0	0	0	2	1	0	0	36	24	0	23	14	0
225160	Matroska	200504	4	0	0	0	2	2	0	0	40	26	0	27	16	0
225160	Matroska	200505	5	0	0	0	3	2	0	0	45	28	0	31	17	0
225160	Matroska	200506	5	0	0	0	3	2	0	0	50	30	0	34	18	0
225160	Matroska	200507	1	0	0	0	1	0	0	0	51	31	0	34	18	0
225160	Matroska	200508	3	0	0	0	3	3	0	0	54	33	0	37	20	0
225160	Matroska	200509	1	0	0	0	1	0	0	0	55	34	0	37	20	0
225160	Matroska	200510	1	0	0	0	1	1	0	0	56	35	0	38	21	0
225160	Matroska	200511	1	0	0	0	1	1	0	0	57	36	0	39	22	0
225160	Matroska	200512	3	0	0	0	3	2	0	0	60	39	0	41	24	0
225160	Matroska	200602	2	0	0	0	1	0	0	0	62	40	0	41	24	0
225160	Matroska	200603	2	0	0	0	2	1	0	0	64	42	0	42	25	0
225160	Matroska	200605	2	0	0	0	2	1	0	0	66	44	0	43	26	0
225160	Matroska	200606	1	0	0	0	1	1	0	0	67	44	0	44	26	0
225160	Matroska	200607	1	0	0	0	1	1	0	0	68	45	0	45	27	0
225160	Matroska	200608	2	0	0	0	2	1	0	0	70	46	0	46	27	0
225160	Matroska	200609	3	0	0	0	3	2	0	0	73	49	0	48	29	0
225160	Matroska	200610	4	0	0	0	4	3	0	0	77	53	0	51	32	0
225160	Matroska	200611	5	1	0	0	4	2	1	0	82	57	1	54	34	0
225160	Matroska	200612	3	1	0	0	3	1	1	0	85	59	2	55	34	0
225160	Matroska	200701	4	1	0	0	3	2	1	0	89	62	3	57	36	0
225160	Matroska	200702	10	0	0	0	4	3	0	0	99	66	3	63	39	0
225160	Matroska	200703	8	0	0	0	7	3	0	0	107	73	3	66	42	0
225160	Matroska	200704	11	0	0	0	10	6	0	0	118	82	3	73	47	0
225160	Matroska	200705	4	1	0	0	4	3	1	0	122	85	4	76	49	0
225160	Matroska	200706	10	1	0	0	9	5	1	0	132	93	5	81	53	0
225160	Matroska	200707	3	0	0	0	3	2	0	0	135	96	5	83	55	0
225160	Matroska	200708	26	0	0	0	10	3	0	0	161	106	5	86	58	0
225160	Matroska	200709	24	1	0	0	18	11	1	0	185	124	6	103	69	0
225160	Matroska	200710	9	0	0	0	7	2	0	0	194	131	6	105	71	0
225160	Matroska	200711	4	0	0	0	4	3	0	0	198	135	6	108	74	0
225160	Matroska	200712	4	0	0	0	4	3	0	0	202	139	6	111	77	0
225160	Matroska	200801	24	0	0	0	13	7	0	0	226	152	6	128	84	0
225160	Matroska	200802	20	0	0	0	15	8	0	0	246	165	6	140	90	0
225160	Matroska	200803	11	1	0	0	11	5	1	0	257	174	7	145	93	0
225160	Matroska	200804	13	3	0	0	12	6	3	0	270	185	10	151	98	0
225160	Matroska	200805	12	0	0	0	9	5	0	0	282	193	10	156	102	0
225160	Matroska	200806	14	2	0	0	11	4	2	0	296	202	12	161	104	0
225160	Matroska	200807	17	0	0	0	11	4	0	0	313	212	12	166	108	0
225160	Matroska	200808	11	1	0	0	7	3	1	0	324	218	13	172	110	0
225160	Matroska	200809	16	0	0	0	11	5	0	0	340	227	13	179	113	0
225160	Matroska	200810	6	1	0	0	6	1	1	0	346	233	14	180	114	0
225160	Matroska	200811	13	0	0	0	9	3	0	0	359	242	14	184	117	0
225160	Matroska	200812	9	1	0	0	8	4	1	0	368	248	15	188	119	0
225160	Matroska	200901	18	6	1	0	13	8	6	1	386	260	21	196	126	2
225160	Matroska	200902	31	2	0	0	22	7	1	0	417	279	23	206	131	3
225160	Matroska	200903	15	0	0	0	9	2	0	0	432	288	23	208	133	3
225160	Matroska	200904	19	0	0	0	14	7	0	0	451	300	23	220	138	3
225160	Matroska	200905	9	1	0	0	7	3	1	0	460	306	24	225	140	3
225160	Matroska	200906	19	1	0	0	17	12	1	0	479	322	25	238	151	3
225160	Matroska	200907	30	6	0	0	22	10	6	0	509	342	31	248	159	3
225160	Matroska	200908	10	0	0	0	9	5	0	0	519	350	31	254	163	3
225160	Matroska	200909	6	1	0	0	5	2	1	0	525	355	32	256	165	3
225160	Matroska	200910	14	1	0	0	11	5	1	0	539	365	33	261	169	4
225160	Matroska	200911	13	1	0	0	10	4	1	0	552	375	34	266	173	4
225160	Matroska	200912	25	3	0	0	20	13	2	0	577	393	37	284	185	6
225160	Matroska	201001	20	2	0	0	16	11	1	0	597	405	39	299	193	6
225160	Matroska	201002	30	1	0	0	18	7	1	0	627	420	40	314	197	7
225160	Matroska	201003	16	1	0	0	13	6	1	0	643	432	41	321	202	8
225160	Matroska	201004	39	4	0	0	22	13	2	0	682	451	45	347	212	11
225160	Matroska	201005	25	4	0	0	19	10	3	0	707	465	49	362	217	12
225160	Matroska	201006	12	0	0	0	10	4	0	0	719	474	49	366	220	12
225160	Matroska	201007	20	1	0	0	15	8	1	0	739	485	50	376	225	12
225160	Matroska	201008	17	2	0	0	13	5	2	0	756	495	52	382	228	12
225160	Matroska	201009	2	0	0	0	2	2	0	0	758	496	52	384	229	12
225160	Matroska	201010	11	2	0	0	9	3	2	0	769	503	54	387	230	12
225160	Matroska	201011	11	1	0	0	7	5	1	0	780	509	55	396	234	12
225160	Matroska	201012	17	1	0	0	13	7	1	0	797	520	56	407	239	12
225160	Matroska	201101	12	2	0	0	9	5	1	0	809	528	58	414	243	12
225160	Matroska	201102	31	5	0	0	20	11	3	0	840	545	63	434	251	12
225160	Matroska	201103	11	2	0	0	11	5	2	0	851	555	65	439	255	12
225160	Matroska	201104	15	1	0	0	11	5	1	0	866	564	66	446	258	12
225160	Matroska	201105	19	4	0	0	15	7	4	0	885	576	70	455	262	13
225160	Matroska	201106	10	3	0	0	9	5	2	0	895	583	73	461	265	15
225160	Matroska	201107	15	2	0	0	12	8	2	0	910	590	75	469	268	16
225160	Matroska	201108	12	1	0	0	7	4	1	0	922	595	76	474	270	16
225160	Matroska	201109	15	4	0	0	11	5	3	0	937	601	80	483	271	17
225160	Matroska	201110	11	3	1	0	10	7	3	1	948	606	83	490	274	18
225160	Matroska	201111	7	1	0	0	7	6	1	0	955	612	84	496	279	18
225160	Matroska	201112	16	4	0	0	11	5	4	0	971	619	88	502	280	18
225160	Matroska	201201	4	1	0	0	4	3	1	0	975	621	89	505	281	19
225160	Matroska	201202	5	2	0	0	5	3	2	0	980	624	91	508	282	19
225160	Matroska	201203	4	0	0	0	3	2	0	0	984	626	91	510	283	19
225160	Matroska	201204	8	2	0	0	6	4	1	0	992	631	93	516	286	20
225160	Matroska	201205	2	0	0	0	2	2	0	0	994	632	93	518	287	20
225160	Matroska	201206	2	0	0	0	2	1	0	0	996	634	93	519	288	20
225160	Matroska	201207	8	1	0	0	5	2	1	0	1004	638	94	521	289	20
225160	Matroska	201208	11	3	0	0	7	4	3	0	1015	643	97	527	291	20
225160	Matroska	201209	9	2	0	0	7	4	1	0	1024	649	99	532	294	21
225160	Matroska	201210	6	1	0	0	4	1	1	0	1030	652	100	533	294	21
225160	Matroska	201211	2	0	0	0	2	1	0	0	1032	654	100	534	295	21
225160	Matroska	201212	2	1	0	0	2	1	1	0	1034	656	101	535	296	21
225160	Matroska	201301	1	0	0	0	1	0	0	0	1035	657	101	535	296	21
225160	Matroska	201302	8	0	0	0	8	3	0	0	1043	664	101	538	298	21
225160	Matroska	201303	7	2	0	0	6	4	1	0	1050	668	103	543	300	21
225160	Matroska	201304	8	1	0	0	5	4	1	0	1058	670	104	550	301	21
225160	Matroska	201305	2	0	0	0	1	1	0	0	1060	671	104	552	302	21
225160	Matroska	201306	1	0	0	0	1	0	0	0	1061	672	104	552	302	21
225160	Matroska	201307	2	0	0	0	2	1	0	0	1063	674	104	553	303	21
225160	Matroska	201308	2	1	0	0	2	1	1	0	1065	676	105	554	304	21
225160	Matroska	201309	3	1	0	0	3	2	1	0	1068	679	106	556	306	21
225160	Matroska	201310	1	0	0	0	1	1	0	0	1069	680	106	557	307	21
225160	Matroska	201312	1	0	0	0	1	1	0	0	1070	680	106	558	307	21
225160	Matroska	201401	1	0	0	0	1	1	0	0	1071	681	106	559	308	21
225160	Matroska	201402	5	0	0	0	4	3	0	0	1076	685	106	563	311	21
225160	Matroska	201403	1	0	0	0	1	0	0	0	1077	686	106	563	311	21
225160	Matroska	201404	6	2	0	0	5	3	2	0	1083	690	108	566	313	21
225160	Matroska	201405	1	0	0	0	1	0	0	0	1084	691	108	566	313	21
225160	Matroska	201406	2	0	0	0	2	2	0	0	1086	693	108	568	315	21
225160	Matroska	201409	2	0	0	0	2	2	0	0	1088	694	108	570	316	21
225160	Matroska	201411	1	0	0	0	1	1	0	0	1089	695	108	571	317	21
225160	Matroska	201412	3	1	0	0	3	2	1	0	1092	698	109	573	319	21
225160	Matroska	201501	1	0	0	0	1	1	0	0	1093	699	109	574	320	21
225160	Matroska	201502	4	0	0	0	4	4	0	0	1097	701	109	578	322	21
225160	Matroska	201503	5	1	0	0	4	2	1	0	1102	705	110	580	324	21
225160	Matroska	201504	5	1	0	0	4	3	1	0	1107	707	111	584	325	21
225160	Matroska	201505	1	0	0	0	1	1	0	0	1108	708	111	585	326	21
225160	Matroska	201506	1	0	0	0	1	1	0	0	1109	709	111	586	327	21
225160	Matroska	201508	2	1	0	0	2	2	1	0	1111	710	112	588	328	22
225160	Matroska	201511	2	1	0	0	2	2	1	0	1113	712	113	590	330	23
225160	Matroska	201602	3	0	0	0	3	2	0	0	1116	715	113	592	332	23
225160	Matroska	201605	3	1	0	0	3	2	1	0	1119	718	114	594	334	23
225160	Matroska	201606	2	0	0	0	2	1	0	0	1121	720	114	595	335	23
225160	Matroska	201608	2	0	0	0	2	2	0	0	1123	721	114	597	336	23
225160	Matroska	201611	1	0	0	0	1	0	0	0	1124	722	114	597	336	23
225160	Matroska	201701	1	0	0	0	1	1	0	0	1125	723	114	598	337	23
225160	Matroska	201702	1	0	0	0	1	1	0	0	1126	724	114	599	338	23
225160	Matroska	201703	1	0	0	0	1	0	0	0	1127	725	114	599	338	23
225160	Matroska	201704	3	0	0	0	2	2	0	0	1130	727	114	602	340	23
225160	Matroska	201707	2	1	0	0	2	1	1	0	1132	728	115	603	340	23
225160	Matroska	201708	3	0	0	0	3	2	0	0	1135	731	115	605	342	23
225160	Matroska	201710	1	0	0	0	1	1	0	0	1136	732	115	606	343	23
225160	Matroska	201712	1	0	0	0	1	1	0	0	1137	733	115	607	344	23
225160	Matroska	201801	3	0	0	0	2	1	0	0	1140	735	115	609	345	23
225160	Matroska	201802	1	0	0	0	1	1	0	0	1141	736	115	610	346	23
225160	Matroska	201804	2	0	0	0	2	2	0	0	1143	738	115	612	348	23
225160	Matroska	201806	3	1	0	0	3	2	1	0	1146	741	116	614	350	23
225160	Matroska	201807	2	0	0	0	2	2	0	0	1148	743	116	616	352	23
49600241	Micro_Data_Center	201603	4	0	0	0	1	1	0	0	4	1	0	4	1	0
49600241	Micro_Data_Center	201605	14	0	0	0	6	6	0	0	18	6	0	18	6	0
49600241	Micro_Data_Center	201608	2	0	0	0	2	2	0	0	20	7	0	20	7	0
49600241	Micro_Data_Center	201612	1	0	0	0	1	1	0	0	21	7	0	21	7	0
49600241	Micro_Data_Center	201704	1	0	0	0	1	1	0	0	22	8	0	22	8	0
49600241	Micro_Data_Center	201707	1	0	0	0	1	1	0	0	23	9	0	23	9	0
49600241	Micro_Data_Center	201708	11	2	0	0	5	4	2	0	34	14	2	28	13	2
49600241	Micro_Data_Center	201710	1	0	0	0	1	0	0	0	35	15	2	28	13	2
49600241	Micro_Data_Center	201711	2	0	0	0	1	1	0	0	37	16	2	30	14	2
49600241	Micro_Data_Center	201712	19	2	0	0	4	3	1	0	56	20	4	37	17	4
49600241	Micro_Data_Center	201801	8	0	0	0	3	2	0	0	64	23	4	44	19	4
49600241	Micro_Data_Center	201802	2	0	0	0	1	0	0	0	66	24	4	44	19	4
49600241	Micro_Data_Center	201803	1	0	0	0	1	1	0	0	67	24	4	45	19	4
49600241	Micro_Data_Center	201804	1	0	0	0	1	1	0	0	68	25	4	46	20	4
49600241	Micro_Data_Center	201805	1	0	0	0	1	1	0	0	69	26	4	47	21	4
49600241	Micro_Data_Center	201806	1	0	0	0	1	1	0	0	70	26	4	48	21	4
43509183	Microservices	201409	11	0	0	0	1	1	0	0	11	1	0	11	1	0
43509183	Microservices	201410	13	0	0	0	6	6	0	0	24	6	0	24	6	0
43509183	Microservices	201412	5	0	0	0	3	3	0	0	29	7	0	29	7	0
43509183	Microservices	201501	2	0	0	0	2	2	0	0	31	9	0	31	9	0
43509183	Microservices	201503	4	0	0	0	2	2	0	0	35	11	0	35	11	0
43509183	Microservices	201504	10	0	0	0	6	6	0	0	45	17	0	45	17	0
43509183	Microservices	201505	14	1	0	0	13	4	1	0	59	30	1	49	21	0
43509183	Microservices	201506	12	0	0	0	8	2	0	0	71	37	1	52	23	0
43509183	Microservices	201507	9	0	0	0	6	3	0	0	80	41	1	58	24	0
43509183	Microservices	201508	6	0	0	0	5	4	0	0	86	44	1	63	27	0
43509183	Microservices	201509	30	0	0	0	9	4	0	0	116	52	1	87	30	0
43509183	Microservices	201510	3	0	0	0	3	1	0	0	119	55	1	88	31	0
43509183	Microservices	201511	17	0	0	0	9	3	0	0	136	62	1	97	33	0
43509183	Microservices	201512	22	0	0	0	6	3	0	0	158	68	1	100	36	0
43509183	Microservices	201601	14	0	0	0	10	6	0	0	172	78	1	108	41	0
43509183	Microservices	201602	15	0	0	0	11	9	0	0	187	87	1	119	48	0
43509183	Microservices	201603	6	0	0	0	5	4	0	0	193	91	1	124	49	0
43509183	Microservices	201604	13	1	0	0	9	5	1	0	206	98	2	132	52	0
43509183	Microservices	201605	28	1	0	0	13	5	1	0	234	109	3	146	55	0
43509183	Microservices	201606	12	0	0	0	6	5	0	0	246	114	3	153	60	0
43509183	Microservices	201607	12	0	0	0	11	8	0	0	258	121	3	161	64	0
43509183	Microservices	201608	23	0	0	0	7	6	0	0	281	126	3	183	67	0
43509183	Microservices	201609	21	0	0	0	8	5	0	0	302	133	3	192	70	0
43509183	Microservices	201610	18	0	0	0	11	9	0	0	320	140	3	208	74	0
43509183	Microservices	201611	22	1	0	0	15	10	1	0	342	153	4	221	81	0
43509183	Microservices	201612	6	0	0	0	5	3	0	0	348	156	4	224	82	0
43509183	Microservices	201701	24	2	0	0	12	6	2	0	372	168	6	234	88	1
43509183	Microservices	201702	6	0	0	0	6	2	0	0	378	173	6	236	89	1
43509183	Microservices	201703	14	1	0	0	7	6	1	0	392	179	7	248	93	2
43509183	Microservices	201704	10	0	0	0	6	5	0	0	402	184	7	257	96	2
43509183	Microservices	201705	27	2	1	0	13	11	2	1	429	194	9	277	104	4
43509183	Microservices	201706	11	1	0	0	5	5	1	0	440	196	10	288	105	5
43509183	Microservices	201707	2	0	0	0	2	1	0	0	442	197	10	289	105	5
43509183	Microservices	201708	7	0	0	0	5	3	0	0	449	199	10	292	105	5
43509183	Microservices	201709	6	1	0	0	3	1	1	0	455	202	11	296	106	5
43509183	Microservices	201710	6	2	0	0	5	4	2	0	461	206	13	301	109	6
43509183	Microservices	201711	3	0	0	0	2	1	0	0	464	208	13	303	110	6
43509183	Microservices	201712	5	2	0	0	3	2	1	0	469	209	15	306	110	6
43509183	Microservices	201801	5	0	0	0	3	1	0	0	474	211	15	307	110	6
43509183	Microservices	201802	5	0	0	0	3	3	0	0	479	213	15	312	112	6
43509183	Microservices	201803	7	1	0	0	5	3	1	0	486	217	16	317	114	6
43509183	Microservices	201804	2	0	0	0	2	1	0	0	488	219	16	318	115	6
43509183	Microservices	201805	8	0	0	0	5	3	0	0	496	224	16	321	117	6
43509183	Microservices	201806	7	0	0	0	6	6	0	0	503	229	16	328	122	6
43509183	Microservices	201807	3	0	0	0	3	2	0	0	506	232	16	330	124	6
27416836	Mobile_data_offloading	201006	5	0	0	0	3	2	0	0	5	3	0	4	2	0
27416836	Mobile_data_offloading	201007	1	0	0	0	1	1	0	0	6	3	0	5	2	0
27416836	Mobile_data_offloading	201008	1	0	0	0	1	0	0	0	7	4	0	5	2	0
27416836	Mobile_data_offloading	201009	5	0	0	0	1	1	0	0	12	5	0	10	3	0
27416836	Mobile_data_offloading	201011	1	0	0	0	1	1	0	0	13	6	0	11	4	0
27416836	Mobile_data_offloading	201012	3	0	0	0	2	2	0	0	16	7	0	14	5	0
27416836	Mobile_data_offloading	201101	5	0	0	0	1	1	0	0	21	8	0	19	6	0
27416836	Mobile_data_offloading	201102	4	0	0	0	2	1	0	0	25	9	0	22	6	0
27416836	Mobile_data_offloading	201103	5	1	0	0	3	3	1	0	30	10	1	27	7	1
27416836	Mobile_data_offloading	201104	2	0	0	0	1	1	0	0	32	11	1	29	8	1
27416836	Mobile_data_offloading	201105	3	0	0	0	2	1	0	0	35	13	1	30	9	1
27416836	Mobile_data_offloading	201108	2	0	0	0	1	0	0	0	37	14	1	30	9	1
27416836	Mobile_data_offloading	201109	3	1	0	0	3	3	1	0	40	17	2	33	12	2
27416836	Mobile_data_offloading	201201	2	1	0	0	2	2	1	0	42	18	3	35	13	3
27416836	Mobile_data_offloading	201202	3	0	0	0	1	1	0	0	45	19	3	38	14	3
27416836	Mobile_data_offloading	201204	1	0	0	0	1	1	0	0	46	20	3	39	15	3
27416836	Mobile_data_offloading	201206	2	0	0	0	2	2	0	0	48	22	3	41	17	3
27416836	Mobile_data_offloading	201207	3	0	0	0	2	1	0	0	51	23	3	42	17	3
27416836	Mobile_data_offloading	201208	2	0	0	0	2	1	0	0	53	24	3	43	17	3
27416836	Mobile_data_offloading	201209	1	0	0	0	1	1	0	0	54	25	3	44	18	3
27416836	Mobile_data_offloading	201210	2	0	0	0	2	2	0	0	56	26	3	46	19	3
27416836	Mobile_data_offloading	201211	2	0	0	0	2	2	0	0	58	28	3	48	21	3
27416836	Mobile_data_offloading	201303	1	0	0	0	1	1	0	0	59	29	3	49	22	3
27416836	Mobile_data_offloading	201304	3	0	0	0	3	3	0	0	62	32	3	52	25	3
27416836	Mobile_data_offloading	201305	3	0	0	0	3	2	0	0	65	35	3	54	27	3
27416836	Mobile_data_offloading	201306	1	0	0	0	1	1	0	0	66	36	3	55	28	3
27416836	Mobile_data_offloading	201307	1	0	0	0	1	1	0	0	67	37	3	56	29	3
27416836	Mobile_data_offloading	201308	2	0	0	0	1	1	0	0	69	38	3	58	30	3
27416836	Mobile_data_offloading	201309	2	0	0	0	2	2	0	0	71	40	3	60	32	3
27416836	Mobile_data_offloading	201401	2	0	0	0	2	1	0	0	73	42	3	61	33	3
27416836	Mobile_data_offloading	201402	4	0	0	0	1	0	0	0	77	43	3	61	33	3
27416836	Mobile_data_offloading	201403	1	0	0	0	1	0	0	0	78	44	3	61	33	3
27416836	Mobile_data_offloading	201404	1	0	0	0	1	0	0	0	79	45	3	61	33	3
27416836	Mobile_data_offloading	201407	1	0	0	0	1	1	0	0	80	46	3	62	34	3
27416836	Mobile_data_offloading	201411	3	0	0	0	2	2	0	0	83	48	3	65	36	3
27416836	Mobile_data_offloading	201501	5	0	0	0	1	0	0	0	88	49	3	65	36	3
27416836	Mobile_data_offloading	201502	1	0	0	0	1	0	0	0	89	50	3	65	36	3
27416836	Mobile_data_offloading	201503	2	0	0	0	2	2	0	0	91	52	3	67	38	3
27416836	Mobile_data_offloading	201506	1	0	0	0	1	1	0	0	92	53	3	68	39	3
27416836	Mobile_data_offloading	201508	2	0	0	0	1	1	0	0	94	54	3	70	40	3
27416836	Mobile_data_offloading	201509	2	0	0	0	1	0	0	0	96	55	3	70	40	3
27416836	Mobile_data_offloading	201603	1	0	0	0	1	0	0	0	97	56	3	70	40	3
27416836	Mobile_data_offloading	201605	2	1	0	0	2	2	1	0	99	58	4	72	42	4
27416836	Mobile_data_offloading	201606	4	0	0	0	4	3	0	0	103	60	4	75	43	4
27416836	Mobile_data_offloading	201608	1	0	0	0	1	0	0	0	104	61	4	75	43	4
27416836	Mobile_data_offloading	201704	3	0	0	0	2	2	0	0	107	63	4	78	44	4
27416836	Mobile_data_offloading	201705	1	0	0	0	1	1	0	0	108	64	4	79	45	4
27416836	Mobile_data_offloading	201707	1	0	0	0	1	0	0	0	109	65	4	79	45	4
27416836	Mobile_data_offloading	201712	4	2	0	0	4	2	2	0	113	69	6	81	47	4
27416836	Mobile_data_offloading	201801	1	0	0	0	1	1	0	0	114	70	6	82	48	4
27416836	Mobile_data_offloading	201803	4	0	0	0	2	1	0	0	118	72	6	85	49	4
44100228	Mobile_edge_computing	201412	9	0	0	0	2	2	0	0	9	2	0	9	2	0
44100228	Mobile_edge_computing	201503	2	0	0	0	1	1	0	0	11	3	0	11	3	0
44100228	Mobile_edge_computing	201510	1	0	0	0	1	1	0	0	12	4	0	12	4	0
44100228	Mobile_edge_computing	201511	16	0	0	0	5	5	0	0	28	9	0	28	9	0
44100228	Mobile_edge_computing	201601	1	0	0	0	1	1	0	0	29	10	0	29	10	0
44100228	Mobile_edge_computing	201602	3	0	0	0	3	2	0	0	32	13	0	31	12	0
44100228	Mobile_edge_computing	201604	1	0	0	0	1	1	0	0	33	14	0	32	13	0
44100228	Mobile_edge_computing	201609	1	0	0	0	1	1	0	0	34	15	0	33	14	0
44100228	Mobile_edge_computing	201610	2	0	0	0	2	1	0	0	36	16	0	34	14	0
44100228	Mobile_edge_computing	201612	2	0	0	0	2	2	0	0	38	18	0	36	16	0
44100228	Mobile_edge_computing	201704	2	0	0	0	2	1	0	0	40	20	0	37	17	0
44100228	Mobile_edge_computing	201705	4	0	0	0	1	0	0	0	44	21	0	37	17	0
44100228	Mobile_edge_computing	201706	1	0	0	0	1	1	0	0	45	22	0	38	18	0
44100228	Mobile_edge_computing	201805	2	0	0	0	1	0	0	0	47	23	0	38	18	0
44100228	Mobile_edge_computing	201806	7	0	0	0	1	1	0	0	54	24	0	45	19	0
44100228	Mobile_edge_computing	201807	4	0	0	0	3	2	0	0	58	27	0	48	21	0
608528	Mozilla_Public_License	200406	1	0	0	0	1	1	0	0	1	1	0	1	1	0
608528	Mozilla_Public_License	200407	2	0	0	0	2	2	0	0	3	3	0	3	3	0
608528	Mozilla_Public_License	200408	2	0	0	0	2	1	0	0	5	5	0	4	4	0
608528	Mozilla_Public_License	200411	3	0	0	0	3	1	0	0	8	8	0	5	5	0
608528	Mozilla_Public_License	200502	2	0	0	0	2	2	0	0	10	10	0	7	7	0
608528	Mozilla_Public_License	200503	1	0	0	0	1	1	0	0	11	11	0	8	8	0
608528	Mozilla_Public_License	200504	1	0	0	0	1	1	0	0	12	12	0	9	9	0
608528	Mozilla_Public_License	200505	2	0	0	0	2	2	0	0	14	13	0	11	10	0
608528	Mozilla_Public_License	200507	1	0	0	0	1	1	0	0	15	14	0	12	11	0
608528	Mozilla_Public_License	200508	2	0	0	0	2	1	0	0	17	15	0	13	11	0
608528	Mozilla_Public_License	200509	5	0	0	0	4	2	0	0	22	19	0	16	13	0
608528	Mozilla_Public_License	200512	1	0	0	0	1	1	0	0	23	20	0	17	14	0
608528	Mozilla_Public_License	200601	2	0	0	0	2	1	0	0	25	22	0	18	15	0
608528	Mozilla_Public_License	200602	1	0	0	0	1	1	0	0	26	22	0	19	15	0
608528	Mozilla_Public_License	200603	3	0	0	0	3	2	0	0	29	25	0	21	17	0
608528	Mozilla_Public_License	200604	1	0	0	0	1	1	0	0	30	25	0	22	17	0
608528	Mozilla_Public_License	200605	6	0	0	0	4	1	0	0	36	29	0	23	18	0
608528	Mozilla_Public_License	200606	12	2	0	0	9	7	2	0	48	38	2	31	25	2
608528	Mozilla_Public_License	200607	3	0	0	0	3	1	0	0	51	41	2	32	26	2
608528	Mozilla_Public_License	200608	5	0	0	0	4	3	0	0	56	45	2	36	29	2
608528	Mozilla_Public_License	200609	2	0	0	0	2	2	0	0	58	47	2	38	31	2
608528	Mozilla_Public_License	200610	1	0	0	0	1	1	0	0	59	48	2	39	32	2
608528	Mozilla_Public_License	200611	1	0	0	0	1	1	0	0	60	49	2	40	33	2
608528	Mozilla_Public_License	200612	8	1	0	0	4	3	1	0	68	53	3	47	36	2
608528	Mozilla_Public_License	200701	3	0	0	0	3	1	0	0	71	56	3	48	37	2
608528	Mozilla_Public_License	200702	2	0	0	0	2	1	0	0	73	58	3	49	38	2
608528	Mozilla_Public_License	200703	2	0	0	0	2	2	0	0	75	60	3	51	40	2
608528	Mozilla_Public_License	200704	2	0	0	0	2	1	0	0	77	62	3	52	41	2
608528	Mozilla_Public_License	200707	1	0	0	0	1	1	0	0	78	63	3	53	42	2
608528	Mozilla_Public_License	200708	4	0	0	0	4	4	0	0	82	66	3	57	45	2
608528	Mozilla_Public_License	200709	1	0	0	0	1	1	0	0	83	67	3	58	46	2
608528	Mozilla_Public_License	200710	3	0	0	0	3	3	0	0	86	70	3	61	49	2
608528	Mozilla_Public_License	200711	3	0	0	0	2	2	0	0	89	72	3	64	51	2
608528	Mozilla_Public_License	200801	1	0	0	0	1	0	0	0	90	73	3	64	51	2
608528	Mozilla_Public_License	200802	4	0	0	0	3	2	0	0	94	75	3	66	52	2
608528	Mozilla_Public_License	200803	5	0	0	0	3	1	0	0	99	78	3	67	53	2
608528	Mozilla_Public_License	200804	4	0	0	0	4	4	0	0	103	82	3	71	57	2
608528	Mozilla_Public_License	200805	2	0	0	0	1	0	0	0	105	83	3	71	57	2
608528	Mozilla_Public_License	200806	1	0	0	0	1	1	0	0	106	84	3	72	58	2
608528	Mozilla_Public_License	200807	3	0	0	0	3	1	0	0	109	87	3	73	59	2
608528	Mozilla_Public_License	200809	1	0	0	0	1	1	0	0	110	87	3	74	59	2
608528	Mozilla_Public_License	200810	5	0	0	0	2	2	0	0	115	89	3	79	61	2
608528	Mozilla_Public_License	200811	2	0	0	0	2	1	0	0	117	91	3	80	62	2
608528	Mozilla_Public_License	200812	1	0	0	0	1	1	0	0	118	91	3	81	62	2
608528	Mozilla_Public_License	200902	2	0	0	0	1	1	0	0	120	92	3	83	63	2
608528	Mozilla_Public_License	200903	2	0	0	0	2	2	0	0	122	94	3	85	65	2
608528	Mozilla_Public_License	200905	1	0	0	0	1	1	0	0	123	94	3	86	65	2
608528	Mozilla_Public_License	200906	1	0	0	0	1	0	0	0	124	95	3	86	65	2
608528	Mozilla_Public_License	200907	1	0	0	0	1	1	0	0	125	96	3	87	66	2
608528	Mozilla_Public_License	200909	1	0	0	0	1	1	0	0	126	97	3	88	67	2
608528	Mozilla_Public_License	200911	1	0	0	0	1	1	0	0	127	98	3	89	68	2
608528	Mozilla_Public_License	200912	4	0	0	0	2	2	0	0	131	100	3	93	70	2
608528	Mozilla_Public_License	201004	1	0	0	0	1	1	0	0	132	101	3	94	71	2
608528	Mozilla_Public_License	201005	3	0	0	0	2	0	0	0	135	103	3	94	71	2
608528	Mozilla_Public_License	201007	1	0	0	0	1	1	0	0	136	104	3	95	72	2
608528	Mozilla_Public_License	201009	1	0	0	0	1	0	0	0	137	105	3	95	72	2
608528	Mozilla_Public_License	201011	1	0	0	0	1	1	0	0	138	106	3	96	73	2
608528	Mozilla_Public_License	201101	1	0	0	0	1	1	0	0	139	107	3	97	74	2
608528	Mozilla_Public_License	201103	1	0	0	0	1	1	0	0	140	108	3	98	75	2
608528	Mozilla_Public_License	201104	1	0	0	0	1	0	0	0	141	109	3	98	75	2
608528	Mozilla_Public_License	201105	5	0	0	0	2	2	0	0	146	111	3	103	77	2
608528	Mozilla_Public_License	201106	3	0	0	0	2	0	0	0	149	113	3	103	77	2
608528	Mozilla_Public_License	201107	2	0	0	0	2	2	0	0	151	115	3	105	79	2
608528	Mozilla_Public_License	201108	1	0	0	0	1	0	0	0	152	116	3	105	79	2
608528	Mozilla_Public_License	201109	3	0	0	0	2	2	0	0	155	118	3	108	81	2
608528	Mozilla_Public_License	201111	4	2	0	0	4	4	2	0	159	122	5	112	85	4
608528	Mozilla_Public_License	201112	1	0	0	0	1	1	0	0	160	122	5	113	85	4
608528	Mozilla_Public_License	201201	4	1	0	0	4	3	1	0	164	125	6	116	87	4
608528	Mozilla_Public_License	201202	3	0	0	0	1	1	0	0	167	126	6	119	88	4
608528	Mozilla_Public_License	201203	1	0	0	0	1	1	0	0	168	126	6	120	88	4
608528	Mozilla_Public_License	201204	6	0	0	0	2	2	0	0	174	128	6	126	90	4
608528	Mozilla_Public_License	201206	2	0	0	0	2	2	0	0	176	130	6	128	92	4
608528	Mozilla_Public_License	201207	2	0	0	0	1	1	0	0	178	130	6	130	92	4
608528	Mozilla_Public_License	201208	2	0	0	0	2	2	0	0	180	132	6	132	94	4
608528	Mozilla_Public_License	201209	3	0	0	0	3	2	0	0	183	135	6	134	96	4
608528	Mozilla_Public_License	201210	4	1	0	0	4	3	1	0	187	138	7	137	98	4
608528	Mozilla_Public_License	201301	1	0	0	0	1	0	0	0	188	139	7	137	98	4
608528	Mozilla_Public_License	201302	4	0	0	0	3	1	0	0	192	142	7	139	99	4
608528	Mozilla_Public_License	201303	3	1	0	0	3	3	1	0	195	144	8	142	101	5
608528	Mozilla_Public_License	201304	1	0	0	0	1	0	0	0	196	145	8	142	101	5
608528	Mozilla_Public_License	201305	1	0	0	0	1	0	0	0	197	146	8	142	101	5
608528	Mozilla_Public_License	201307	6	0	0	0	2	1	0	0	203	148	8	147	102	5
608528	Mozilla_Public_License	201308	1	0	0	0	1	0	0	0	204	149	8	147	102	5
608528	Mozilla_Public_License	201310	4	0	0	0	3	2	0	0	208	151	8	149	103	5
608528	Mozilla_Public_License	201401	2	0	0	0	1	1	0	0	210	151	8	151	103	5
608528	Mozilla_Public_License	201402	5	0	0	0	5	4	0	0	215	156	8	155	107	5
608528	Mozilla_Public_License	201404	1	0	0	0	1	1	0	0	216	157	8	156	108	5
608528	Mozilla_Public_License	201408	5	0	0	0	3	3	0	0	221	158	8	161	109	5
608528	Mozilla_Public_License	201411	3	0	0	0	1	1	0	0	224	159	8	164	110	5
608528	Mozilla_Public_License	201504	1	0	0	0	1	1	0	0	225	160	8	165	111	5
608528	Mozilla_Public_License	201506	4	0	0	0	1	1	0	0	229	160	8	169	111	5
608528	Mozilla_Public_License	201509	1	0	0	0	1	0	0	0	230	161	8	169	111	5
608528	Mozilla_Public_License	201510	1	0	0	0	1	1	0	0	231	162	8	170	112	5
608528	Mozilla_Public_License	201512	1	0	0	0	1	1	0	0	232	163	8	171	113	5
608528	Mozilla_Public_License	201602	1	0	0	0	1	1	0	0	233	164	8	172	114	5
608528	Mozilla_Public_License	201606	2	0	0	0	1	0	0	0	235	165	8	172	114	5
608528	Mozilla_Public_License	201607	1	0	0	0	1	1	0	0	236	165	8	173	114	5
608528	Mozilla_Public_License	201608	4	0	0	0	1	1	0	0	240	165	8	177	114	5
608528	Mozilla_Public_License	201609	25	0	0	0	3	2	0	0	265	166	8	200	114	5
608528	Mozilla_Public_License	201610	5	0	0	0	4	3	0	0	270	169	8	204	116	5
608528	Mozilla_Public_License	201611	5	0	0	0	5	4	0	0	275	173	8	208	118	5
608528	Mozilla_Public_License	201612	1	0	0	0	1	1	0	0	276	174	8	209	119	5
608528	Mozilla_Public_License	201701	2	0	0	0	2	2	0	0	278	175	8	211	120	5
608528	Mozilla_Public_License	201702	1	0	0	0	1	1	0	0	279	176	8	212	121	5
608528	Mozilla_Public_License	201704	1	0	0	0	1	1	0	0	280	177	8	213	122	5
608528	Mozilla_Public_License	201705	1	0	0	0	1	1	0	0	281	178	8	214	123	5
608528	Mozilla_Public_License	201706	1	0	0	0	1	1	0	0	282	179	8	215	123	5
608528	Mozilla_Public_License	201708	2	1	0	0	2	2	1	0	284	181	9	217	124	6
608528	Mozilla_Public_License	201709	1	0	0	0	1	1	0	0	285	182	9	218	125	6
608528	Mozilla_Public_License	201712	8	3	0	0	5	5	2	0	293	186	12	226	129	9
608528	Mozilla_Public_License	201801	1	0	0	0	1	1	0	0	294	187	12	227	130	9
608528	Mozilla_Public_License	201804	4	1	0	0	3	2	1	0	298	190	13	230	132	9
608528	Mozilla_Public_License	201806	1	0	0	0	1	1	0	0	299	191	13	231	133	9
608528	Mozilla_Public_License	201807	1	0	0	0	1	1	0	0	300	192	13	232	134	9
20407	Multicast	200207	1	0	0	0	1	1	0	0	1	1	0	1	1	0
20407	Multicast	200303	1	0	0	0	1	1	0	0	2	2	0	2	2	0
20407	Multicast	200312	4	0	0	0	1	0	0	0	6	3	0	2	2	0
20407	Multicast	200401	5	0	0	0	2	1	0	0	11	5	0	3	3	0
20407	Multicast	200402	2	0	0	0	1	0	0	0	13	6	0	3	3	0
20407	Multicast	200403	2	0	0	0	1	0	0	0	15	7	0	3	3	0
20407	Multicast	200404	1	0	0	0	1	0	0	0	16	8	0	3	3	0
20407	Multicast	200405	1	0	0	0	1	0	0	0	17	9	0	3	3	0
20407	Multicast	200407	1	0	0	0	1	1	0	0	18	10	0	4	4	0
20407	Multicast	200408	2	0	0	0	2	0	0	0	20	12	0	4	4	0
20407	Multicast	200409	2	0	0	0	2	2	0	0	22	14	0	6	6	0
20407	Multicast	200410	5	0	0	0	5	0	0	0	27	19	0	6	6	0
20407	Multicast	200411	3	0	0	0	3	2	0	0	30	22	0	8	8	0
20407	Multicast	200412	5	0	0	0	5	1	0	0	35	27	0	9	9	0
20407	Multicast	200501	2	0	0	0	2	0	0	0	37	29	0	9	9	0
20407	Multicast	200502	3	0	0	0	2	1	0	0	40	31	0	11	10	0
20407	Multicast	200503	1	0	0	0	1	1	0	0	41	32	0	12	11	0
20407	Multicast	200504	2	0	0	0	2	1	0	0	43	34	0	13	12	0
20407	Multicast	200505	6	0	0	0	5	1	0	0	49	39	0	14	13	0
20407	Multicast	200506	6	0	0	0	6	3	0	0	55	44	0	17	15	0
20407	Multicast	200507	1	0	0	0	1	1	0	0	56	45	0	18	16	0
20407	Multicast	200508	2	0	0	0	2	2	0	0	58	47	0	20	18	0
20407	Multicast	200509	5	0	0	0	4	2	0	0	63	51	0	23	20	0
20407	Multicast	200510	9	0	0	0	4	3	0	0	72	54	0	26	22	0
20407	Multicast	200511	3	0	0	0	3	1	0	0	75	57	0	27	23	0
20407	Multicast	200512	9	0	0	0	8	5	0	0	84	64	0	32	28	0
20407	Multicast	200601	7	0	0	0	6	4	0	0	91	69	0	37	32	0
20407	Multicast	200602	5	0	0	0	4	3	0	0	96	73	0	41	35	0
20407	Multicast	200603	5	1	0	0	4	1	1	0	101	77	1	42	36	0
20407	Multicast	200604	9	1	0	0	6	2	1	0	110	83	2	44	38	0
20407	Multicast	200605	6	0	0	0	5	4	0	0	116	87	2	48	41	0
20407	Multicast	200606	12	0	0	0	10	8	0	0	128	95	2	58	47	0
20407	Multicast	200607	10	0	0	0	7	5	0	0	138	101	2	66	51	0
20407	Multicast	200608	5	0	0	0	4	3	0	0	143	105	2	70	54	0
20407	Multicast	200609	2	1	0	0	2	1	1	0	145	107	3	71	55	0
20407	Multicast	200610	12	2	0	0	8	4	2	0	157	114	5	78	58	0
20407	Multicast	200611	3	1	0	0	2	1	1	0	160	116	6	79	59	0
20407	Multicast	200612	14	0	0	0	6	2	0	0	174	121	6	86	60	0
20407	Multicast	200701	5	0	0	0	4	2	0	0	179	125	6	89	62	0
20407	Multicast	200702	5	0	0	0	3	1	0	0	184	128	6	92	63	0
20407	Multicast	200703	1	0	0	0	1	1	0	0	185	129	6	93	64	0
20407	Multicast	200704	1	0	0	0	1	1	0	0	186	130	6	94	65	0
20407	Multicast	200705	6	1	0	0	6	4	1	0	192	134	7	98	67	0
20407	Multicast	200706	4	1	0	0	4	2	1	0	196	137	8	100	68	1
20407	Multicast	200707	7	0	0	0	6	4	0	0	203	143	8	105	72	1
20407	Multicast	200708	8	0	0	0	7	3	0	0	211	150	8	108	75	1
20407	Multicast	200709	2	0	0	0	2	0	0	0	213	152	8	108	75	1
20407	Multicast	200710	3	0	0	0	2	0	0	0	216	154	8	108	75	1
20407	Multicast	200711	6	1	0	0	5	2	1	0	222	159	9	110	77	2
20407	Multicast	200712	9	0	0	0	4	2	0	0	231	163	9	115	79	2
20407	Multicast	200801	3	1	0	0	3	2	1	0	234	166	10	117	81	2
20407	Multicast	200802	5	0	0	0	3	1	0	0	239	169	10	118	82	2
20407	Multicast	200803	3	0	0	0	3	0	0	0	242	172	10	118	82	2
20407	Multicast	200805	6	1	0	0	5	4	1	0	248	176	11	123	85	2
20407	Multicast	200806	4	1	0	0	4	1	1	0	252	180	12	124	86	2
20407	Multicast	200807	2	0	0	0	2	1	0	0	254	182	12	125	87	2
20407	Multicast	200808	6	0	0	0	2	1	0	0	260	184	12	130	88	2
20407	Multicast	200809	9	2	0	0	7	3	2	0	269	190	14	133	90	2
20407	Multicast	200810	8	0	0	0	3	2	0	0	277	192	14	139	91	2
20407	Multicast	200811	6	0	0	0	3	1	0	0	283	195	14	143	92	2
20407	Multicast	200812	6	0	0	0	2	2	0	0	289	196	14	149	93	2
20407	Multicast	200901	5	1	0	0	5	4	1	0	294	201	15	153	97	2
20407	Multicast	200902	5	0	0	0	3	1	0	0	299	204	15	154	98	2
20407	Multicast	200903	9	2	0	0	7	3	2	0	308	211	17	157	101	2
20407	Multicast	200904	12	0	0	0	6	4	0	0	320	216	17	165	104	2
20407	Multicast	200905	9	2	0	0	7	3	2	0	329	222	19	170	106	2
20407	Multicast	200906	7	0	0	0	6	2	0	0	336	228	19	173	108	2
20407	Multicast	200907	7	1	0	0	6	3	1	0	343	234	20	176	111	3
20407	Multicast	200908	3	1	0	0	3	2	1	0	346	237	21	178	113	3
20407	Multicast	200909	5	0	0	0	1	0	0	0	351	238	21	178	113	3
20407	Multicast	200910	1	0	0	0	1	0	0	0	352	239	21	178	113	3
20407	Multicast	200911	1	0	0	0	1	0	0	0	353	240	21	178	113	3
20407	Multicast	200912	7	0	0	0	4	1	0	0	360	244	21	179	114	3
20407	Multicast	201001	11	1	0	0	8	6	1	0	371	249	22	187	117	3
20407	Multicast	201002	21	0	0	0	2	2	0	0	392	250	22	208	118	3
20407	Multicast	201003	2	1	0	0	2	1	1	0	394	251	23	209	118	3
20407	Multicast	201005	5	1	0	0	5	2	1	0	399	256	24	211	120	3
20407	Multicast	201007	2	0	0	0	2	0	0	0	401	258	24	211	120	3
20407	Multicast	201008	9	2	0	0	5	2	1	0	410	262	26	214	121	3
20407	Multicast	201009	20	2	0	0	9	5	2	0	430	269	28	228	124	3
20407	Multicast	201010	7	1	0	0	6	5	1	0	437	272	29	234	126	4
20407	Multicast	201011	10	1	0	0	7	6	1	0	447	279	30	243	132	4
20407	Multicast	201012	5	1	0	0	4	3	1	0	452	283	31	246	135	5
20407	Multicast	201101	1	0	0	0	1	1	0	0	453	284	31	247	136	5
20407	Multicast	201102	5	0	0	0	3	1	0	0	458	287	31	249	137	5
20407	Multicast	201103	2	1	0	0	2	1	1	0	460	289	32	250	138	5
20407	Multicast	201107	1	0	0	0	1	0	0	0	461	290	32	250	138	5
20407	Multicast	201108	8	1	0	0	7	5	1	0	469	296	33	255	142	5
20407	Multicast	201109	5	2	0	0	3	2	1	0	474	297	35	259	142	6
20407	Multicast	201110	4	1	0	0	3	3	1	0	478	299	36	263	144	7
20407	Multicast	201111	1	0	0	0	1	1	0	0	479	300	36	264	145	7
20407	Multicast	201201	1	0	0	0	1	1	0	0	480	301	36	265	146	7
20407	Multicast	201202	1	0	0	0	1	1	0	0	481	302	36	266	147	7
20407	Multicast	201203	2	0	0	0	2	1	0	0	483	304	36	267	148	7
20407	Multicast	201204	1	0	0	0	1	1	0	0	484	305	36	268	149	7
20407	Multicast	201206	2	0	0	0	2	2	0	0	486	307	36	270	151	7
20407	Multicast	201207	2	0	0	0	1	1	0	0	488	308	36	272	152	7
20407	Multicast	201209	1	0	0	0	1	1	0	0	489	308	36	273	152	7
20407	Multicast	201210	9	1	0	0	5	2	1	0	498	311	37	275	152	7
20407	Multicast	201211	3	1	0	0	2	0	1	0	501	313	38	275	152	7
20407	Multicast	201212	2	1	0	0	2	1	1	0	503	315	39	276	153	7
20407	Multicast	201301	9	1	0	0	5	4	1	0	512	319	40	284	155	7
20407	Multicast	201302	3	1	0	0	3	2	1	0	515	322	41	286	157	7
20407	Multicast	201304	1	0	0	0	1	1	0	0	516	323	41	287	158	7
20407	Multicast	201305	3	0	0	0	3	3	0	0	519	326	41	290	161	7
20407	Multicast	201306	7	0	0	0	3	2	0	0	526	328	41	295	162	7
20407	Multicast	201308	4	1	0	0	4	2	1	0	530	331	42	297	163	7
20407	Multicast	201310	2	0	0	0	2	2	0	0	532	333	42	299	165	7
20407	Multicast	201311	1	0	0	0	1	0	0	0	533	334	42	299	165	7
20407	Multicast	201401	1	0	0	0	1	1	0	0	534	335	42	300	166	7
20407	Multicast	201403	3	0	0	0	3	2	0	0	537	338	42	302	168	7
20407	Multicast	201405	1	0	0	0	1	1	0	0	538	339	42	303	169	7
20407	Multicast	201407	14	0	0	0	9	6	0	0	552	346	42	314	173	7
20407	Multicast	201408	3	1	0	0	3	2	1	0	555	348	43	316	174	7
20407	Multicast	201409	2	0	0	0	2	2	0	0	557	350	43	318	176	7
20407	Multicast	201411	4	0	0	0	3	2	0	0	561	353	43	320	178	7
20407	Multicast	201412	2	1	0	0	2	1	1	0	563	355	44	321	179	7
20407	Multicast	201502	5	1	0	0	4	2	1	0	568	358	45	323	180	7
20407	Multicast	201503	1	0	0	0	1	1	0	0	569	359	45	324	181	7
20407	Multicast	201504	3	1	0	0	2	1	1	0	572	360	46	325	181	7
20407	Multicast	201506	2	0	0	0	2	2	0	0	574	361	46	327	182	7
20407	Multicast	201510	3	1	0	0	3	1	1	0	577	363	47	328	182	7
20407	Multicast	201511	10	6	4	3	4	2	3	2	587	366	53	332	183	9
20407	Multicast	201512	1	0	0	0	1	1	0	0	588	366	53	333	183	9
20407	Multicast	201605	3	1	0	0	2	1	1	0	591	367	54	334	183	9
20407	Multicast	201606	1	0	0	0	1	0	0	0	592	368	54	334	183	9
20407	Multicast	201607	2	0	0	0	2	2	0	0	594	370	54	336	185	9
20407	Multicast	201608	4	1	0	0	4	3	1	0	598	372	55	339	186	9
20407	Multicast	201609	3	1	0	0	3	2	1	0	601	373	56	341	186	9
20407	Multicast	201610	1	0	0	0	1	0	0	0	602	374	56	341	186	9
20407	Multicast	201611	1	0	0	0	1	1	0	0	603	374	56	342	186	9
20407	Multicast	201701	1	0	0	0	1	1	0	0	604	375	56	343	187	9
20407	Multicast	201702	1	0	0	0	1	1	0	0	605	376	56	344	188	9
20407	Multicast	201707	1	0	0	0	1	1	0	0	606	376	56	345	188	9
20407	Multicast	201709	8	1	0	0	3	1	1	0	614	378	57	347	188	9
20407	Multicast	201710	2	0	0	0	2	2	0	0	616	379	57	349	189	9
20407	Multicast	201711	2	0	0	0	2	2	0	0	618	380	57	351	190	9
20407	Multicast	201712	2	0	0	0	1	0	0	0	620	381	57	351	190	9
20407	Multicast	201801	1	0	0	0	1	1	0	0	621	381	57	352	190	9
20407	Multicast	201802	13	4	0	0	7	5	2	0	634	387	61	361	194	9
20407	Multicast	201803	4	2	0	0	4	2	2	0	638	390	63	363	195	9
20407	Multicast	201805	1	0	0	0	1	1	0	0	639	390	63	364	195	9
20407	Multicast	201806	9	0	0	0	6	1	0	0	648	395	63	367	195	9
20407	Multicast	201807	1	0	0	0	1	1	0	0	649	395	63	368	195	9
40584315	Multipath_TCP	201310	52	0	0	0	10	8	0	0	52	10	0	50	8	0
40584315	Multipath_TCP	201312	3	0	0	0	3	3	0	0	55	13	0	53	11	0
40584315	Multipath_TCP	201401	3	0	0	0	2	0	0	0	58	15	0	53	11	0
40584315	Multipath_TCP	201402	1	0	0	0	1	1	0	0	59	16	0	54	12	0
40584315	Multipath_TCP	201403	2	0	0	0	2	1	0	0	61	18	0	55	13	0
40584315	Multipath_TCP	201404	1	0	0	0	1	1	0	0	62	19	0	56	14	0
40584315	Multipath_TCP	201405	1	0	0	0	1	0	0	0	63	20	0	56	14	0
40584315	Multipath_TCP	201406	1	0	0	0	1	1	0	0	64	21	0	57	15	0
40584315	Multipath_TCP	201407	3	0	0	0	2	1	0	0	67	23	0	59	16	0
40584315	Multipath_TCP	201408	3	0	0	0	3	2	0	0	70	25	0	61	17	0
40584315	Multipath_TCP	201411	1	0	0	0	1	1	0	0	71	26	0	62	18	0
40584315	Multipath_TCP	201501	14	0	0	0	5	3	0	0	85	30	0	72	20	0
40584315	Multipath_TCP	201503	2	0	0	0	2	1	0	0	87	31	0	73	20	0
40584315	Multipath_TCP	201506	1	0	0	0	1	1	0	0	88	32	0	74	21	0
40584315	Multipath_TCP	201507	4	0	0	0	3	2	0	0	92	34	0	76	22	0
40584315	Multipath_TCP	201508	3	0	0	0	3	2	0	0	95	37	0	78	23	0
40584315	Multipath_TCP	201509	2	0	0	0	2	2	0	0	97	39	0	80	25	0
40584315	Multipath_TCP	201510	1	0	0	0	1	0	0	0	98	40	0	80	25	0
40584315	Multipath_TCP	201603	1	0	0	0	1	1	0	0	99	41	0	81	25	0
40584315	Multipath_TCP	201604	2	0	0	0	2	1	0	0	101	43	0	82	26	0
40584315	Multipath_TCP	201606	1	0	0	0	1	0	0	0	102	44	0	82	26	0
40584315	Multipath_TCP	201607	8	1	0	0	3	3	1	0	110	47	1	90	29	1
40584315	Multipath_TCP	201610	4	0	0	0	4	4	0	0	114	51	1	94	33	1
40584315	Multipath_TCP	201612	1	0	0	0	1	1	0	0	115	52	1	95	34	1
40584315	Multipath_TCP	201701	2	0	0	0	1	0	0	0	117	53	1	95	34	1
40584315	Multipath_TCP	201702	5	0	0	0	2	2	0	0	122	53	1	100	34	1
40584315	Multipath_TCP	201710	3	0	0	0	2	2	0	0	125	55	1	103	35	1
40584315	Multipath_TCP	201711	2	0	0	0	1	1	0	0	127	55	1	105	35	1
40584315	Multipath_TCP	201712	8	0	0	0	2	2	0	0	135	56	1	113	36	1
40584315	Multipath_TCP	201802	3	0	0	0	3	3	0	0	138	59	1	116	38	1
40584315	Multipath_TCP	201804	2	0	0	0	2	2	0	0	140	61	1	118	40	1
40584315	Multipath_TCP	201806	1	0	0	0	1	1	0	0	141	62	1	119	41	1
40584315	Multipath_TCP	201807	1	0	0	0	1	1	0	0	142	63	1	120	42	1
20623	Multiprotocol_Label_Switching	200202	4	0	0	0	1	1	0	0	4	1	0	4	1	0
20623	Multiprotocol_Label_Switching	200207	1	0	0	0	1	1	0	0	5	2	0	5	2	0
20623	Multiprotocol_Label_Switching	200208	2	0	0	0	1	0	0	0	7	3	0	5	2	0
20623	Multiprotocol_Label_Switching	200209	10	0	0	0	2	1	0	0	17	5	0	6	3	0
20623	Multiprotocol_Label_Switching	200302	2	0	0	0	2	1	0	0	19	7	0	7	4	0
20623	Multiprotocol_Label_Switching	200304	1	0	0	0	1	0	0	0	20	8	0	7	4	0
20623	Multiprotocol_Label_Switching	200305	1	0	0	0	1	0	0	0	21	9	0	7	4	0
20623	Multiprotocol_Label_Switching	200306	3	0	0	0	2	1	0	0	24	11	0	8	5	0
20623	Multiprotocol_Label_Switching	200309	4	1	0	0	3	2	1	0	28	14	1	10	7	0
20623	Multiprotocol_Label_Switching	200311	3	0	0	0	2	1	0	0	31	16	1	12	8	0
20623	Multiprotocol_Label_Switching	200403	1	0	0	0	1	1	0	0	32	17	1	13	9	0
20623	Multiprotocol_Label_Switching	200404	1	0	0	0	1	1	0	0	33	18	1	14	10	0
20623	Multiprotocol_Label_Switching	200406	1	0	0	0	1	1	0	0	34	19	1	15	11	0
20623	Multiprotocol_Label_Switching	200407	1	0	0	0	1	1	0	0	35	20	1	16	12	0
20623	Multiprotocol_Label_Switching	200408	1	0	0	0	1	1	0	0	36	21	1	17	13	0
20623	Multiprotocol_Label_Switching	200409	3	0	0	0	2	1	0	0	39	23	1	19	14	0
20623	Multiprotocol_Label_Switching	200410	1	0	0	0	1	1	0	0	40	24	1	20	15	0
20623	Multiprotocol_Label_Switching	200411	8	0	0	0	6	4	0	0	48	28	1	25	17	0
20623	Multiprotocol_Label_Switching	200412	8	0	0	0	6	4	0	0	56	34	1	30	21	0
20623	Multiprotocol_Label_Switching	200504	4	0	0	0	4	2	0	0	60	37	1	32	22	0
20623	Multiprotocol_Label_Switching	200505	3	0	0	0	3	2	0	0	63	40	1	34	24	0
20623	Multiprotocol_Label_Switching	200506	7	0	0	0	1	1	0	0	70	41	1	41	25	0
20623	Multiprotocol_Label_Switching	200507	7	0	0	0	5	1	0	0	77	45	1	42	25	0
20623	Multiprotocol_Label_Switching	200509	1	0	0	0	1	0	0	0	78	46	1	42	25	0
20623	Multiprotocol_Label_Switching	200510	5	0	0	0	3	0	0	0	83	49	1	42	25	0
20623	Multiprotocol_Label_Switching	200511	1	0	0	0	1	0	0	0	84	50	1	42	25	0
20623	Multiprotocol_Label_Switching	200512	22	1	0	0	6	2	1	0	106	55	2	44	26	0
20623	Multiprotocol_Label_Switching	200601	8	1	0	0	8	2	1	0	114	62	3	46	27	0
20623	Multiprotocol_Label_Switching	200602	13	0	0	0	9	7	0	0	127	70	3	57	33	0
20623	Multiprotocol_Label_Switching	200603	6	0	0	0	6	3	0	0	133	75	3	60	35	0
20623	Multiprotocol_Label_Switching	200604	10	2	0	0	8	7	2	0	143	82	5	68	41	1
20623	Multiprotocol_Label_Switching	200605	7	0	0	0	6	1	0	0	150	88	5	69	42	1
20623	Multiprotocol_Label_Switching	200606	12	1	0	0	9	2	1	0	162	97	6	72	44	1
20623	Multiprotocol_Label_Switching	200607	5	0	0	0	5	2	0	0	167	102	6	74	46	1
20623	Multiprotocol_Label_Switching	200608	20	2	0	0	16	5	2	0	187	115	8	80	48	1
20623	Multiprotocol_Label_Switching	200609	9	2	0	0	9	6	2	0	196	123	10	86	53	2
20623	Multiprotocol_Label_Switching	200610	10	1	0	0	9	4	1	0	206	132	11	90	57	2
20623	Multiprotocol_Label_Switching	200611	16	1	0	0	7	6	1	0	222	138	12	105	62	3
20623	Multiprotocol_Label_Switching	200612	19	5	0	0	13	4	3	0	241	150	17	111	65	4
20623	Multiprotocol_Label_Switching	200701	20	0	0	0	13	4	0	0	261	162	17	116	68	4
20623	Multiprotocol_Label_Switching	200702	8	0	0	0	6	2	0	0	269	167	17	118	69	4
20623	Multiprotocol_Label_Switching	200703	13	2	0	0	10	2	2	0	282	177	19	120	71	4
20623	Multiprotocol_Label_Switching	200704	21	3	0	0	15	9	3	0	303	191	22	134	79	6
20623	Multiprotocol_Label_Switching	200705	8	0	0	0	6	4	0	0	311	196	22	139	82	6
20623	Multiprotocol_Label_Switching	200706	11	2	0	0	7	2	2	0	322	203	24	141	84	6
20623	Multiprotocol_Label_Switching	200707	10	1	0	0	8	3	1	0	332	210	25	145	86	6
20623	Multiprotocol_Label_Switching	200708	24	1	0	0	18	6	1	0	356	226	26	155	91	6
20623	Multiprotocol_Label_Switching	200709	20	1	0	0	14	7	1	0	376	236	27	163	95	6
20623	Multiprotocol_Label_Switching	200710	23	6	1	0	13	7	2	1	399	244	33	179	99	9
20623	Multiprotocol_Label_Switching	200711	10	2	0	0	8	5	2	0	409	248	35	186	101	9
20623	Multiprotocol_Label_Switching	200712	20	1	0	0	13	5	1	0	429	260	36	195	105	10
20623	Multiprotocol_Label_Switching	200801	15	0	0	0	11	6	0	0	444	270	36	202	110	10
20623	Multiprotocol_Label_Switching	200802	18	0	0	0	13	7	0	0	462	281	36	210	116	10
20623	Multiprotocol_Label_Switching	200803	15	0	0	0	12	5	0	0	477	290	36	215	118	10
20623	Multiprotocol_Label_Switching	200804	15	3	0	0	9	5	3	0	492	298	39	222	122	11
20623	Multiprotocol_Label_Switching	200805	23	3	0	0	16	6	3	0	515	313	42	228	127	12
20623	Multiprotocol_Label_Switching	200806	18	0	0	0	11	5	0	0	533	324	42	240	132	12
20623	Multiprotocol_Label_Switching	200807	13	0	0	0	7	4	0	0	546	330	42	249	135	12
20623	Multiprotocol_Label_Switching	200808	9	1	0	0	7	3	1	0	555	337	43	252	138	12
20623	Multiprotocol_Label_Switching	200809	11	0	0	0	11	3	0	0	566	348	43	255	141	12
20623	Multiprotocol_Label_Switching	200810	9	2	0	0	9	4	2	0	575	355	45	259	144	13
20623	Multiprotocol_Label_Switching	200811	24	6	0	0	16	7	5	0	599	370	51	267	150	13
20623	Multiprotocol_Label_Switching	200812	9	2	0	0	9	5	2	0	608	377	53	272	154	14
20623	Multiprotocol_Label_Switching	200901	15	1	0	0	13	7	1	0	623	388	54	279	159	15
20623	Multiprotocol_Label_Switching	200902	9	0	0	0	7	4	0	0	632	393	54	284	162	15
20623	Multiprotocol_Label_Switching	200903	4	0	0	0	3	1	0	0	636	396	54	285	163	15
20623	Multiprotocol_Label_Switching	200904	12	2	0	0	7	3	2	0	648	402	56	292	165	16
20623	Multiprotocol_Label_Switching	200905	16	4	0	0	15	9	4	0	664	413	60	301	170	16
20623	Multiprotocol_Label_Switching	200906	18	6	0	0	11	5	3	0	682	421	66	313	172	16
20623	Multiprotocol_Label_Switching	200907	10	2	0	0	8	1	1	0	692	428	68	315	172	16
20623	Multiprotocol_Label_Switching	200908	13	2	0	0	11	6	2	0	705	435	70	323	174	16
20623	Multiprotocol_Label_Switching	200909	20	4	0	0	12	8	4	0	725	446	74	335	181	18
20623	Multiprotocol_Label_Switching	200910	5	0	0	0	4	2	0	0	730	449	74	337	183	18
20623	Multiprotocol_Label_Switching	200911	7	1	0	0	6	1	1	0	737	455	75	338	184	18
20623	Multiprotocol_Label_Switching	200912	8	1	0	0	5	2	1	0	745	459	76	341	185	18
20623	Multiprotocol_Label_Switching	201001	6	0	0	0	3	2	0	0	751	461	76	345	186	18
20623	Multiprotocol_Label_Switching	201002	5	0	0	0	5	4	0	0	756	465	76	349	189	18
20623	Multiprotocol_Label_Switching	201003	10	3	0	0	5	2	1	0	766	468	79	355	190	18
20623	Multiprotocol_Label_Switching	201004	12	2	0	0	10	4	2	0	778	477	81	360	193	18
20623	Multiprotocol_Label_Switching	201005	19	1	0	0	6	3	1	0	797	481	82	375	194	18
20623	Multiprotocol_Label_Switching	201006	4	1	0	0	3	3	1	0	801	483	83	379	196	18
20623	Multiprotocol_Label_Switching	201007	6	0	0	0	3	2	0	0	807	486	83	381	198	18
20623	Multiprotocol_Label_Switching	201008	4	1	0	0	3	1	1	0	811	488	84	383	198	18
20623	Multiprotocol_Label_Switching	201009	4	1	0	0	3	2	1	0	815	491	85	386	200	18
20623	Multiprotocol_Label_Switching	201010	10	2	0	0	6	5	2	0	825	495	87	395	203	19
20623	Multiprotocol_Label_Switching	201011	19	1	0	0	14	6	1	0	844	507	88	403	207	19
20623	Multiprotocol_Label_Switching	201012	11	1	0	0	9	3	1	0	855	514	89	408	208	19
20623	Multiprotocol_Label_Switching	201101	10	2	0	0	8	4	2	0	865	520	91	413	210	19
20623	Multiprotocol_Label_Switching	201102	9	2	0	0	7	5	1	0	874	524	93	420	212	19
20623	Multiprotocol_Label_Switching	201103	3	0	0	0	3	2	0	0	877	526	93	422	213	19
20623	Multiprotocol_Label_Switching	201104	1	0	0	0	1	1	0	0	878	527	93	423	214	19
20623	Multiprotocol_Label_Switching	201105	14	4	0	0	8	2	1	0	892	534	97	428	215	19
20623	Multiprotocol_Label_Switching	201106	5	0	0	0	4	1	0	0	897	538	97	429	216	19
20623	Multiprotocol_Label_Switching	201107	5	1	0	0	5	3	1	0	902	542	98	432	218	19
20623	Multiprotocol_Label_Switching	201108	6	1	0	0	5	2	1	0	908	546	99	435	219	19
20623	Multiprotocol_Label_Switching	201109	6	1	0	0	5	2	1	0	914	549	100	438	219	19
20623	Multiprotocol_Label_Switching	201110	11	2	0	0	8	6	2	0	925	555	102	447	223	19
20623	Multiprotocol_Label_Switching	201111	4	0	0	0	4	4	0	0	929	558	102	451	226	19
20623	Multiprotocol_Label_Switching	201112	12	2	0	0	10	7	2	0	941	565	104	460	231	19
20623	Multiprotocol_Label_Switching	201201	8	2	0	0	5	2	1	0	949	569	106	465	232	19
20623	Multiprotocol_Label_Switching	201202	3	0	0	0	2	1	0	0	952	571	106	467	233	19
20623	Multiprotocol_Label_Switching	201203	7	2	0	0	6	3	2	0	959	575	108	471	234	19
20623	Multiprotocol_Label_Switching	201204	18	0	0	0	9	6	0	0	977	581	108	485	237	19
20623	Multiprotocol_Label_Switching	201205	9	1	0	0	6	2	1	0	986	585	109	490	237	19
20623	Multiprotocol_Label_Switching	201206	11	4	0	0	7	2	2	0	997	590	113	494	237	19
20623	Multiprotocol_Label_Switching	201207	8	2	0	0	6	5	2	0	1005	596	115	501	242	20
20623	Multiprotocol_Label_Switching	201208	8	0	0	0	5	3	0	0	1013	599	115	506	243	20
20623	Multiprotocol_Label_Switching	201209	12	3	0	0	10	3	3	0	1025	607	118	509	244	21
20623	Multiprotocol_Label_Switching	201210	13	1	0	0	5	4	1	0	1038	609	119	519	245	21
20623	Multiprotocol_Label_Switching	201211	4	1	0	0	3	2	1	0	1042	611	120	521	246	21
20623	Multiprotocol_Label_Switching	201212	12	4	0	0	9	3	3	0	1054	618	124	526	247	21
20623	Multiprotocol_Label_Switching	201301	2	1	0	0	2	2	1	0	1056	620	125	528	248	22
20623	Multiprotocol_Label_Switching	201302	6	1	0	0	5	3	1	0	1062	623	126	531	249	22
20623	Multiprotocol_Label_Switching	201303	8	0	0	0	6	4	0	0	1070	627	126	536	252	22
20623	Multiprotocol_Label_Switching	201304	10	1	0	0	6	2	1	0	1080	633	127	538	254	22
20623	Multiprotocol_Label_Switching	201306	2	1	0	0	2	0	1	0	1082	635	128	538	254	22
20623	Multiprotocol_Label_Switching	201308	7	2	0	0	7	4	2	0	1089	640	130	542	256	22
20623	Multiprotocol_Label_Switching	201309	4	1	0	0	4	2	1	0	1093	642	131	544	256	22
20623	Multiprotocol_Label_Switching	201310	13	1	0	0	7	4	1	0	1106	648	132	550	259	22
20623	Multiprotocol_Label_Switching	201311	12	2	0	0	8	7	2	0	1118	655	134	561	265	23
20623	Multiprotocol_Label_Switching	201312	6	0	0	0	5	3	0	0	1124	659	134	565	267	23
20623	Multiprotocol_Label_Switching	201401	12	2	0	0	8	3	2	0	1136	665	136	570	268	23
20623	Multiprotocol_Label_Switching	201402	8	2	0	0	7	5	2	0	1144	672	138	575	273	23
20623	Multiprotocol_Label_Switching	201403	7	1	0	0	3	2	1	0	1151	675	139	580	275	23
20623	Multiprotocol_Label_Switching	201404	10	1	0	0	6	5	1	0	1161	678	140	589	277	23
20623	Multiprotocol_Label_Switching	201405	12	4	0	0	9	3	3	0	1173	685	144	593	278	23
20623	Multiprotocol_Label_Switching	201406	1	0	0	0	1	0	0	0	1174	686	144	593	278	23
20623	Multiprotocol_Label_Switching	201407	4	2	0	0	4	2	2	0	1178	688	146	595	278	23
20623	Multiprotocol_Label_Switching	201408	2	1	0	0	2	2	1	0	1180	689	147	597	278	24
20623	Multiprotocol_Label_Switching	201409	3	1	0	0	3	1	1	0	1183	692	148	598	279	24
20623	Multiprotocol_Label_Switching	201410	9	5	0	0	9	4	5	0	1192	699	153	602	282	24
20623	Multiprotocol_Label_Switching	201411	7	0	0	0	6	3	0	0	1199	703	153	606	283	24
20623	Multiprotocol_Label_Switching	201412	11	4	0	0	9	7	4	0	1210	710	157	615	288	26
20623	Multiprotocol_Label_Switching	201502	1	0	0	0	1	1	0	0	1211	711	157	616	289	26
20623	Multiprotocol_Label_Switching	201503	2	1	0	0	2	1	1	0	1213	712	158	617	289	26
20623	Multiprotocol_Label_Switching	201504	11	3	0	0	10	4	3	0	1224	721	161	621	293	26
20623	Multiprotocol_Label_Switching	201505	5	1	0	0	5	2	1	0	1229	724	162	623	294	26
20623	Multiprotocol_Label_Switching	201507	6	3	0	0	4	2	2	0	1235	726	165	626	294	26
20623	Multiprotocol_Label_Switching	201508	7	1	0	0	5	2	1	0	1242	730	166	628	295	26
20623	Multiprotocol_Label_Switching	201509	17	3	0	0	10	4	2	0	1259	737	169	633	297	26
20623	Multiprotocol_Label_Switching	201510	6	1	0	0	5	2	1	0	1265	740	170	635	297	26
20623	Multiprotocol_Label_Switching	201511	2	0	0	0	2	0	0	0	1267	742	170	635	297	26
20623	Multiprotocol_Label_Switching	201512	1	0	0	0	1	0	0	0	1268	743	170	635	297	26
20623	Multiprotocol_Label_Switching	201601	7	1	0	0	3	2	1	0	1275	745	171	638	298	26
20623	Multiprotocol_Label_Switching	201602	8	2	0	0	5	2	2	0	1283	749	173	640	299	26
20623	Multiprotocol_Label_Switching	201603	1	0	0	0	1	1	0	0	1284	750	173	641	300	26
20623	Multiprotocol_Label_Switching	201604	5	1	0	0	5	4	1	0	1289	755	174	645	304	26
20623	Multiprotocol_Label_Switching	201605	12	6	0	0	8	5	5	0	1301	759	180	651	305	26
20623	Multiprotocol_Label_Switching	201606	6	0	0	0	1	0	0	0	1307	760	180	651	305	26
20623	Multiprotocol_Label_Switching	201607	5	1	0	0	4	1	1	0	1312	763	181	652	305	26
20623	Multiprotocol_Label_Switching	201608	2	1	0	0	2	2	1	0	1314	764	182	654	305	27
20623	Multiprotocol_Label_Switching	201609	7	3	0	0	6	3	3	0	1321	768	185	657	306	27
20623	Multiprotocol_Label_Switching	201610	3	0	0	0	3	1	0	0	1324	771	185	658	307	27
20623	Multiprotocol_Label_Switching	201611	14	3	0	0	6	5	2	0	1338	775	188	668	310	27
20623	Multiprotocol_Label_Switching	201612	2	1	0	0	2	1	1	0	1340	777	189	669	311	27
20623	Multiprotocol_Label_Switching	201701	12	2	0	0	7	2	2	0	1352	783	191	671	312	27
20623	Multiprotocol_Label_Switching	201702	4	1	0	0	4	4	1	0	1356	785	192	675	314	28
20623	Multiprotocol_Label_Switching	201703	1	0	0	0	1	0	0	0	1357	786	192	675	314	28
20623	Multiprotocol_Label_Switching	201704	3	0	0	0	3	3	0	0	1360	789	192	678	317	28
20623	Multiprotocol_Label_Switching	201705	5	0	0	0	4	1	0	0	1365	792	192	679	317	28
20623	Multiprotocol_Label_Switching	201706	4	1	0	0	4	2	1	0	1369	796	193	681	319	28
20623	Multiprotocol_Label_Switching	201707	1	0	0	0	1	0	0	0	1370	797	193	681	319	28
20623	Multiprotocol_Label_Switching	201708	5	1	0	0	4	3	1	0	1375	800	194	684	321	28
20623	Multiprotocol_Label_Switching	201709	7	2	0	0	5	3	1	0	1382	805	196	688	323	28
20623	Multiprotocol_Label_Switching	201710	6	0	0	0	3	0	0	0	1388	808	196	688	323	28
20623	Multiprotocol_Label_Switching	201711	1	0	0	0	1	1	0	0	1389	808	196	689	323	28
20623	Multiprotocol_Label_Switching	201712	8	3	0	0	6	2	2	0	1397	813	199	692	324	28
20623	Multiprotocol_Label_Switching	201801	2	0	0	0	2	1	0	0	1399	815	199	693	325	28
20623	Multiprotocol_Label_Switching	201803	1	0	0	0	1	1	0	0	1400	816	199	694	326	28
20623	Multiprotocol_Label_Switching	201804	5	0	0	0	3	3	0	0	1405	817	199	699	327	28
20623	Multiprotocol_Label_Switching	201806	2	0	0	0	1	0	0	0	1407	818	199	699	327	28
20623	Multiprotocol_Label_Switching	201807	1	0	0	0	1	1	0	0	1408	819	199	700	328	28
19545	MySQL	200112	1	0	0	0	1	1	0	0	1	1	0	1	1	0
19545	MySQL	200202	3	0	0	0	3	3	0	0	4	4	0	4	4	0
19545	MySQL	200206	2	0	0	0	2	2	0	0	6	5	0	6	4	0
19545	MySQL	200207	4	0	0	0	2	1	0	0	10	7	0	7	5	0
19545	MySQL	200208	1	0	0	0	1	1	0	0	11	8	0	8	6	0
19545	MySQL	200209	5	0	0	0	4	4	0	0	16	12	0	13	10	0
19545	MySQL	200210	3	0	0	0	2	2	0	0	19	13	0	16	11	0
19545	MySQL	200211	1	0	0	0	1	0	0	0	20	14	0	16	11	0
19545	MySQL	200212	1	0	0	0	1	1	0	0	21	15	0	17	12	0
19545	MySQL	200301	1	0	0	0	1	0	0	0	22	16	0	17	12	0
19545	MySQL	200303	2	0	0	0	2	1	0	0	24	18	0	18	13	0
19545	MySQL	200308	1	0	0	0	1	1	0	0	25	19	0	19	14	0
19545	MySQL	200309	9	0	0	0	8	5	0	0	34	27	0	25	19	0
19545	MySQL	200310	2	0	0	0	2	1	0	0	36	29	0	26	20	0
19545	MySQL	200311	3	0	0	0	3	3	0	0	39	32	0	29	23	0
19545	MySQL	200312	11	0	0	0	3	2	0	0	50	34	0	32	24	0
19545	MySQL	200401	5	1	0	0	5	4	1	0	55	38	1	36	27	0
19545	MySQL	200402	7	0	0	0	6	4	0	0	62	44	1	41	31	0
19545	MySQL	200403	5	0	0	0	3	2	0	0	67	47	1	43	33	0
19545	MySQL	200404	8	0	0	0	5	2	0	0	75	52	1	46	35	0
19545	MySQL	200405	7	0	0	0	6	4	0	0	82	57	1	51	38	0
19545	MySQL	200406	21	3	0	0	15	10	2	0	103	69	4	64	45	0
19545	MySQL	200407	5	0	0	0	5	4	0	0	108	72	4	68	47	0
19545	MySQL	200408	6	0	0	0	6	1	0	0	114	78	4	69	48	0
19545	MySQL	200409	7	0	0	0	5	4	0	0	121	82	4	75	51	0
19545	MySQL	200410	7	1	0	0	6	3	1	0	128	87	5	78	53	0
19545	MySQL	200411	15	1	0	0	12	5	1	0	143	98	6	83	58	0
19545	MySQL	200412	10	1	0	0	7	4	1	0	153	104	7	89	61	0
19545	MySQL	200501	22	0	0	0	10	6	0	0	175	112	7	105	65	0
19545	MySQL	200502	33	4	0	0	17	9	2	0	208	127	11	130	72	0
19545	MySQL	200503	28	3	0	0	15	9	1	0	236	140	14	152	79	1
19545	MySQL	200504	32	5	0	0	13	10	4	0	268	149	19	178	85	3
19545	MySQL	200505	21	1	0	0	12	7	1	0	289	156	20	192	87	3
19545	MySQL	200506	3	0	0	0	3	3	0	0	292	158	20	195	89	3
19545	MySQL	200507	9	0	0	0	8	4	0	0	301	166	20	199	93	3
19545	MySQL	200508	24	3	0	0	14	7	2	0	325	177	23	216	97	3
19545	MySQL	200509	18	0	0	0	16	9	0	0	343	191	23	227	104	3
19545	MySQL	200510	20	1	0	0	16	11	1	0	363	204	24	238	112	3
19545	MySQL	200511	47	3	0	0	33	14	3	0	410	234	27	261	123	4
19545	MySQL	200512	26	2	0	0	19	10	1	0	436	249	29	276	129	4
19545	MySQL	200601	19	1	0	0	18	10	1	0	455	262	30	287	134	4
19545	MySQL	200602	44	5	0	0	33	15	5	0	499	291	35	303	145	5
19545	MySQL	200603	28	4	0	0	24	13	4	0	527	310	39	317	153	5
19545	MySQL	200604	24	6	0	0	18	10	4	0	551	324	45	330	159	7
19545	MySQL	200605	31	1	0	0	18	7	1	0	582	341	46	339	165	8
19545	MySQL	200606	37	6	0	0	23	7	5	0	619	360	52	354	169	8
19545	MySQL	200607	39	0	0	0	19	10	0	0	658	376	52	382	177	8
19545	MySQL	200608	27	2	0	0	18	12	2	0	685	391	54	401	186	9
19545	MySQL	200609	25	2	0	0	19	9	2	0	710	408	56	413	193	9
19545	MySQL	200610	21	3	0	0	19	8	3	0	731	427	59	422	201	10
19545	MySQL	200611	41	7	0	0	30	17	5	0	772	451	66	443	213	11
19545	MySQL	200612	23	4	0	0	22	9	4	0	795	471	70	452	222	12
19545	MySQL	200701	40	3	0	0	29	17	3	0	835	495	73	473	235	12
19545	MySQL	200702	40	2	0	0	29	15	2	0	875	521	75	494	247	13
19545	MySQL	200703	41	4	0	0	24	16	3	0	916	542	79	526	261	15
19545	MySQL	200704	50	6	0	0	29	16	4	0	966	568	85	556	275	16
19545	MySQL	200705	61	5	0	0	31	16	2	0	1027	589	90	596	283	16
19545	MySQL	200706	32	5	0	0	22	13	4	0	1059	606	95	618	293	17
19545	MySQL	200707	17	1	0	0	14	9	1	0	1076	616	96	630	299	17
19545	MySQL	200708	29	4	0	0	22	8	3	0	1105	634	100	641	304	17
19545	MySQL	200709	53	9	0	0	29	17	4	0	1158	657	109	673	315	18
19545	MySQL	200710	40	8	0	0	25	17	6	0	1198	674	117	702	325	22
19545	MySQL	200711	26	4	0	0	18	7	3	0	1224	690	121	710	331	22
19545	MySQL	200712	18	4	0	0	15	7	4	0	1242	702	125	718	335	22
19545	MySQL	200801	43	6	0	0	26	15	6	0	1285	723	131	744	345	23
19545	MySQL	200802	56	8	0	0	31	18	8	0	1341	747	139	781	357	24
19545	MySQL	200803	47	10	3	2	31	18	8	2	1388	772	149	814	369	28
19545	MySQL	200804	34	2	0	0	26	15	2	0	1422	789	151	833	377	28
19545	MySQL	200805	27	6	0	0	22	17	4	0	1449	805	157	854	388	31
19545	MySQL	200806	34	5	0	0	21	11	4	0	1483	821	162	874	394	33
19545	MySQL	200807	17	1	0	0	14	7	1	0	1500	831	163	883	398	33
19545	MySQL	200808	43	8	0	0	27	19	7	0	1543	852	171	914	411	35
19545	MySQL	200809	21	5	1	0	18	13	5	1	1564	863	176	930	417	38
19545	MySQL	200810	24	5	0	0	22	11	4	0	1588	881	181	942	424	38
19545	MySQL	200811	31	5	0	0	25	13	5	0	1619	897	186	959	428	38
19545	MySQL	200812	22	2	0	0	17	11	2	0	1641	910	188	974	435	38
19545	MySQL	200901	25	6	0	0	17	10	5	0	1666	924	194	990	442	38
19545	MySQL	200902	14	5	2	1	12	6	4	2	1680	932	199	997	444	39
19545	MySQL	200903	11	0	0	0	8	8	0	0	1691	937	199	1008	449	39
19545	MySQL	200904	30	9	0	0	21	11	6	0	1721	955	208	1025	457	39
19545	MySQL	200905	39	3	0	0	29	16	3	0	1760	978	211	1046	467	40
19545	MySQL	200906	27	7	0	0	20	7	3	0	1787	995	218	1059	471	43
19545	MySQL	200907	46	4	0	0	29	13	3	0	1833	1017	222	1079	477	43
19545	MySQL	200908	14	0	0	0	11	8	0	0	1847	1025	222	1088	482	43
19545	MySQL	200909	7	2	0	0	7	5	2	0	1854	1030	224	1093	485	43
19545	MySQL	200910	26	4	0	0	23	13	3	0	1880	1050	228	1108	495	43
19545	MySQL	200911	22	5	0	0	19	6	5	0	1902	1065	233	1117	497	43
19545	MySQL	200912	21	4	0	0	16	9	3	0	1923	1078	237	1128	504	44
19545	MySQL	201001	51	4	0	0	27	14	3	0	1974	1102	241	1145	515	44
19545	MySQL	201002	42	5	1	0	28	18	4	1	2016	1125	246	1172	529	46
19545	MySQL	201003	33	3	0	0	22	14	3	0	2049	1139	249	1195	537	46
19545	MySQL	201004	32	7	0	0	20	13	5	0	2081	1151	256	1218	542	49
19545	MySQL	201005	18	5	0	0	17	11	4	0	2099	1162	261	1230	547	50
19545	MySQL	201006	17	3	0	0	14	9	2	0	2116	1172	264	1241	552	51
19545	MySQL	201007	24	3	0	0	12	7	3	0	2140	1181	267	1248	556	51
19545	MySQL	201008	23	3	0	0	19	5	3	0	2163	1198	270	1253	561	51
19545	MySQL	201009	27	3	0	0	17	9	3	0	2190	1211	273	1270	566	52
19545	MySQL	201010	28	3	0	0	19	11	3	0	2218	1227	276	1289	574	53
19545	MySQL	201011	33	5	0	0	25	11	3	0	2251	1247	281	1305	580	53
19545	MySQL	201012	31	4	0	0	19	12	3	0	2282	1261	285	1327	588	55
19545	MySQL	201101	17	1	0	0	16	13	1	0	2299	1274	286	1341	598	55
19545	MySQL	201102	62	9	0	0	29	10	5	0	2361	1299	295	1377	604	56
19545	MySQL	201103	13	3	0	0	9	4	3	0	2374	1307	298	1381	607	56
19545	MySQL	201104	3	0	0	0	3	1	0	0	2377	1309	298	1382	607	56
19545	MySQL	201105	9	2	0	0	8	5	2	0	2386	1316	300	1388	611	56
19545	MySQL	201106	20	7	0	0	15	7	5	0	2406	1326	307	1398	613	56
19545	MySQL	201107	6	2	0	0	5	3	1	0	2412	1330	309	1402	615	57
19545	MySQL	201108	6	0	0	0	4	3	0	0	2418	1332	309	1406	616	57
19545	MySQL	201109	59	12	3	1	23	15	6	2	2477	1351	321	1452	627	65
19545	MySQL	201110	17	3	0	0	13	7	3	0	2494	1363	324	1461	633	65
19545	MySQL	201111	20	6	0	0	15	8	5	0	2514	1376	330	1471	639	65
19545	MySQL	201112	11	2	0	0	8	4	2	0	2525	1383	332	1476	642	65
19545	MySQL	201201	9	0	0	0	6	4	0	0	2534	1388	332	1483	645	65
19545	MySQL	201202	23	2	0	0	18	13	2	0	2557	1401	334	1499	653	66
19545	MySQL	201203	36	8	1	0	21	9	6	1	2593	1417	342	1521	657	68
19545	MySQL	201204	9	1	0	0	8	3	1	0	2602	1423	343	1525	658	68
19545	MySQL	201205	17	2	0	0	15	9	2	0	2619	1434	345	1534	663	68
19545	MySQL	201206	11	2	0	0	10	6	2	0	2630	1440	347	1540	665	68
19545	MySQL	201207	21	1	0	0	14	7	1	0	2651	1452	348	1550	670	69
19545	MySQL	201208	14	2	0	0	10	6	2	0	2665	1460	350	1559	674	69
19545	MySQL	201209	33	8	0	0	22	12	6	0	2698	1479	358	1581	683	70
19545	MySQL	201210	22	3	0	0	15	9	3	0	2720	1489	361	1595	687	70
19545	MySQL	201211	36	0	0	0	16	12	0	0	2756	1496	361	1625	691	70
19545	MySQL	201212	15	0	0	0	8	6	0	0	2771	1502	361	1638	695	70
19545	MySQL	201301	27	5	0	0	17	8	5	0	2798	1513	366	1652	696	70
19545	MySQL	201302	15	1	0	0	13	8	1	0	2813	1523	367	1661	701	70
19545	MySQL	201303	12	3	0	0	11	6	2	0	2825	1532	370	1668	705	70
19545	MySQL	201304	18	3	0	0	12	8	2	0	2843	1541	373	1682	710	71
19545	MySQL	201305	12	3	0	0	12	8	3	0	2855	1551	376	1690	716	72
19545	MySQL	201306	18	1	0	0	14	7	1	0	2873	1561	377	1699	719	72
19545	MySQL	201307	17	1	0	0	13	6	1	0	2890	1572	378	1708	723	72
19545	MySQL	201308	21	3	0	0	16	11	3	0	2911	1582	381	1723	728	72
19545	MySQL	201309	11	2	0	0	9	6	1	0	2922	1588	383	1731	732	73
19545	MySQL	201310	9	0	0	0	8	6	0	0	2931	1596	383	1738	738	73
19545	MySQL	201311	18	2	0	0	13	8	2	0	2949	1606	385	1748	743	74
19545	MySQL	201312	14	6	0	0	10	7	5	0	2963	1611	391	1756	745	75
19545	MySQL	201401	10	0	0	0	6	5	0	0	2973	1616	391	1764	749	75
19545	MySQL	201402	14	1	0	0	9	7	1	0	2987	1623	392	1776	754	75
19545	MySQL	201403	21	5	0	0	12	8	3	0	3008	1633	397	1792	760	79
19545	MySQL	201404	43	0	0	0	13	8	0	0	3051	1642	397	1829	764	79
19545	MySQL	201405	17	3	0	0	13	7	3	0	3068	1652	400	1838	768	79
19545	MySQL	201406	8	2	0	0	7	5	2	0	3076	1656	402	1843	770	80
19545	MySQL	201407	29	3	0	0	16	9	2	0	3105	1666	405	1864	773	80
19545	MySQL	201408	15	1	0	0	9	4	1	0	3120	1673	406	1874	775	80
19545	MySQL	201409	9	1	0	0	7	4	1	0	3129	1677	407	1880	776	80
19545	MySQL	201410	7	1	0	0	6	5	1	0	3136	1681	408	1886	779	80
19545	MySQL	201411	9	0	0	0	6	4	0	0	3145	1685	408	1890	781	80
19545	MySQL	201412	6	2	0	0	6	3	2	0	3151	1689	410	1893	782	80
19545	MySQL	201501	5	0	0	0	4	3	0	0	3156	1691	410	1897	783	80
19545	MySQL	201502	6	1	0	0	4	3	1	0	3162	1694	411	1902	785	80
19545	MySQL	201503	14	3	0	0	11	6	3	0	3176	1703	414	1910	789	80
19545	MySQL	201504	10	2	0	0	7	4	1	0	3186	1709	416	1917	792	81
19545	MySQL	201505	6	0	0	0	4	1	0	0	3192	1713	416	1919	793	81
19545	MySQL	201506	15	3	0	0	9	7	2	0	3207	1719	419	1932	796	82
19545	MySQL	201507	38	2	0	0	10	7	2	0	3245	1726	421	1962	800	83
19545	MySQL	201508	11	1	0	0	9	6	1	0	3256	1732	422	1970	803	83
19545	MySQL	201509	12	2	0	0	6	4	2	0	3268	1737	424	1980	806	84
19545	MySQL	201510	5	1	0	0	5	5	1	0	3273	1741	425	1985	809	85
19545	MySQL	201511	18	3	0	0	15	8	3	0	3291	1750	428	1995	812	86
19545	MySQL	201512	17	4	0	0	12	8	4	0	3308	1759	432	2004	816	87
19545	MySQL	201601	6	1	0	0	6	4	1	0	3314	1762	433	2008	818	87
19545	MySQL	201602	8	1	0	0	7	4	1	0	3322	1767	434	2012	820	87
19545	MySQL	201603	6	1	0	0	5	3	1	0	3328	1770	435	2016	822	87
19545	MySQL	201604	10	3	0	0	9	4	3	0	3338	1778	438	2020	825	87
19545	MySQL	201605	16	3	0	0	8	7	3	0	3354	1781	441	2035	828	90
19545	MySQL	201606	7	0	0	0	7	6	0	0	3361	1787	441	2041	833	90
19545	MySQL	201607	19	4	0	0	16	11	4	0	3380	1797	445	2055	839	92
19545	MySQL	201608	19	2	0	0	11	8	2	0	3399	1804	447	2070	843	92
19545	MySQL	201609	14	2	0	0	9	8	2	0	3413	1809	449	2083	846	93
19545	MySQL	201610	11	2	0	0	9	8	2	0	3424	1815	451	2093	851	94
19545	MySQL	201611	27	12	1	0	19	12	9	1	3451	1831	463	2110	861	100
19545	MySQL	201612	18	5	0	0	11	7	5	0	3469	1836	468	2119	863	102
19545	MySQL	201701	16	4	1	0	12	9	4	1	3485	1843	472	2130	868	105
19545	MySQL	201702	14	5	0	0	10	6	4	0	3499	1851	477	2138	872	107
19545	MySQL	201703	1	0	0	0	1	1	0	0	3500	1851	477	2139	872	107
19545	MySQL	201704	13	7	1	0	9	7	5	1	3513	1858	484	2150	877	112
19545	MySQL	201706	8	2	0	0	7	7	2	0	3521	1862	486	2158	881	114
19545	MySQL	201707	8	2	0	0	7	4	2	0	3529	1867	488	2162	883	114
19545	MySQL	201708	7	1	0	0	6	3	1	0	3536	1871	489	2165	885	114
19545	MySQL	201709	13	3	0	0	11	8	3	0	3549	1880	492	2175	890	115
19545	MySQL	201710	17	2	0	0	10	7	2	0	3566	1888	494	2182	894	117
19545	MySQL	201711	29	7	0	0	24	22	5	0	3595	1906	501	2209	911	123
19545	MySQL	201712	10	2	0	0	8	7	2	0	3605	1912	503	2218	915	124
19545	MySQL	201801	8	2	0	0	5	3	2	0	3613	1916	505	2221	917	125
19545	MySQL	201802	11	2	0	0	10	8	2	0	3624	1921	507	2230	920	126
19545	MySQL	201803	7	1	0	0	5	4	1	0	3631	1924	508	2235	921	127
19545	MySQL	201804	16	0	0	0	8	7	0	0	3647	1931	508	2250	926	127
19545	MySQL	201805	10	0	0	0	7	6	0	0	3657	1937	508	2258	930	127
19545	MySQL	201806	19	4	0	0	15	9	4	0	3676	1949	512	2269	935	127
19545	MySQL	201807	15	1	0	0	4	3	1	0	3691	1953	513	2283	938	127
30228442	NAT64	201105	1	0	0	0	1	1	0	0	1	1	0	1	1	0
30228442	NAT64	201108	10	0	0	0	5	5	0	0	11	6	0	11	6	0
30228442	NAT64	201112	1	0	0	0	1	0	0	0	12	7	0	11	6	0
30228442	NAT64	201204	5	0	0	0	1	1	0	0	17	8	0	16	7	0
30228442	NAT64	201205	4	0	0	0	2	1	0	0	21	9	0	18	7	0
30228442	NAT64	201207	2	0	0	0	2	1	0	0	23	11	0	19	8	0
30228442	NAT64	201209	1	0	0	0	1	0	0	0	24	12	0	19	8	0
30228442	NAT64	201211	1	0	0	0	1	1	0	0	25	13	0	20	9	0
30228442	NAT64	201301	5	0	0	0	3	3	0	0	30	15	0	25	11	0
30228442	NAT64	201302	1	0	0	0	1	1	0	0	31	16	0	26	12	0
30228442	NAT64	201303	1	0	0	0	1	1	0	0	32	17	0	27	13	0
30228442	NAT64	201305	3	0	0	0	3	1	0	0	35	20	0	28	14	0
30228442	NAT64	201306	4	1	0	0	3	2	1	0	39	23	1	30	16	1
30228442	NAT64	201307	1	0	0	0	1	1	0	0	40	24	1	31	17	1
30228442	NAT64	201308	2	0	0	0	2	1	0	0	42	26	1	32	18	1
30228442	NAT64	201311	1	0	0	0	1	0	0	0	43	27	1	32	18	1
30228442	NAT64	201312	5	0	0	0	4	3	0	0	48	30	1	36	20	1
30228442	NAT64	201401	1	0	0	0	1	1	0	0	49	31	1	37	21	1
30228442	NAT64	201403	7	0	0	0	3	3	0	0	56	33	1	44	23	1
30228442	NAT64	201404	2	0	0	0	2	1	0	0	58	34	1	45	23	1
30228442	NAT64	201411	2	1	0	0	2	1	1	0	60	35	2	46	23	1
30228442	NAT64	201502	3	0	0	0	3	2	0	0	63	36	2	48	23	1
30228442	NAT64	201503	2	0	0	0	2	1	0	0	65	37	2	49	23	1
30228442	NAT64	201504	9	0	0	0	2	2	0	0	74	37	2	58	23	1
30228442	NAT64	201506	4	0	0	0	3	2	0	0	78	38	2	61	23	1
30228442	NAT64	201507	1	0	0	0	1	1	0	0	79	39	2	62	23	1
30228442	NAT64	201610	1	0	0	0	1	1	0	0	80	39	2	63	23	1
30228442	NAT64	201611	1	0	0	0	1	1	0	0	81	40	2	64	23	1
30228442	NAT64	201707	2	0	0	0	2	2	0	0	83	42	2	66	24	1
30228442	NAT64	201712	1	0	0	0	1	1	0	0	84	43	2	67	25	1
30228442	NAT64	201802	1	0	0	0	1	1	0	0	85	44	2	68	26	1
30228442	NAT64	201803	1	0	0	0	1	1	0	0	86	45	2	69	27	1
30228442	NAT64	201805	1	0	0	0	1	0	0	0	87	46	2	69	27	1
30228442	NAT64	201806	1	1	0	0	1	0	1	0	88	47	3	69	27	1
3711679	NETCONF	200602	2	0	0	0	1	1	0	0	2	1	0	2	1	0
3711679	NETCONF	200604	1	0	0	0	1	0	0	0	3	2	0	2	1	0
3711679	NETCONF	200609	1	0	0	0	1	1	0	0	4	3	0	3	2	0
3711679	NETCONF	200610	2	0	0	0	2	1	0	0	6	4	0	4	3	0
3711679	NETCONF	200701	3	0	0	0	3	1	0	0	9	6	0	5	4	0
3711679	NETCONF	200702	4	0	0	0	2	0	0	0	13	7	0	5	4	0
3711679	NETCONF	200703	1	0	0	0	1	1	0	0	14	8	0	6	5	0
3711679	NETCONF	200704	1	0	0	0	1	1	0	0	15	9	0	7	6	0
3711679	NETCONF	200706	2	1	0	0	2	2	1	0	17	10	1	9	7	1
3711679	NETCONF	200707	2	0	0	0	2	2	0	0	19	11	1	11	8	1
3711679	NETCONF	200708	1	0	0	0	1	1	0	0	20	12	1	12	9	1
3711679	NETCONF	200709	4	1	0	0	2	0	1	0	24	13	2	12	9	1
3711679	NETCONF	200710	1	0	0	0	1	1	0	0	25	14	2	13	10	1
3711679	NETCONF	200807	3	0	0	0	2	0	0	0	28	15	2	13	10	1
3711679	NETCONF	200809	12	0	0	0	3	1	0	0	40	17	2	14	11	1
3711679	NETCONF	200901	2	0	0	0	1	0	0	0	42	18	2	14	11	1
3711679	NETCONF	200905	1	0	0	0	1	1	0	0	43	19	2	15	12	1
3711679	NETCONF	200906	1	0	0	0	1	0	0	0	44	20	2	15	12	1
3711679	NETCONF	200908	1	0	0	0	1	0	0	0	45	21	2	15	12	1
3711679	NETCONF	200911	1	0	0	0	1	1	0	0	46	22	2	16	13	1
3711679	NETCONF	200912	4	1	0	0	2	1	1	0	50	24	3	17	14	1
3711679	NETCONF	201004	4	0	0	0	1	1	0	0	54	25	3	21	15	1
3711679	NETCONF	201007	2	0	0	0	2	1	0	0	56	27	3	22	16	1
3711679	NETCONF	201008	6	0	0	0	2	0	0	0	62	29	3	22	16	1
3711679	NETCONF	201009	2	0	0	0	1	0	0	0	64	29	3	22	16	1
3711679	NETCONF	201011	1	0	0	0	1	0	0	0	65	30	3	22	16	1
3711679	NETCONF	201012	2	0	0	0	1	1	0	0	67	31	3	24	17	1
3711679	NETCONF	201101	1	0	0	0	1	0	0	0	68	32	3	24	17	1
3711679	NETCONF	201109	1	0	0	0	1	1	0	0	69	33	3	25	18	1
3711679	NETCONF	201111	6	1	0	0	4	4	1	0	75	36	4	31	21	2
3711679	NETCONF	201203	4	1	0	0	3	1	1	0	79	38	5	32	21	2
3711679	NETCONF	201204	1	0	0	0	1	1	0	0	80	39	5	33	22	2
3711679	NETCONF	201208	1	0	0	0	1	1	0	0	81	40	5	34	23	2
3711679	NETCONF	201209	2	0	0	0	2	1	0	0	83	42	5	35	24	2
3711679	NETCONF	201301	1	0	0	0	1	1	0	0	84	43	5	36	25	2
3711679	NETCONF	201303	2	0	0	0	2	1	0	0	86	45	5	37	26	2
3711679	NETCONF	201304	1	0	0	0	1	1	0	0	87	46	5	38	27	2
3711679	NETCONF	201305	1	0	0	0	1	1	0	0	88	47	5	39	28	2
3711679	NETCONF	201306	2	0	0	0	2	2	0	0	90	49	5	41	30	2
3711679	NETCONF	201307	1	0	0	0	1	1	0	0	91	50	5	42	31	2
3711679	NETCONF	201309	3	0	0	0	2	1	0	0	94	51	5	43	31	2
3711679	NETCONF	201311	3	0	0	0	2	2	0	0	97	53	5	46	33	2
3711679	NETCONF	201312	4	1	0	0	2	2	1	0	101	55	6	50	35	3
3711679	NETCONF	201403	4	0	0	0	2	2	0	0	105	55	6	54	35	3
3711679	NETCONF	201404	2	0	0	0	2	1	0	0	107	56	6	55	35	3
3711679	NETCONF	201409	2	0	0	0	1	1	0	0	109	57	6	57	36	3
3711679	NETCONF	201512	2	0	0	0	2	2	0	0	111	58	6	59	37	3
3711679	NETCONF	201603	1	0	0	0	1	1	0	0	112	59	6	60	38	3
3711679	NETCONF	201605	6	0	0	0	2	1	0	0	118	61	6	64	39	3
3711679	NETCONF	201606	1	0	0	0	1	1	0	0	119	61	6	65	39	3
3711679	NETCONF	201608	3	0	0	0	2	2	0	0	122	62	6	68	40	3
3711679	NETCONF	201610	1	0	0	0	1	1	0	0	123	63	6	69	41	3
3711679	NETCONF	201701	5	0	0	0	4	2	0	0	128	66	6	71	42	3
3711679	NETCONF	201703	1	0	0	0	1	1	0	0	129	66	6	72	42	3
3711679	NETCONF	201706	2	0	0	0	2	1	0	0	131	68	6	73	43	3
3711679	NETCONF	201805	2	0	0	0	1	0	0	0	133	69	6	73	43	3
21488	Nanotechnology	200202	4	0	0	0	4	4	0	0	4	4	0	4	2	0
21488	Nanotechnology	200206	2	0	0	0	2	1	0	0	6	6	0	5	2	0
21488	Nanotechnology	200207	3	0	0	0	2	2	0	0	9	8	0	8	4	0
21488	Nanotechnology	200208	4	0	0	0	4	3	0	0	13	12	0	11	6	0
21488	Nanotechnology	200209	1	0	0	0	1	1	0	0	14	13	0	12	7	0
21488	Nanotechnology	200210	1	0	0	0	1	0	0	0	15	14	0	12	7	0
21488	Nanotechnology	200211	2	0	0	0	2	0	0	0	17	16	0	12	7	0
21488	Nanotechnology	200212	2	0	0	0	1	0	0	0	19	17	0	12	7	0
21488	Nanotechnology	200301	2	0	0	0	2	2	0	0	21	19	0	14	9	0
21488	Nanotechnology	200302	3	0	0	0	2	1	0	0	24	21	0	16	10	0
21488	Nanotechnology	200305	8	0	0	0	6	2	0	0	32	27	0	19	12	0
21488	Nanotechnology	200306	2	0	0	0	2	0	0	0	34	29	0	19	12	0
21488	Nanotechnology	200307	9	0	0	0	6	4	0	0	43	34	0	26	15	0
21488	Nanotechnology	200308	3	0	0	0	3	1	0	0	46	37	0	27	16	0
21488	Nanotechnology	200309	10	2	0	0	5	3	2	0	56	41	2	30	18	1
21488	Nanotechnology	200310	18	0	0	0	7	0	0	0	74	48	2	30	18	1
21488	Nanotechnology	200311	8	1	0	0	4	3	1	0	82	51	3	35	20	1
21488	Nanotechnology	200312	5	0	0	0	5	2	0	0	87	56	3	37	22	1
21488	Nanotechnology	200401	2	0	0	0	2	1	0	0	89	58	3	38	23	1
21488	Nanotechnology	200402	1	0	0	0	1	0	0	0	90	59	3	38	23	1
21488	Nanotechnology	200403	13	0	0	0	6	5	0	0	103	63	3	50	26	1
21488	Nanotechnology	200404	18	1	0	0	13	6	1	0	121	75	4	57	31	1
21488	Nanotechnology	200405	18	0	0	0	8	3	0	0	139	81	4	64	33	1
21488	Nanotechnology	200406	17	4	0	0	12	5	4	0	156	91	8	72	36	1
21488	Nanotechnology	200407	10	2	0	0	7	3	2	0	166	96	10	75	37	1
21488	Nanotechnology	200408	7	0	0	0	6	4	0	0	173	102	10	80	41	1
21488	Nanotechnology	200409	25	1	0	0	19	7	1	0	198	121	11	88	48	1
21488	Nanotechnology	200410	12	0	0	0	9	3	0	0	210	130	11	91	51	1
21488	Nanotechnology	200411	17	0	0	0	13	4	0	0	227	142	11	96	54	1
21488	Nanotechnology	200412	19	0	0	0	10	5	0	0	246	152	11	105	59	1
21488	Nanotechnology	200501	23	2	0	0	15	7	2	0	269	164	13	119	64	1
21488	Nanotechnology	200502	21	1	0	0	12	6	1	0	290	175	14	126	69	1
21488	Nanotechnology	200503	10	0	0	0	9	4	0	0	300	184	14	130	73	1
21488	Nanotechnology	200504	34	3	0	0	29	10	3	0	334	208	17	142	80	1
21488	Nanotechnology	200505	45	4	0	0	26	10	2	0	379	232	21	160	88	1
21488	Nanotechnology	200506	29	1	0	0	22	8	1	0	408	253	22	170	96	1
21488	Nanotechnology	200507	32	3	0	0	26	10	3	0	440	274	25	183	102	1
21488	Nanotechnology	200508	57	3	0	0	34	15	2	0	497	304	28	208	114	1
21488	Nanotechnology	200509	65	3	0	0	40	14	3	0	562	344	31	224	128	1
21488	Nanotechnology	200510	48	6	0	0	36	12	5	0	610	374	37	239	135	1
21488	Nanotechnology	200511	86	14	2	1	50	23	9	2	696	416	51	282	151	2
21488	Nanotechnology	200512	81	11	0	0	39	12	8	0	777	450	62	299	158	2
21488	Nanotechnology	200601	88	12	0	0	43	17	6	0	865	489	74	329	171	3
21488	Nanotechnology	200602	86	22	4	3	50	22	15	2	951	534	96	360	190	4
21488	Nanotechnology	200603	51	7	0	0	38	15	4	0	1002	567	103	381	201	5
21488	Nanotechnology	200604	112	21	0	0	70	27	14	0	1114	626	124	425	217	5
21488	Nanotechnology	200605	80	8	0	0	48	15	6	0	1194	665	132	467	224	5
21488	Nanotechnology	200606	64	6	0	0	42	17	4	0	1258	703	138	494	238	8
21488	Nanotechnology	200607	116	16	0	0	55	21	9	0	1374	750	154	541	252	12
21488	Nanotechnology	200608	87	21	0	0	54	24	13	0	1461	799	175	589	272	19
21488	Nanotechnology	200609	103	13	0	0	61	27	12	0	1564	848	188	638	291	23
21488	Nanotechnology	200610	161	26	0	0	83	39	22	0	1725	919	214	734	321	27
21488	Nanotechnology	200611	274	72	3	1	108	43	31	2	1999	1015	286	833	354	37
21488	Nanotechnology	200612	189	41	1	0	88	39	25	1	2188	1090	327	922	383	43
21488	Nanotechnology	200701	149	36	6	5	75	34	19	2	2337	1153	363	984	406	49
21488	Nanotechnology	200702	155	37	6	4	94	48	24	3	2492	1235	400	1074	444	63
21488	Nanotechnology	200703	171	39	2	0	101	53	30	2	2663	1320	439	1154	487	74
21488	Nanotechnology	200704	159	32	0	0	79	33	23	0	2822	1385	471	1232	510	77
21488	Nanotechnology	200705	55	11	0	0	43	17	8	0	2877	1422	482	1257	521	77
21488	Nanotechnology	200706	109	31	1	0	59	24	21	1	2986	1473	513	1297	537	82
21488	Nanotechnology	200707	68	16	0	0	41	20	13	0	3054	1510	529	1330	553	85
21488	Nanotechnology	200708	65	8	0	0	40	14	8	0	3119	1548	537	1348	565	86
21488	Nanotechnology	200709	52	10	0	0	33	17	9	0	3171	1575	547	1373	577	87
21488	Nanotechnology	200710	107	34	3	2	64	33	23	2	3278	1627	581	1421	598	93
21488	Nanotechnology	200711	148	41	0	0	87	32	25	0	3426	1701	622	1481	617	96
21488	Nanotechnology	200712	153	47	2	0	82	41	30	2	3579	1769	669	1555	645	101
21488	Nanotechnology	200801	97	20	1	0	56	28	14	1	3676	1817	689	1603	666	103
21488	Nanotechnology	200802	153	58	2	0	78	35	28	2	3829	1881	747	1677	689	111
21488	Nanotechnology	200803	92	34	0	0	65	34	23	0	3921	1931	781	1728	710	117
21488	Nanotechnology	200804	99	30	0	0	66	27	20	0	4020	1988	811	1771	729	121
21488	Nanotechnology	200805	127	31	0	0	71	34	22	0	4147	2046	842	1840	751	125
21488	Nanotechnology	200806	105	30	1	0	66	37	23	1	4252	2106	872	1888	782	130
21488	Nanotechnology	200807	60	8	0	0	34	16	8	0	4312	2131	880	1925	790	130
21488	Nanotechnology	200808	72	24	0	0	40	15	14	0	4384	2165	904	1951	799	130
21488	Nanotechnology	200809	52	15	0	0	30	13	9	0	4436	2188	919	1976	805	131
21488	Nanotechnology	200810	85	26	1	0	49	22	16	1	4521	2227	945	2008	817	133
21488	Nanotechnology	200811	96	30	0	0	58	29	22	0	4617	2275	975	2051	836	136
21488	Nanotechnology	200812	88	21	0	0	51	22	15	0	4705	2318	996	2084	852	138
21488	Nanotechnology	200901	82	20	3	1	49	24	13	3	4787	2358	1016	2124	870	144
21488	Nanotechnology	200902	55	14	0	0	42	19	12	0	4842	2393	1030	2146	883	145
21488	Nanotechnology	200903	91	29	2	0	48	21	19	2	4933	2430	1059	2181	894	150
21488	Nanotechnology	200904	94	26	0	0	64	35	20	0	5027	2481	1085	2229	917	153
21488	Nanotechnology	200905	81	25	0	0	51	25	15	0	5108	2525	1110	2265	935	157
21488	Nanotechnology	200906	86	24	0	0	45	20	13	0	5194	2561	1134	2308	946	158
21488	Nanotechnology	200907	46	9	0	0	33	15	8	0	5240	2587	1143	2327	954	159
21488	Nanotechnology	200908	45	4	0	0	30	12	4	0	5285	2614	1147	2347	963	159
21488	Nanotechnology	200909	48	11	0	0	31	18	9	0	5333	2638	1158	2373	975	161
21488	Nanotechnology	200910	70	21	0	0	41	19	12	0	5403	2672	1179	2405	987	162
21488	Nanotechnology	200911	90	17	0	0	34	17	11	0	5493	2702	1196	2465	1001	163
21488	Nanotechnology	200912	49	14	0	0	30	15	6	0	5542	2727	1210	2495	1011	164
21488	Nanotechnology	201001	2	0	0	0	2	2	0	0	5544	2727	1210	2497	1011	164
21488	Nanotechnology	201002	3	0	0	0	2	2	0	0	5547	2728	1210	2500	1012	164
21488	Nanotechnology	201003	40	8	0	0	28	20	3	0	5587	2752	1218	2531	1028	166
21488	Nanotechnology	201004	39	11	0	0	24	14	9	0	5626	2768	1229	2553	1035	168
21488	Nanotechnology	201005	33	11	0	0	19	11	4	0	5659	2780	1240	2576	1039	172
21488	Nanotechnology	201006	33	7	0	0	28	15	6	0	5692	2801	1247	2594	1047	172
21488	Nanotechnology	201007	37	9	0	0	25	13	5	0	5729	2819	1256	2616	1055	173
21488	Nanotechnology	201008	27	6	0	0	20	12	4	0	5756	2833	1262	2633	1061	175
21488	Nanotechnology	201009	28	8	0	0	13	8	3	0	5784	2843	1270	2646	1066	175
21488	Nanotechnology	201010	38	16	3	1	24	13	11	3	5822	2862	1286	2665	1075	177
21488	Nanotechnology	201011	3	0	0	0	3	3	0	0	5825	2864	1286	2668	1077	177
21488	Nanotechnology	201012	13	2	0	0	9	9	2	0	5838	2873	1288	2681	1086	179
21488	Nanotechnology	201101	18	3	0	0	15	9	3	0	5856	2884	1291	2692	1091	179
21488	Nanotechnology	201102	50	17	2	0	28	16	7	1	5906	2904	1308	2727	1100	183
21488	Nanotechnology	201103	35	12	0	0	22	11	6	0	5941	2921	1320	2747	1106	185
21488	Nanotechnology	201104	24	11	0	0	20	8	7	0	5965	2936	1331	2759	1109	185
21488	Nanotechnology	201105	49	17	0	0	27	15	10	0	6014	2955	1348	2790	1116	189
21488	Nanotechnology	201106	36	6	0	0	16	11	4	0	6050	2965	1354	2817	1121	190
21488	Nanotechnology	201107	23	6	0	0	14	7	3	0	6073	2973	1360	2831	1124	190
21488	Nanotechnology	201108	18	5	0	0	13	8	4	0	6091	2980	1365	2843	1126	190
21488	Nanotechnology	201109	18	4	0	0	12	7	3	0	6109	2987	1369	2853	1128	190
21488	Nanotechnology	201110	5	0	0	0	3	3	0	0	6114	2989	1369	2858	1130	190
21488	Nanotechnology	201111	3	0	0	0	2	2	0	0	6117	2990	1369	2861	1131	190
21488	Nanotechnology	201112	18	2	0	0	11	11	2	0	6135	2995	1371	2879	1136	192
21488	Nanotechnology	201201	9	1	0	0	6	6	1	0	6144	2997	1372	2888	1138	193
21488	Nanotechnology	201202	3	1	0	0	3	3	1	0	6147	2997	1373	2891	1138	194
21488	Nanotechnology	201203	4	0	0	0	3	3	0	0	6151	2998	1373	2895	1139	194
21488	Nanotechnology	201204	1	0	0	0	1	1	0	0	6152	2999	1373	2896	1140	194
21488	Nanotechnology	201205	13	3	0	0	8	8	2	0	6165	3004	1376	2909	1145	197
21488	Nanotechnology	201206	5	0	0	0	3	3	0	0	6170	3005	1376	2914	1146	197
21488	Nanotechnology	201207	9	1	0	0	6	6	1	0	6179	3010	1377	2923	1151	198
21488	Nanotechnology	201208	7	0	0	0	4	4	0	0	6186	3010	1377	2930	1151	198
21488	Nanotechnology	201209	12	0	0	0	11	11	0	0	6198	3017	1377	2942	1158	198
21488	Nanotechnology	201210	19	6	0	0	16	9	6	0	6217	3030	1383	2951	1164	199
21488	Nanotechnology	201211	51	11	0	0	21	11	8	0	6268	3044	1394	2991	1168	201
21488	Nanotechnology	201212	28	10	0	0	18	10	6	0	6296	3057	1404	3009	1173	205
21488	Nanotechnology	201301	6	2	0	0	4	4	2	0	6302	3059	1406	3015	1175	207
21488	Nanotechnology	201302	2	0	0	0	1	1	0	0	6304	3060	1406	3017	1176	207
21488	Nanotechnology	201303	13	0	0	0	7	7	0	0	6317	3066	1406	3030	1182	207
21488	Nanotechnology	201304	31	9	0	0	19	12	5	0	6348	3079	1415	3053	1188	211
21488	Nanotechnology	201305	44	16	2	0	15	12	8	1	6392	3089	1431	3073	1195	213
21488	Nanotechnology	201306	3	0	0	0	1	1	0	0	6395	3090	1431	3076	1196	213
21488	Nanotechnology	201307	5	1	0	0	5	5	1	0	6400	3094	1432	3081	1200	214
21488	Nanotechnology	201310	6	0	0	0	5	5	0	0	6406	3096	1432	3087	1202	214
21488	Nanotechnology	201311	3	1	0	0	3	3	1	0	6409	3096	1433	3090	1202	215
21488	Nanotechnology	201312	4	0	0	0	2	2	0	0	6413	3098	1433	3094	1204	215
21488	Nanotechnology	201401	6	1	0	0	2	2	1	0	6419	3099	1434	3100	1205	216
21488	Nanotechnology	201402	4	0	0	0	3	3	0	0	6423	3101	1434	3104	1207	216
21488	Nanotechnology	201403	2	0	0	0	1	1	0	0	6425	3101	1434	3106	1207	216
21488	Nanotechnology	201404	6	1	0	0	6	6	1	0	6431	3105	1435	3112	1211	217
21488	Nanotechnology	201405	15	5	0	0	11	7	4	0	6446	3113	1440	3121	1215	218
21488	Nanotechnology	201406	15	6	0	0	9	6	3	0	6461	3119	1446	3133	1218	221
21488	Nanotechnology	201407	8	3	0	0	7	5	3	0	6469	3122	1449	3139	1219	223
21488	Nanotechnology	201408	3	1	0	0	3	3	1	0	6472	3123	1450	3142	1220	224
21488	Nanotechnology	201409	31	12	0	0	23	11	7	0	6503	3141	1462	3160	1226	227
21488	Nanotechnology	201410	27	9	0	0	15	7	5	0	6530	3152	1471	3172	1229	228
21488	Nanotechnology	201411	32	15	1	0	22	10	9	1	6562	3168	1486	3189	1233	232
21488	Nanotechnology	201412	16	3	0	0	13	9	2	0	6578	3175	1489	3201	1236	233
21488	Nanotechnology	201501	12	1	0	0	9	5	1	0	6590	3181	1490	3208	1238	233
21488	Nanotechnology	201502	11	3	0	0	10	7	3	0	6601	3189	1493	3216	1243	234
21488	Nanotechnology	201503	22	8	0	0	13	7	4	0	6623	3200	1501	3228	1248	236
21488	Nanotechnology	201504	38	10	0	0	16	11	4	0	6661	3212	1511	3257	1255	244
21488	Nanotechnology	201505	23	10	1	0	13	10	7	1	6684	3220	1521	3272	1260	246
21488	Nanotechnology	201506	19	5	0	0	13	8	4	0	6703	3230	1526	3282	1265	246
21488	Nanotechnology	201507	17	5	0	0	14	8	5	0	6720	3239	1531	3291	1268	248
21488	Nanotechnology	201508	12	3	0	0	9	7	2	0	6732	3245	1534	3301	1272	249
21488	Nanotechnology	201509	26	8	0	0	16	9	5	0	6758	3257	1542	3316	1276	250
21488	Nanotechnology	201510	32	9	0	0	22	12	7	0	6790	3274	1551	3332	1282	252
21488	Nanotechnology	201511	21	7	0	0	15	11	4	0	6811	3285	1558	3348	1289	254
21488	Nanotechnology	201512	12	3	0	0	6	3	1	0	6823	3289	1561	3355	1291	255
21488	Nanotechnology	201601	7	1	0	0	5	4	1	0	6830	3291	1562	3361	1292	255
21488	Nanotechnology	201602	6	0	0	0	2	2	0	0	6836	3292	1562	3367	1293	255
21488	Nanotechnology	201603	1	0	0	0	1	1	0	0	6837	3293	1562	3368	1294	255
21488	Nanotechnology	201604	2	0	0	0	1	1	0	0	6839	3294	1562	3370	1295	255
21488	Nanotechnology	201605	1	0	0	0	1	1	0	0	6840	3295	1562	3371	1296	255
21488	Nanotechnology	201606	1	0	0	0	1	1	0	0	6841	3295	1562	3372	1296	255
21488	Nanotechnology	201608	2	0	0	0	1	1	0	0	6843	3296	1562	3374	1297	255
21488	Nanotechnology	201609	7	1	0	0	5	5	1	0	6850	3299	1563	3381	1300	256
21488	Nanotechnology	201611	6	0	0	0	5	5	0	0	6856	3303	1563	3387	1304	256
21488	Nanotechnology	201701	2	0	0	0	2	2	0	0	6858	3305	1563	3389	1306	256
21488	Nanotechnology	201702	1	0	0	0	1	1	0	0	6859	3305	1563	3390	1306	256
21488	Nanotechnology	201703	6	0	0	0	3	3	0	0	6865	3308	1563	3396	1309	256
21488	Nanotechnology	201705	4	1	0	0	3	3	1	0	6869	3309	1564	3400	1310	257
21488	Nanotechnology	201706	2	0	0	0	2	2	0	0	6871	3310	1564	3402	1311	257
21488	Nanotechnology	201707	2	0	0	0	2	2	0	0	6873	3311	1564	3404	1312	257
21488	Nanotechnology	201708	2	0	0	0	2	2	0	0	6875	3312	1564	3406	1313	257
21488	Nanotechnology	201709	7	1	0	0	4	4	1	0	6882	3316	1565	3413	1317	258
21488	Nanotechnology	201710	2	0	0	0	2	2	0	0	6884	3318	1565	3415	1319	258
21488	Nanotechnology	201711	9	0	0	0	5	5	0	0	6893	3323	1565	3424	1324	258
21488	Nanotechnology	201712	2	0	0	0	2	2	0	0	6895	3324	1565	3426	1325	258
21488	Nanotechnology	201801	3	1	0	0	3	3	1	0	6898	3326	1566	3429	1327	259
21488	Nanotechnology	201802	4	0	0	0	3	3	0	0	6902	3328	1566	3433	1329	259
21488	Nanotechnology	201803	2	0	0	0	2	2	0	0	6904	3328	1566	3435	1329	259
21488	Nanotechnology	201804	4	1	0	0	4	4	1	0	6908	3330	1567	3439	1331	260
21488	Nanotechnology	201805	5	0	0	0	5	5	0	0	6913	3333	1567	3444	1334	260
21488	Nanotechnology	201806	3	0	0	0	3	3	0	0	6916	3336	1567	3447	1337	260
21488	Nanotechnology	201807	3	0	0	0	3	3	0	0	6919	3337	1567	3450	1338	260
29194241	Network_Automation	201111	11	1	0	0	4	4	1	0	11	4	1	11	4	1
29194241	Network_Automation	201201	6	0	0	0	2	2	0	0	17	4	1	17	4	1
29194241	Network_Automation	201204	1	0	0	0	1	1	0	0	18	5	1	18	5	1
29194241	Network_Automation	201208	1	0	0	0	1	1	0	0	19	6	1	19	6	1
29194241	Network_Automation	201303	1	0	0	0	1	1	0	0	20	7	1	20	7	1
29194241	Network_Automation	201305	7	0	0	0	1	1	0	0	27	7	1	27	7	1
29194241	Network_Automation	201502	3	0	0	0	1	1	0	0	30	7	1	30	7	1
29194241	Network_Automation	201503	1	0	0	0	1	1	0	0	31	8	1	31	8	1
29194241	Network_Automation	201504	3	0	0	0	2	2	0	0	34	9	1	34	9	1
29194241	Network_Automation	201505	2	0	0	0	2	2	0	0	36	10	1	36	10	1
29194241	Network_Automation	201511	1	0	0	0	1	1	0	0	37	10	1	37	10	1
29194241	Network_Automation	201605	1	0	0	0	1	1	0	0	38	11	1	38	11	1
29194241	Network_Automation	201610	1	0	0	0	1	1	0	0	39	12	1	39	12	1
29194241	Network_Automation	201704	1	0	0	0	1	1	0	0	40	13	1	40	13	1
29194241	Network_Automation	201706	1	0	0	0	1	1	0	0	41	14	1	41	14	1
29194241	Network_Automation	201711	1	0	0	0	1	1	0	0	42	14	1	42	14	1
29194241	Network_Automation	201803	1	0	0	0	1	1	0	0	43	15	1	43	15	1
51252	Network_File_System	200206	1	0	0	0	1	1	0	0	1	1	0	1	1	0
51252	Network_File_System	200209	1	0	0	0	1	0	0	0	2	2	0	1	1	0
51252	Network_File_System	200312	1	0	0	0	1	1	0	0	3	3	0	2	2	0
51252	Network_File_System	200401	4	0	0	0	3	3	0	0	7	6	0	6	5	0
51252	Network_File_System	200402	4	0	0	0	2	2	0	0	11	7	0	10	6	0
51252	Network_File_System	200403	7	0	0	0	6	6	0	0	18	12	0	17	11	0
51252	Network_File_System	200404	2	0	0	0	2	1	0	0	20	14	0	18	12	0
51252	Network_File_System	200405	2	0	0	0	2	1	0	0	22	16	0	19	13	0
51252	Network_File_System	200406	1	0	0	0	1	1	0	0	23	17	0	20	14	0
51252	Network_File_System	200407	2	0	0	0	2	2	0	0	25	19	0	22	16	0
51252	Network_File_System	200408	3	0	0	0	3	2	0	0	28	21	0	24	17	0
51252	Network_File_System	200409	3	0	0	0	3	2	0	0	31	24	0	26	19	0
51252	Network_File_System	200410	1	0	0	0	1	1	0	0	32	25	0	27	20	0
51252	Network_File_System	200411	3	0	0	0	3	3	0	0	35	28	0	30	23	0
51252	Network_File_System	200412	7	2	0	0	6	5	1	0	42	33	2	36	27	2
51252	Network_File_System	200501	3	0	0	0	2	1	0	0	45	34	2	37	27	2
51252	Network_File_System	200502	6	0	0	0	3	1	0	0	51	37	2	38	28	2
51252	Network_File_System	200503	4	1	0	0	3	2	1	0	55	40	3	41	30	2
51252	Network_File_System	200504	2	0	0	0	2	2	0	0	57	42	3	43	32	2
51252	Network_File_System	200505	2	0	0	0	2	2	0	0	59	44	3	45	34	2
51252	Network_File_System	200506	1	0	0	0	1	1	0	0	60	45	3	46	35	2
51252	Network_File_System	200507	4	1	0	0	4	2	1	0	64	48	4	48	37	2
51252	Network_File_System	200508	4	0	0	0	3	2	0	0	68	51	4	51	39	2
51252	Network_File_System	200509	6	0	0	0	3	1	0	0	74	53	4	53	39	2
51252	Network_File_System	200510	3	0	0	0	3	2	0	0	77	56	4	55	41	2
51252	Network_File_System	200511	23	1	0	0	3	2	1	0	100	59	5	77	43	2
51252	Network_File_System	200512	4	0	0	0	4	4	0	0	104	63	5	81	47	2
51252	Network_File_System	200601	3	0	0	0	2	0	0	0	107	65	5	81	47	2
51252	Network_File_System	200602	10	1	0	0	5	3	1	0	117	70	6	89	50	2
51252	Network_File_System	200603	4	1	0	0	4	3	1	0	121	72	7	92	51	3
51252	Network_File_System	200604	7	1	0	0	7	4	1	0	128	78	8	96	54	3
51252	Network_File_System	200605	13	1	0	0	5	4	1	0	141	81	9	108	56	3
51252	Network_File_System	200606	1	0	0	0	1	0	0	0	142	82	9	108	56	3
51252	Network_File_System	200607	6	0	0	0	3	2	0	0	148	85	9	110	58	3
51252	Network_File_System	200608	10	0	0	0	7	5	0	0	158	90	9	118	61	3
51252	Network_File_System	200609	1	0	0	0	1	1	0	0	159	91	9	119	62	3
51252	Network_File_System	200610	6	1	0	0	6	5	1	0	165	97	10	124	67	3
51252	Network_File_System	200611	16	1	0	0	11	8	1	0	181	104	11	132	72	3
51252	Network_File_System	200612	7	0	0	0	7	6	0	0	188	110	11	138	77	3
51252	Network_File_System	200701	5	2	0	0	4	2	1	0	193	113	13	141	78	3
51252	Network_File_System	200702	8	0	0	0	7	6	0	0	201	119	13	148	83	3
51252	Network_File_System	200703	9	0	0	0	4	3	0	0	210	122	13	156	85	3
51252	Network_File_System	200704	9	3	0	0	8	4	3	0	219	128	16	161	87	3
51252	Network_File_System	200705	3	0	0	0	3	2	0	0	222	130	16	163	88	3
51252	Network_File_System	200706	4	1	0	0	4	2	1	0	226	133	17	165	89	3
51252	Network_File_System	200707	1	0	0	0	1	1	0	0	227	134	17	166	90	3
51252	Network_File_System	200708	1	0	0	0	1	1	0	0	228	135	17	167	91	3
51252	Network_File_System	200709	5	0	0	0	4	1	0	0	233	138	17	168	91	3
51252	Network_File_System	200710	1	0	0	0	1	1	0	0	234	139	17	169	92	3
51252	Network_File_System	200711	6	0	0	0	5	3	0	0	240	142	17	172	93	3
51252	Network_File_System	200712	4	1	0	0	4	3	1	0	244	145	18	175	95	3
51252	Network_File_System	200801	4	1	0	0	4	3	1	0	248	149	19	178	98	3
51252	Network_File_System	200802	1	0	0	0	1	1	0	0	249	150	19	179	99	3
51252	Network_File_System	200803	3	1	0	0	3	2	1	0	252	152	20	181	100	3
51252	Network_File_System	200804	7	0	0	0	6	4	0	0	259	154	20	186	100	3
51252	Network_File_System	200805	7	3	0	0	5	4	2	0	266	158	23	192	103	5
51252	Network_File_System	200806	6	2	0	0	5	2	1	0	272	162	25	195	104	5
51252	Network_File_System	200807	4	2	0	0	4	2	2	0	276	165	27	197	105	5
51252	Network_File_System	200808	3	1	0	0	3	3	1	0	279	168	28	200	108	6
51252	Network_File_System	200809	7	1	0	0	3	2	1	0	286	170	29	202	109	6
51252	Network_File_System	200810	1	0	0	0	1	1	0	0	287	171	29	203	110	6
51252	Network_File_System	200811	9	1	0	0	8	6	1	0	296	176	30	209	113	6
51252	Network_File_System	200812	2	0	0	0	2	0	0	0	298	178	30	209	113	6
51252	Network_File_System	200901	6	1	0	0	6	3	1	0	304	183	31	212	115	6
51252	Network_File_System	200902	2	0	0	0	2	1	0	0	306	184	31	213	115	6
51252	Network_File_System	200903	6	1	0	0	6	5	1	0	312	188	32	218	118	6
51252	Network_File_System	200905	3	0	0	0	3	3	0	0	315	190	32	221	120	6
51252	Network_File_System	200906	3	1	0	0	3	2	1	0	318	193	33	223	122	6
51252	Network_File_System	200907	5	1	0	0	4	1	1	0	323	196	34	224	122	6
51252	Network_File_System	200909	1	0	0	0	1	1	0	0	324	197	34	225	123	6
51252	Network_File_System	200910	1	0	0	0	1	0	0	0	325	198	34	225	123	6
51252	Network_File_System	200912	2	1	0	0	2	1	1	0	327	199	35	226	123	6
51252	Network_File_System	201001	4	0	0	0	4	4	0	0	331	201	35	230	125	6
51252	Network_File_System	201002	10	1	0	0	8	3	1	0	341	208	36	235	127	6
51252	Network_File_System	201003	4	0	0	0	4	2	0	0	345	212	36	237	129	6
51252	Network_File_System	201004	1	0	0	0	1	1	0	0	346	213	36	238	130	6
51252	Network_File_System	201005	2	0	0	0	2	0	0	0	348	215	36	238	130	6
51252	Network_File_System	201006	1	0	0	0	1	1	0	0	349	216	36	239	131	6
51252	Network_File_System	201007	5	1	0	0	5	4	1	0	354	220	37	243	134	6
51252	Network_File_System	201008	2	0	0	0	2	2	0	0	356	221	37	245	135	6
51252	Network_File_System	201009	5	0	0	0	4	3	0	0	361	225	37	249	138	6
51252	Network_File_System	201010	2	0	0	0	2	1	0	0	363	227	37	250	139	6
51252	Network_File_System	201012	2	0	0	0	2	2	0	0	365	228	37	252	140	6
51252	Network_File_System	201101	3	0	0	0	2	1	0	0	368	229	37	253	140	6
51252	Network_File_System	201102	2	0	0	0	2	2	0	0	370	231	37	255	142	6
51252	Network_File_System	201103	4	1	0	0	3	1	1	0	374	234	38	256	143	6
51252	Network_File_System	201104	1	0	0	0	1	0	0	0	375	235	38	256	143	6
51252	Network_File_System	201106	1	0	0	0	1	1	0	0	376	236	38	257	144	6
51252	Network_File_System	201107	2	0	0	0	2	2	0	0	378	238	38	259	146	6
51252	Network_File_System	201108	2	0	0	0	2	2	0	0	380	240	38	261	148	6
51252	Network_File_System	201109	7	0	0	0	2	1	0	0	387	242	38	267	149	6
51252	Network_File_System	201112	1	0	0	0	1	1	0	0	388	243	38	268	150	6
51252	Network_File_System	201201	1	0	0	0	1	0	0	0	389	244	38	268	150	6
51252	Network_File_System	201202	3	0	0	0	2	1	0	0	392	246	38	270	151	6
51252	Network_File_System	201203	4	1	0	0	3	1	1	0	396	249	39	271	152	6
51252	Network_File_System	201204	3	1	0	0	3	2	1	0	399	251	40	273	153	6
51252	Network_File_System	201205	3	1	0	0	3	2	1	0	402	254	41	275	155	6
51252	Network_File_System	201207	5	2	0	0	5	3	2	0	407	258	43	278	157	6
51252	Network_File_System	201208	1	0	0	0	1	1	0	0	408	258	43	279	157	6
51252	Network_File_System	201209	1	0	0	0	1	1	0	0	409	259	43	280	158	6
51252	Network_File_System	201210	1	0	0	0	1	1	0	0	410	259	43	281	158	6
51252	Network_File_System	201211	4	0	0	0	2	0	0	0	414	261	43	281	158	6
51252	Network_File_System	201212	1	0	0	0	1	1	0	0	415	262	43	282	159	6
51252	Network_File_System	201301	2	1	0	0	2	1	1	0	417	264	44	283	160	6
51252	Network_File_System	201302	1	0	0	0	1	1	0	0	418	264	44	284	160	6
51252	Network_File_System	201305	6	0	0	0	5	4	0	0	424	269	44	288	164	6
51252	Network_File_System	201306	3	1	0	0	3	2	1	0	427	272	45	290	166	6
51252	Network_File_System	201307	4	2	0	0	4	2	2	0	431	276	47	292	168	6
51252	Network_File_System	201308	2	0	0	0	1	0	0	0	433	277	47	292	168	6
51252	Network_File_System	201309	15	3	0	0	6	4	2	0	448	282	50	302	171	6
51252	Network_File_System	201310	3	0	0	0	3	1	0	0	451	285	50	303	171	6
51252	Network_File_System	201311	3	0	0	0	3	2	0	0	454	288	50	305	173	6
51252	Network_File_System	201312	5	0	0	0	2	2	0	0	459	290	50	310	175	6
51252	Network_File_System	201401	6	0	0	0	5	4	0	0	465	292	50	315	177	6
51252	Network_File_System	201402	14	0	0	0	4	4	0	0	479	295	50	329	180	6
51252	Network_File_System	201403	2	1	0	0	2	1	1	0	481	296	51	330	180	6
51252	Network_File_System	201405	1	0	0	0	1	0	0	0	482	297	51	330	180	6
51252	Network_File_System	201406	6	1	0	0	5	4	1	0	488	299	52	335	180	6
51252	Network_File_System	201409	4	0	0	0	4	3	0	0	492	301	52	338	181	6
51252	Network_File_System	201410	1	0	0	0	1	0	0	0	493	302	52	338	181	6
51252	Network_File_System	201411	5	0	0	0	2	2	0	0	498	303	52	343	182	6
51252	Network_File_System	201502	2	0	0	0	2	2	0	0	500	304	52	345	183	6
51252	Network_File_System	201503	2	1	0	0	2	1	1	0	502	305	53	346	183	6
51252	Network_File_System	201504	3	0	0	0	3	2	0	0	505	308	53	348	185	6
51252	Network_File_System	201505	1	0	0	0	1	1	0	0	506	309	53	349	186	6
51252	Network_File_System	201506	6	1	0	0	4	3	1	0	512	311	54	354	187	6
51252	Network_File_System	201507	2	0	0	0	2	1	0	0	514	313	54	355	188	6
51252	Network_File_System	201508	3	0	0	0	2	1	0	0	517	314	54	356	188	6
51252	Network_File_System	201509	4	1	0	0	3	2	1	0	521	316	55	359	189	6
51252	Network_File_System	201510	2	1	0	0	2	1	1	0	523	317	56	360	189	7
51252	Network_File_System	201511	2	1	0	0	2	1	1	0	525	318	57	361	189	7
51252	Network_File_System	201512	6	0	0	0	5	4	0	0	531	322	57	366	192	7
51252	Network_File_System	201601	2	0	0	0	2	2	0	0	533	323	57	368	193	7
51252	Network_File_System	201604	1	0	0	0	1	1	0	0	534	324	57	369	194	7
51252	Network_File_System	201605	3	1	0	0	3	2	1	0	537	327	58	371	196	8
51252	Network_File_System	201606	3	1	0	0	3	2	1	0	540	329	59	373	197	8
51252	Network_File_System	201607	6	0	0	0	4	2	0	0	546	332	59	376	198	8
51252	Network_File_System	201608	2	1	0	0	2	1	1	0	548	333	60	377	198	8
51252	Network_File_System	201609	4	1	0	0	3	1	1	0	552	336	61	378	199	8
51252	Network_File_System	201701	10	1	0	0	5	5	1	0	562	338	62	388	201	8
51252	Network_File_System	201702	5	1	0	0	4	3	1	0	567	341	63	392	203	8
51252	Network_File_System	201703	2	0	0	0	2	2	0	0	569	343	63	394	205	8
51252	Network_File_System	201704	3	1	0	0	3	2	1	0	572	344	64	396	205	8
51252	Network_File_System	201705	1	0	0	0	1	0	0	0	573	345	64	396	205	8
51252	Network_File_System	201706	1	0	0	0	1	0	0	0	574	346	64	396	205	8
51252	Network_File_System	201707	3	1	0	0	3	2	1	0	577	349	65	398	206	8
51252	Network_File_System	201709	2	0	0	0	2	1	0	0	579	350	65	399	206	8
51252	Network_File_System	201710	2	1	0	0	2	1	1	0	581	351	66	400	206	8
51252	Network_File_System	201711	2	0	0	0	1	0	0	0	583	352	66	400	206	8
51252	Network_File_System	201801	3	1	0	0	3	1	1	0	586	355	67	401	207	8
51252	Network_File_System	201802	1	0	0	0	1	1	0	0	587	356	67	402	207	8
51252	Network_File_System	201806	1	0	0	0	1	1	0	0	588	357	67	403	208	8
51252	Network_File_System	201807	2	0	0	0	2	1	0	0	590	359	67	404	209	8
159886	Network_Time_Protocol	200301	3	0	0	0	1	1	0	0	3	1	0	3	1	0
159886	Network_Time_Protocol	200304	9	0	0	0	3	2	0	0	12	3	0	10	2	0
159886	Network_Time_Protocol	200309	1	0	0	0	1	0	0	0	13	4	0	10	2	0
159886	Network_Time_Protocol	200310	3	0	0	0	1	1	0	0	16	5	0	13	3	0
159886	Network_Time_Protocol	200311	1	0	0	0	1	0	0	0	17	6	0	13	3	0
159886	Network_Time_Protocol	200312	2	0	0	0	2	1	0	0	19	8	0	14	4	0
159886	Network_Time_Protocol	200401	1	0	0	0	1	1	0	0	20	9	0	15	5	0
159886	Network_Time_Protocol	200402	2	0	0	0	2	2	0	0	22	11	0	17	7	0
159886	Network_Time_Protocol	200404	4	0	0	0	3	3	0	0	26	13	0	21	9	0
159886	Network_Time_Protocol	200406	6	0	0	0	3	3	0	0	32	15	0	27	11	0
159886	Network_Time_Protocol	200407	8	0	0	0	4	3	0	0	40	19	0	30	14	0
159886	Network_Time_Protocol	200408	5	0	0	0	4	1	0	0	45	23	0	32	15	0
159886	Network_Time_Protocol	200409	1	0	0	0	1	1	0	0	46	23	0	33	15	0
159886	Network_Time_Protocol	200410	1	0	0	0	1	0	0	0	47	24	0	33	15	0
159886	Network_Time_Protocol	200411	4	0	0	0	4	3	0	0	51	28	0	36	18	0
159886	Network_Time_Protocol	200412	5	0	0	0	2	2	0	0	56	30	0	41	20	0
159886	Network_Time_Protocol	200501	3	0	0	0	3	3	0	0	59	33	0	44	23	0
159886	Network_Time_Protocol	200502	1	0	0	0	1	0	0	0	60	34	0	44	23	0
159886	Network_Time_Protocol	200504	3	0	0	0	3	2	0	0	63	37	0	46	25	0
159886	Network_Time_Protocol	200505	9	0	0	0	9	3	0	0	72	46	0	49	28	0
159886	Network_Time_Protocol	200506	2	0	0	0	2	1	0	0	74	48	0	50	29	0
159886	Network_Time_Protocol	200507	4	0	0	0	2	2	0	0	78	50	0	54	31	0
159886	Network_Time_Protocol	200508	9	0	0	0	6	2	0	0	87	56	0	56	33	0
159886	Network_Time_Protocol	200509	9	1	0	0	8	5	1	0	96	63	1	62	37	0
159886	Network_Time_Protocol	200510	5	0	0	0	2	0	0	0	101	65	1	62	37	0
159886	Network_Time_Protocol	200511	16	0	0	0	7	2	0	0	117	71	1	64	39	0
159886	Network_Time_Protocol	200512	10	0	0	0	8	1	0	0	127	78	1	65	40	0
159886	Network_Time_Protocol	200601	4	0	0	0	4	1	0	0	131	82	1	66	41	0
159886	Network_Time_Protocol	200602	11	0	0	0	8	5	0	0	142	88	1	73	45	0
159886	Network_Time_Protocol	200603	2	1	0	0	2	2	1	0	144	89	2	75	46	1
159886	Network_Time_Protocol	200604	10	0	0	0	8	5	0	0	154	95	2	81	50	1
159886	Network_Time_Protocol	200605	26	0	0	0	15	9	0	0	180	107	2	100	56	1
159886	Network_Time_Protocol	200606	16	1	0	0	10	4	1	0	196	116	3	106	59	1
159886	Network_Time_Protocol	200607	5	0	0	0	5	2	0	0	201	121	3	108	61	1
159886	Network_Time_Protocol	200608	10	1	0	0	9	4	1	0	211	127	4	113	63	1
159886	Network_Time_Protocol	200609	4	0	0	0	4	3	0	0	215	131	4	116	66	1
159886	Network_Time_Protocol	200610	1	0	0	0	1	1	0	0	216	132	4	117	67	1
159886	Network_Time_Protocol	200611	7	0	0	0	4	2	0	0	223	135	4	121	69	1
159886	Network_Time_Protocol	200612	5	0	0	0	4	3	0	0	228	139	4	125	72	1
159886	Network_Time_Protocol	200701	15	2	0	0	7	4	1	0	243	146	6	137	76	1
159886	Network_Time_Protocol	200702	12	0	0	0	9	2	0	0	255	154	6	141	77	1
159886	Network_Time_Protocol	200703	7	0	0	0	6	5	0	0	262	158	6	146	80	1
159886	Network_Time_Protocol	200704	9	0	0	0	7	5	0	0	271	164	6	153	84	1
159886	Network_Time_Protocol	200705	2	0	0	0	2	1	0	0	273	166	6	154	85	1
159886	Network_Time_Protocol	200706	3	1	0	0	3	2	1	0	276	169	7	156	87	1
159886	Network_Time_Protocol	200707	2	0	0	0	2	2	0	0	278	171	7	158	89	1
159886	Network_Time_Protocol	200708	5	0	0	0	5	3	0	0	283	176	7	161	92	1
159886	Network_Time_Protocol	200709	9	1	0	0	8	5	1	0	292	183	8	166	96	1
159886	Network_Time_Protocol	200710	11	0	0	0	4	2	0	0	303	187	8	174	98	1
159886	Network_Time_Protocol	200711	1	0	0	0	1	1	0	0	304	188	8	175	99	1
159886	Network_Time_Protocol	200712	7	2	0	0	7	2	2	0	311	194	10	177	100	1
159886	Network_Time_Protocol	200801	5	0	0	0	3	1	0	0	316	197	10	179	101	1
159886	Network_Time_Protocol	200802	7	0	0	0	5	4	0	0	323	202	10	185	105	1
159886	Network_Time_Protocol	200803	3	0	0	0	3	2	0	0	326	203	10	187	105	1
159886	Network_Time_Protocol	200804	7	0	0	0	4	3	0	0	333	207	10	193	108	1
159886	Network_Time_Protocol	200805	8	1	0	0	6	4	1	0	341	212	11	198	111	1
159886	Network_Time_Protocol	200806	1	0	0	0	1	0	0	0	342	213	11	198	111	1
159886	Network_Time_Protocol	200807	5	0	0	0	3	1	0	0	347	216	11	199	112	1
159886	Network_Time_Protocol	200808	2	0	0	0	2	1	0	0	349	218	11	200	113	1
159886	Network_Time_Protocol	200809	11	1	0	0	10	6	1	0	360	226	12	206	117	1
159886	Network_Time_Protocol	200810	1	0	0	0	1	0	0	0	361	227	12	206	117	1
159886	Network_Time_Protocol	200811	2	0	0	0	1	0	0	0	363	227	12	206	117	1
159886	Network_Time_Protocol	200812	3	0	0	0	3	1	0	0	366	229	12	207	117	1
159886	Network_Time_Protocol	200901	9	0	0	0	5	4	0	0	375	233	12	215	120	1
159886	Network_Time_Protocol	200902	9	0	0	0	6	2	0	0	384	238	12	219	121	1
159886	Network_Time_Protocol	200903	11	1	0	0	7	3	1	0	395	242	13	225	121	1
159886	Network_Time_Protocol	200904	7	1	0	0	5	3	1	0	402	245	14	229	122	2
159886	Network_Time_Protocol	200906	9	2	0	0	5	5	1	0	411	249	16	238	126	4
159886	Network_Time_Protocol	200907	16	2	0	0	11	7	2	0	427	257	18	250	130	5
159886	Network_Time_Protocol	200908	11	1	0	0	7	4	1	0	438	262	19	258	132	5
159886	Network_Time_Protocol	200909	3	0	0	0	3	1	0	0	441	264	19	259	132	5
159886	Network_Time_Protocol	200910	2	1	0	0	2	1	1	0	443	265	20	260	132	5
159886	Network_Time_Protocol	200911	5	0	0	0	4	3	0	0	448	267	20	263	133	5
159886	Network_Time_Protocol	200912	5	0	0	0	4	3	0	0	453	270	20	267	136	5
159886	Network_Time_Protocol	201001	7	1	0	0	5	3	1	0	460	273	21	272	137	5
159886	Network_Time_Protocol	201002	5	0	0	0	5	3	0	0	465	278	21	275	140	5
159886	Network_Time_Protocol	201003	6	2	0	0	5	3	2	0	471	280	23	279	140	5
159886	Network_Time_Protocol	201004	3	1	0	0	3	3	1	0	474	283	24	282	143	6
159886	Network_Time_Protocol	201005	7	2	0	0	7	6	2	0	481	288	26	288	147	7
159886	Network_Time_Protocol	201006	3	0	0	0	3	3	0	0	484	289	26	291	148	7
159886	Network_Time_Protocol	201007	13	0	0	0	3	3	0	0	497	291	26	304	150	7
159886	Network_Time_Protocol	201008	8	0	0	0	4	4	0	0	505	292	26	312	151	7
159886	Network_Time_Protocol	201009	7	0	0	0	5	4	0	0	512	295	26	318	153	7
159886	Network_Time_Protocol	201010	4	0	0	0	3	3	0	0	516	297	26	322	155	7
159886	Network_Time_Protocol	201011	1	0	0	0	1	1	0	0	517	298	26	323	156	7
159886	Network_Time_Protocol	201012	16	1	0	0	4	2	1	0	533	301	27	333	158	7
159886	Network_Time_Protocol	201101	3	0	0	0	3	1	0	0	536	303	27	334	158	7
159886	Network_Time_Protocol	201102	10	1	0	0	7	4	1	0	546	306	28	341	159	8
159886	Network_Time_Protocol	201103	4	0	0	0	4	4	0	0	550	307	28	345	160	8
159886	Network_Time_Protocol	201104	1	0	0	0	1	1	0	0	551	308	28	346	161	8
159886	Network_Time_Protocol	201105	2	0	0	0	2	1	0	0	553	310	28	347	162	8
159886	Network_Time_Protocol	201106	3	0	0	0	3	2	0	0	556	313	28	349	164	8
159886	Network_Time_Protocol	201107	1	0	0	0	1	1	0	0	557	314	28	350	165	8
159886	Network_Time_Protocol	201108	3	0	0	0	3	3	0	0	560	316	28	353	167	8
159886	Network_Time_Protocol	201109	4	0	0	0	2	2	0	0	564	317	28	357	168	8
159886	Network_Time_Protocol	201110	11	0	0	0	7	6	0	0	575	323	28	367	173	8
159886	Network_Time_Protocol	201111	1	0	0	0	1	0	0	0	576	324	28	367	173	8
159886	Network_Time_Protocol	201112	14	2	0	0	7	5	2	0	590	328	30	379	175	9
159886	Network_Time_Protocol	201201	4	1	0	0	3	2	1	0	594	330	31	381	176	9
159886	Network_Time_Protocol	201202	2	0	0	0	2	1	0	0	596	332	31	382	177	9
159886	Network_Time_Protocol	201203	1	0	0	0	1	1	0	0	597	333	31	383	178	9
159886	Network_Time_Protocol	201205	11	3	0	0	8	6	3	0	608	338	34	392	181	11
159886	Network_Time_Protocol	201206	12	2	0	0	8	6	2	0	620	342	36	402	183	11
159886	Network_Time_Protocol	201207	5	2	0	0	5	4	2	0	625	345	38	406	185	13
159886	Network_Time_Protocol	201208	5	1	0	0	5	3	1	0	630	350	39	409	188	13
159886	Network_Time_Protocol	201209	10	1	0	0	3	2	1	0	640	353	40	411	190	14
159886	Network_Time_Protocol	201211	6	0	0	0	4	3	0	0	646	357	40	416	193	14
159886	Network_Time_Protocol	201212	4	1	0	0	4	2	1	0	650	361	41	418	195	14
159886	Network_Time_Protocol	201301	2	1	0	0	2	1	1	0	652	363	42	419	196	14
159886	Network_Time_Protocol	201302	5	2	0	0	4	3	2	0	657	365	44	422	197	14
159886	Network_Time_Protocol	201303	1	0	0	0	1	1	0	0	658	366	44	423	198	14
159886	Network_Time_Protocol	201304	1	0	0	0	1	1	0	0	659	367	44	424	199	14
159886	Network_Time_Protocol	201305	9	2	0	0	7	4	2	0	668	373	46	429	202	14
159886	Network_Time_Protocol	201306	29	14	1	0	17	9	10	1	697	385	60	449	206	20
159886	Network_Time_Protocol	201308	4	1	0	0	4	3	1	0	701	388	61	452	208	20
159886	Network_Time_Protocol	201309	5	3	0	0	5	1	3	0	706	392	64	453	208	21
159886	Network_Time_Protocol	201310	3	1	0	0	3	2	1	0	709	395	65	455	210	21
159886	Network_Time_Protocol	201311	32	2	0	0	5	4	2	0	741	398	67	486	212	22
159886	Network_Time_Protocol	201312	2	0	0	0	2	1	0	0	743	400	67	487	213	22
159886	Network_Time_Protocol	201401	2	0	0	0	2	2	0	0	745	401	67	489	214	22
159886	Network_Time_Protocol	201402	10	1	0	0	7	5	1	0	755	405	68	496	216	22
159886	Network_Time_Protocol	201403	9	0	0	0	8	6	0	0	764	411	68	503	219	22
159886	Network_Time_Protocol	201406	5	1	0	0	4	2	1	0	769	413	69	506	219	22
159886	Network_Time_Protocol	201407	9	0	0	0	4	4	0	0	778	415	69	515	221	22
159886	Network_Time_Protocol	201408	8	0	0	0	5	4	0	0	786	417	69	522	222	22
159886	Network_Time_Protocol	201409	5	2	1	0	4	2	2	1	791	419	71	524	222	23
159886	Network_Time_Protocol	201410	1	0	0	0	1	0	0	0	792	420	71	524	222	23
159886	Network_Time_Protocol	201411	16	3	0	0	12	9	2	0	808	427	74	535	226	23
159886	Network_Time_Protocol	201412	10	5	0	0	8	5	5	0	818	432	79	541	228	25
159886	Network_Time_Protocol	201501	12	0	0	0	9	6	0	0	830	439	79	550	232	25
159886	Network_Time_Protocol	201502	12	3	0	0	9	5	3	0	842	445	82	557	234	25
159886	Network_Time_Protocol	201503	12	4	2	1	3	3	2	2	854	447	86	569	236	29
159886	Network_Time_Protocol	201504	1	0	0	0	1	0	0	0	855	448	86	569	236	29
159886	Network_Time_Protocol	201505	12	1	0	0	8	6	1	0	867	453	87	579	239	29
159886	Network_Time_Protocol	201506	3	0	0	0	3	2	0	0	870	456	87	581	241	29
159886	Network_Time_Protocol	201507	5	0	0	0	4	3	0	0	875	458	87	585	242	29
159886	Network_Time_Protocol	201508	2	1	0	0	2	1	1	0	877	459	88	586	242	29
159886	Network_Time_Protocol	201510	3	1	0	0	3	2	1	0	880	461	89	588	243	29
159886	Network_Time_Protocol	201511	6	2	0	0	4	3	2	0	886	464	91	592	245	29
159886	Network_Time_Protocol	201512	7	1	0	0	2	2	1	0	893	464	92	599	245	30
159886	Network_Time_Protocol	201601	6	0	0	0	4	3	0	0	899	466	92	604	246	30
159886	Network_Time_Protocol	201602	2	0	0	0	2	1	0	0	901	467	92	605	246	30
159886	Network_Time_Protocol	201603	3	1	0	0	3	2	1	0	904	469	93	607	246	31
159886	Network_Time_Protocol	201604	3	1	0	0	3	2	1	0	907	472	94	609	247	32
159886	Network_Time_Protocol	201605	1	0	0	0	1	0	0	0	908	473	94	609	247	32
159886	Network_Time_Protocol	201606	9	2	0	0	7	4	2	0	917	478	96	615	249	33
159886	Network_Time_Protocol	201609	1	0	0	0	1	1	0	0	918	478	96	616	249	33
159886	Network_Time_Protocol	201610	3	1	0	0	2	1	1	0	921	480	97	618	250	33
159886	Network_Time_Protocol	201612	18	5	0	0	6	6	2	0	939	485	102	636	254	38
159886	Network_Time_Protocol	201701	4	0	0	0	3	3	0	0	943	487	102	640	256	38
159886	Network_Time_Protocol	201702	5	2	0	0	5	3	2	0	948	490	104	643	257	38
159886	Network_Time_Protocol	201703	2	1	0	0	2	1	1	0	950	491	105	644	257	38
159886	Network_Time_Protocol	201704	7	0	0	0	4	3	0	0	957	494	105	649	259	38
159886	Network_Time_Protocol	201705	6	2	0	0	5	3	2	0	963	498	107	652	260	39
159886	Network_Time_Protocol	201706	4	1	0	0	4	3	1	0	967	502	108	655	263	39
159886	Network_Time_Protocol	201707	5	1	0	0	5	4	1	0	972	504	109	659	264	39
159886	Network_Time_Protocol	201708	8	3	0	0	6	5	2	0	980	509	112	666	267	41
159886	Network_Time_Protocol	201709	16	6	1	0	9	8	4	1	996	515	118	681	272	46
159886	Network_Time_Protocol	201710	3	0	0	0	3	3	0	0	999	516	118	684	273	46
159886	Network_Time_Protocol	201711	8	3	1	0	6	4	3	1	1007	519	121	690	274	47
159886	Network_Time_Protocol	201712	13	2	0	0	8	7	2	0	1020	524	123	702	277	48
159886	Network_Time_Protocol	201801	9	2	0	0	6	4	2	0	1029	528	125	706	279	48
159886	Network_Time_Protocol	201802	8	3	0	0	7	4	2	0	1037	533	128	711	281	48
159886	Network_Time_Protocol	201803	6	1	0	0	6	4	1	0	1043	538	129	715	284	48
159886	Network_Time_Protocol	201804	4	1	0	0	4	3	1	0	1047	542	130	718	287	48
159886	Network_Time_Protocol	201805	4	0	0	0	2	2	0	0	1051	543	130	722	288	48
159886	Network_Time_Protocol	201806	9	0	0	0	6	5	0	0	1060	547	130	730	291	48
159886	Network_Time_Protocol	201807	3	2	0	0	3	2	2	0	1063	549	132	732	292	49
53036	Network_address_translation	200202	1	0	0	0	1	1	0	0	1	1	0	1	1	0
53036	Network_address_translation	200205	1	0	0	0	1	1	0	0	2	2	0	2	1	0
53036	Network_address_translation	200207	5	0	0	0	3	2	0	0	7	5	0	5	3	0
53036	Network_address_translation	200208	7	0	0	0	3	2	0	0	14	7	0	7	4	0
53036	Network_address_translation	200211	2	0	0	0	2	1	0	0	16	9	0	8	5	0
53036	Network_address_translation	200301	2	0	0	0	2	1	0	0	18	11	0	9	6	0
53036	Network_address_translation	200303	4	0	0	0	3	3	0	0	22	14	0	13	9	0
53036	Network_address_translation	200304	2	0	0	0	2	2	0	0	24	16	0	15	11	0
53036	Network_address_translation	200305	3	0	0	0	3	2	0	0	27	19	0	17	13	0
53036	Network_address_translation	200307	1	0	0	0	1	1	0	0	28	19	0	18	13	0
53036	Network_address_translation	200308	1	0	0	0	1	1	0	0	29	20	0	19	14	0
53036	Network_address_translation	200309	2	0	0	0	2	1	0	0	31	22	0	20	15	0
53036	Network_address_translation	200310	3	0	0	0	3	2	0	0	34	25	0	22	17	0
53036	Network_address_translation	200311	3	0	0	0	3	1	0	0	37	28	0	23	18	0
53036	Network_address_translation	200312	2	0	0	0	2	0	0	0	39	30	0	23	18	0
53036	Network_address_translation	200401	3	0	0	0	3	2	0	0	42	33	0	25	20	0
53036	Network_address_translation	200402	1	0	0	0	1	1	0	0	43	34	0	26	21	0
53036	Network_address_translation	200403	1	0	0	0	1	1	0	0	44	35	0	27	22	0
53036	Network_address_translation	200404	2	0	0	0	2	2	0	0	46	37	0	29	24	0
53036	Network_address_translation	200405	3	0	0	0	3	2	0	0	49	40	0	31	26	0
53036	Network_address_translation	200406	1	0	0	0	1	1	0	0	50	41	0	32	27	0
53036	Network_address_translation	200408	10	2	0	0	8	4	2	0	60	48	2	38	30	0
53036	Network_address_translation	200409	3	0	0	0	3	2	0	0	63	51	2	40	32	0
53036	Network_address_translation	200410	2	0	0	0	2	2	0	0	65	53	2	42	34	0
53036	Network_address_translation	200411	8	1	0	0	7	4	1	0	73	60	3	46	38	0
53036	Network_address_translation	200412	4	1	0	0	4	2	1	0	77	64	4	48	40	0
53036	Network_address_translation	200501	7	1	0	0	6	4	1	0	84	70	5	52	44	0
53036	Network_address_translation	200502	9	0	0	0	7	3	0	0	93	76	5	55	46	0
53036	Network_address_translation	200503	6	0	0	0	4	3	0	0	99	79	5	60	48	0
53036	Network_address_translation	200504	6	0	0	0	4	1	0	0	105	83	5	61	49	0
53036	Network_address_translation	200505	8	0	0	0	7	5	0	0	113	90	5	66	54	0
53036	Network_address_translation	200506	24	2	0	0	15	8	2	0	137	104	7	75	61	0
53036	Network_address_translation	200507	22	8	0	0	11	5	5	0	159	114	15	84	65	1
53036	Network_address_translation	200508	7	1	0	0	5	2	1	0	166	119	16	86	67	1
53036	Network_address_translation	200509	2	0	0	0	2	1	0	0	168	121	16	87	68	1
53036	Network_address_translation	200510	5	1	0	0	4	2	1	0	173	125	17	89	70	1
53036	Network_address_translation	200511	8	1	0	0	7	4	1	0	181	131	18	93	74	1
53036	Network_address_translation	200512	17	3	0	0	15	9	3	0	198	143	21	102	80	1
53036	Network_address_translation	200601	30	3	0	0	17	5	3	0	228	159	24	108	84	1
53036	Network_address_translation	200602	6	0	0	0	4	2	0	0	234	163	24	112	86	1
53036	Network_address_translation	200603	14	1	0	0	9	2	1	0	248	172	25	115	88	1
53036	Network_address_translation	200604	14	2	0	0	9	4	1	0	262	181	27	124	92	1
53036	Network_address_translation	200605	19	4	0	0	11	4	3	0	281	191	31	130	95	1
53036	Network_address_translation	200606	15	0	0	0	9	4	0	0	296	200	31	138	99	1
53036	Network_address_translation	200607	18	1	0	0	13	6	1	0	314	213	32	148	105	1
53036	Network_address_translation	200608	9	0	0	0	8	3	0	0	323	220	32	151	107	1
53036	Network_address_translation	200609	10	2	0	0	9	4	2	0	333	229	34	156	111	2
53036	Network_address_translation	200610	8	2	0	0	8	2	2	0	341	236	36	158	112	3
53036	Network_address_translation	200611	32	4	0	0	21	7	4	0	373	256	40	167	118	3
53036	Network_address_translation	200612	13	3	0	0	9	5	2	0	386	263	43	174	121	3
53036	Network_address_translation	200701	6	0	0	0	5	3	0	0	392	268	43	178	124	3
53036	Network_address_translation	200702	9	1	0	0	7	3	1	0	401	275	44	181	127	3
53036	Network_address_translation	200703	11	2	0	0	9	4	2	0	412	283	46	185	130	3
53036	Network_address_translation	200704	11	2	0	0	9	3	2	0	423	290	48	188	131	3
53036	Network_address_translation	200705	6	1	0	0	6	4	1	0	429	296	49	192	135	3
53036	Network_address_translation	200706	17	3	0	0	15	9	3	0	446	309	52	202	142	3
53036	Network_address_translation	200707	17	1	0	0	9	4	1	0	463	318	53	208	146	3
53036	Network_address_translation	200708	23	2	0	0	16	7	2	0	486	331	55	218	150	3
53036	Network_address_translation	200709	14	1	0	0	12	3	1	0	500	343	56	221	153	3
53036	Network_address_translation	200710	26	5	0	0	18	10	5	0	526	357	61	237	159	5
53036	Network_address_translation	200711	31	6	1	0	16	8	4	1	557	368	67	256	163	8
53036	Network_address_translation	200712	16	2	0	0	16	9	2	0	573	383	69	265	171	8
53036	Network_address_translation	200801	22	4	0	0	13	6	3	0	595	395	73	278	176	9
53036	Network_address_translation	200802	9	1	0	0	7	5	1	0	604	400	74	283	179	9
53036	Network_address_translation	200803	11	2	0	0	9	3	2	0	615	408	76	286	181	9
53036	Network_address_translation	200804	16	1	0	0	11	6	1	0	631	417	77	296	185	9
53036	Network_address_translation	200805	15	4	1	0	11	2	4	1	646	428	81	298	187	10
53036	Network_address_translation	200806	5	1	0	0	5	1	1	0	651	433	82	299	188	10
53036	Network_address_translation	200807	23	0	0	0	16	7	0	0	674	447	82	312	193	10
53036	Network_address_translation	200808	24	3	0	0	18	11	3	0	698	464	85	327	203	11
53036	Network_address_translation	200809	6	0	0	0	5	2	0	0	704	469	85	329	205	11
53036	Network_address_translation	200810	31	11	0	0	16	8	5	0	735	482	96	344	210	12
53036	Network_address_translation	200811	9	2	0	0	8	4	2	0	744	487	98	348	211	12
53036	Network_address_translation	200812	4	1	0	0	4	1	1	0	748	490	99	349	211	12
53036	Network_address_translation	200901	12	2	0	0	12	7	2	0	760	500	101	356	216	12
53036	Network_address_translation	200902	13	2	0	0	12	5	2	0	773	511	103	362	220	13
53036	Network_address_translation	200903	18	2	0	0	9	6	2	0	791	518	105	377	224	14
53036	Network_address_translation	200904	10	4	1	0	9	4	4	1	801	526	109	381	227	15
53036	Network_address_translation	200905	9	3	0	0	7	4	2	0	810	532	112	386	230	15
53036	Network_address_translation	200906	15	6	0	0	11	5	3	0	825	541	118	395	233	16
53036	Network_address_translation	200907	19	4	0	0	10	4	3	0	844	549	122	406	235	16
53036	Network_address_translation	200908	4	1	0	0	4	1	1	0	848	553	123	407	236	16
53036	Network_address_translation	200909	3	1	0	0	3	1	1	0	851	555	124	408	236	16
53036	Network_address_translation	200910	11	2	0	0	7	3	2	0	862	562	126	412	239	16
53036	Network_address_translation	200911	5	0	0	0	4	3	0	0	867	565	126	415	241	16
53036	Network_address_translation	200912	3	0	0	0	3	2	0	0	870	568	126	417	243	16
53036	Network_address_translation	201001	10	1	0	0	8	6	1	0	880	574	127	425	247	16
53036	Network_address_translation	201002	12	2	0	0	9	6	2	0	892	580	129	433	250	17
53036	Network_address_translation	201003	12	3	0	0	10	5	3	0	904	589	132	438	254	17
53036	Network_address_translation	201004	8	2	0	0	8	5	2	0	912	593	134	443	255	17
53036	Network_address_translation	201005	12	5	0	0	9	5	4	0	924	600	139	451	258	18
53036	Network_address_translation	201006	13	3	0	0	10	6	3	0	937	607	142	459	261	18
53036	Network_address_translation	201007	23	1	0	0	10	7	1	0	960	615	143	466	266	18
53036	Network_address_translation	201008	1	0	0	0	1	1	0	0	961	615	143	467	266	18
53036	Network_address_translation	201009	13	2	0	0	7	6	2	0	974	619	145	477	269	18
53036	Network_address_translation	201010	19	6	0	0	13	7	4	0	993	631	151	489	275	20
53036	Network_address_translation	201011	9	1	0	0	7	4	1	0	1002	638	152	493	279	20
53036	Network_address_translation	201012	12	3	0	0	10	4	3	0	1014	647	155	497	282	20
53036	Network_address_translation	201101	24	5	0	0	16	9	5	0	1038	656	160	510	284	21
53036	Network_address_translation	201102	19	2	0	0	12	7	2	0	1057	667	162	520	290	21
53036	Network_address_translation	201103	18	1	0	0	14	6	1	0	1075	678	163	529	293	21
53036	Network_address_translation	201104	20	2	0	0	11	7	2	0	1095	687	165	545	298	21
53036	Network_address_translation	201105	28	4	0	0	15	9	4	0	1123	698	169	560	303	22
53036	Network_address_translation	201106	6	0	0	0	6	4	0	0	1129	703	169	564	306	22
53036	Network_address_translation	201107	14	1	0	0	10	6	1	0	1143	710	170	572	309	22
53036	Network_address_translation	201108	18	3	0	0	13	7	3	0	1161	717	173	582	310	22
53036	Network_address_translation	201109	5	2	0	0	5	3	2	0	1166	720	175	585	311	22
53036	Network_address_translation	201110	18	7	0	0	12	7	5	0	1184	730	182	594	316	22
53036	Network_address_translation	201111	7	1	0	0	5	3	1	0	1191	734	183	598	318	22
53036	Network_address_translation	201112	3	1	0	0	3	2	1	0	1194	735	184	600	318	22
53036	Network_address_translation	201201	2	0	0	0	1	0	0	0	1196	736	184	600	318	22
53036	Network_address_translation	201202	11	2	0	0	6	1	2	0	1207	740	186	601	318	22
53036	Network_address_translation	201203	11	3	0	0	9	5	3	0	1218	745	189	606	319	23
53036	Network_address_translation	201204	8	2	0	0	7	4	2	0	1226	751	191	610	322	23
53036	Network_address_translation	201205	6	1	0	0	6	5	1	0	1232	755	192	615	325	23
53036	Network_address_translation	201206	8	0	0	0	6	5	0	0	1240	761	192	622	330	23
53036	Network_address_translation	201207	4	0	0	0	4	2	0	0	1244	764	192	624	331	23
53036	Network_address_translation	201208	6	1	0	0	5	3	1	0	1250	767	193	627	332	23
53036	Network_address_translation	201209	11	4	0	0	10	5	4	0	1261	775	197	633	335	23
53036	Network_address_translation	201210	16	3	0	0	10	8	2	0	1277	781	200	646	338	25
53036	Network_address_translation	201211	7	3	0	0	7	4	3	0	1284	786	203	650	340	25
53036	Network_address_translation	201212	1	0	0	0	1	1	0	0	1285	787	203	651	341	25
53036	Network_address_translation	201301	13	3	0	0	8	6	3	0	1298	792	206	657	344	26
53036	Network_address_translation	201302	9	2	0	0	5	3	1	0	1307	796	208	664	346	26
53036	Network_address_translation	201303	19	5	0	0	12	8	3	0	1326	805	213	674	351	26
53036	Network_address_translation	201304	9	2	0	0	6	2	2	0	1335	809	215	677	351	26
53036	Network_address_translation	201305	2	0	0	0	2	2	0	0	1337	809	215	679	351	26
53036	Network_address_translation	201306	11	3	0	0	9	4	3	0	1348	817	218	683	354	26
53036	Network_address_translation	201307	1	0	0	0	1	0	0	0	1349	818	218	683	354	26
53036	Network_address_translation	201308	8	3	0	0	8	4	3	0	1357	824	221	687	356	26
53036	Network_address_translation	201309	1	0	0	0	1	1	0	0	1358	824	221	688	356	26
53036	Network_address_translation	201310	7	4	0	0	6	3	4	0	1365	827	225	691	356	27
53036	Network_address_translation	201311	1	0	0	0	1	0	0	0	1366	828	225	691	356	27
53036	Network_address_translation	201312	3	0	0	0	3	2	0	0	1369	830	225	693	357	27
53036	Network_address_translation	201401	18	2	0	0	12	5	2	0	1387	840	227	699	360	27
53036	Network_address_translation	201402	21	4	0	0	11	8	4	0	1408	848	231	714	364	27
53036	Network_address_translation	201403	25	2	0	0	7	4	1	0	1433	852	233	735	365	27
53036	Network_address_translation	201404	8	3	0	0	7	4	3	0	1441	856	236	740	366	28
53036	Network_address_translation	201405	5	0	0	0	3	2	0	0	1446	858	236	744	367	28
53036	Network_address_translation	201406	9	0	0	0	4	3	0	0	1455	859	236	752	367	28
53036	Network_address_translation	201407	4	0	0	0	2	1	0	0	1459	861	236	754	368	28
53036	Network_address_translation	201408	15	1	0	0	10	6	1	0	1474	868	237	761	371	29
53036	Network_address_translation	201409	4	2	0	0	4	2	2	0	1478	871	239	763	372	29
53036	Network_address_translation	201410	14	2	0	0	9	4	2	0	1492	878	241	769	374	29
53036	Network_address_translation	201411	12	1	0	0	7	4	1	0	1504	884	242	775	377	29
53036	Network_address_translation	201412	11	3	0	0	7	4	3	0	1515	889	245	783	379	29
53036	Network_address_translation	201501	4	1	0	0	4	2	1	0	1519	893	246	785	381	29
53036	Network_address_translation	201502	3	0	0	0	2	0	0	0	1522	895	246	785	381	29
53036	Network_address_translation	201503	13	2	0	0	8	6	2	0	1535	900	248	795	384	30
53036	Network_address_translation	201504	10	4	0	0	8	5	4	0	1545	906	252	800	386	30
53036	Network_address_translation	201505	12	3	0	0	10	5	3	0	1557	913	255	807	388	30
53036	Network_address_translation	201506	9	3	0	0	9	6	3	0	1566	918	258	813	391	30
53036	Network_address_translation	201507	7	1	0	0	5	4	1	0	1573	920	259	819	392	30
53036	Network_address_translation	201508	4	1	0	0	3	2	1	0	1577	922	260	822	393	30
53036	Network_address_translation	201509	7	2	0	0	6	4	2	0	1584	926	262	826	395	30
53036	Network_address_translation	201510	6	0	0	0	4	1	0	0	1590	929	262	829	395	30
53036	Network_address_translation	201511	11	5	0	0	9	5	4	0	1601	935	267	835	397	30
53036	Network_address_translation	201512	5	1	0	0	4	2	1	0	1606	938	268	837	398	30
53036	Network_address_translation	201601	5	2	0	0	5	4	2	0	1611	941	270	841	400	31
53036	Network_address_translation	201602	13	5	0	0	11	7	4	0	1624	949	275	849	404	33
53036	Network_address_translation	201603	11	2	0	0	9	5	2	0	1635	955	277	855	406	33
53036	Network_address_translation	201604	2	1	0	0	2	1	1	0	1637	956	278	856	406	33
53036	Network_address_translation	201605	27	10	0	0	10	7	4	0	1664	964	288	870	410	35
53036	Network_address_translation	201606	16	6	0	0	13	5	5	0	1680	974	294	876	411	36
53036	Network_address_translation	201607	3	1	0	0	3	2	1	0	1683	976	295	878	411	37
53036	Network_address_translation	201608	6	1	0	0	5	2	1	0	1689	980	296	880	412	37
53036	Network_address_translation	201609	8	3	0	0	8	5	3	0	1697	986	299	885	415	37
53036	Network_address_translation	201610	4	3	0	0	4	4	3	0	1701	989	302	889	416	40
53036	Network_address_translation	201612	6	0	0	0	4	2	0	0	1707	993	302	891	417	40
53036	Network_address_translation	201701	2	0	0	0	1	0	0	0	1709	994	302	891	417	40
53036	Network_address_translation	201702	5	1	0	0	5	3	1	0	1714	998	303	894	419	40
53036	Network_address_translation	201703	2	0	0	0	2	2	0	0	1716	1000	303	896	421	40
53036	Network_address_translation	201704	3	1	0	0	2	1	1	0	1719	1001	304	897	421	40
53036	Network_address_translation	201705	10	0	0	0	6	6	0	0	1729	1006	304	907	426	40
53036	Network_address_translation	201706	15	5	0	0	13	12	5	0	1744	1017	309	920	433	43
53036	Network_address_translation	201707	3	1	0	0	3	2	1	0	1747	1019	310	922	434	43
53036	Network_address_translation	201708	6	2	0	0	5	2	2	0	1753	1024	312	924	436	43
53036	Network_address_translation	201709	2	0	0	0	2	2	0	0	1755	1025	312	926	437	43
53036	Network_address_translation	201710	7	4	1	0	7	4	4	1	1762	1029	316	930	438	44
53036	Network_address_translation	201711	5	1	0	0	4	2	1	0	1767	1031	317	932	438	44
53036	Network_address_translation	201712	14	6	0	0	13	11	5	0	1781	1041	323	944	444	48
53036	Network_address_translation	201801	5	1	0	0	4	3	1	0	1786	1044	324	947	444	49
53036	Network_address_translation	201802	6	1	0	0	5	4	1	0	1792	1047	325	952	445	50
53036	Network_address_translation	201803	10	3	0	0	6	4	2	0	1802	1052	328	957	448	51
53036	Network_address_translation	201804	7	3	0	0	7	5	3	0	1809	1057	331	962	450	52
53036	Network_address_translation	201805	5	1	0	0	3	2	1	0	1814	1059	332	966	451	52
53036	Network_address_translation	201806	3	1	0	0	3	2	1	0	1817	1062	333	968	453	52
53036	Network_address_translation	201807	7	3	0	0	6	3	2	0	1824	1067	336	972	454	53
38556048	Network_function_virtualization	201303	13	0	0	0	6	5	0	0	13	6	0	12	5	0
38556048	Network_function_virtualization	201304	3	0	0	0	2	2	0	0	16	7	0	15	6	0
38556048	Network_function_virtualization	201305	1	0	0	0	1	1	0	0	17	8	0	16	7	0
38556048	Network_function_virtualization	201306	4	0	0	0	2	2	0	0	21	10	0	20	9	0
38556048	Network_function_virtualization	201307	8	1	0	0	3	2	1	0	29	13	1	27	11	0
38556048	Network_function_virtualization	201308	4	1	0	0	3	3	1	0	33	16	2	31	14	1
38556048	Network_function_virtualization	201309	7	1	0	0	4	4	1	0	40	18	3	38	16	2
38556048	Network_function_virtualization	201310	10	0	0	0	5	3	0	0	50	22	3	42	19	2
38556048	Network_function_virtualization	201311	3	0	0	0	3	3	0	0	53	25	3	45	22	2
38556048	Network_function_virtualization	201312	17	0	0	0	9	5	0	0	70	33	3	57	26	2
38556048	Network_function_virtualization	201401	11	1	0	0	6	4	1	0	81	38	4	66	29	2
38556048	Network_function_virtualization	201402	16	0	0	0	6	3	0	0	97	44	4	79	32	2
38556048	Network_function_virtualization	201403	4	0	0	0	4	2	0	0	101	48	4	81	34	2
38556048	Network_function_virtualization	201404	7	0	0	0	3	1	0	0	108	51	4	86	35	2
38556048	Network_function_virtualization	201405	3	0	0	0	3	0	0	0	111	54	4	86	35	2
38556048	Network_function_virtualization	201406	7	0	0	0	6	3	0	0	118	60	4	89	38	2
38556048	Network_function_virtualization	201407	17	0	0	0	11	6	0	0	135	70	4	98	43	2
38556048	Network_function_virtualization	201409	3	0	0	0	2	1	0	0	138	72	4	99	44	2
38556048	Network_function_virtualization	201410	6	1	0	0	4	2	1	0	144	75	5	103	45	2
38556048	Network_function_virtualization	201411	15	1	0	0	3	3	1	0	159	78	6	118	48	3
38556048	Network_function_virtualization	201412	22	1	0	0	5	3	1	0	181	81	7	136	49	3
38556048	Network_function_virtualization	201501	1	0	0	0	1	0	0	0	182	82	7	136	49	3
38556048	Network_function_virtualization	201502	2	0	0	0	2	1	0	0	184	84	7	137	50	3
38556048	Network_function_virtualization	201503	3	0	0	0	2	1	0	0	187	86	7	139	51	3
38556048	Network_function_virtualization	201504	6	0	0	0	2	2	0	0	193	87	7	145	52	3
38556048	Network_function_virtualization	201505	8	0	0	0	3	3	0	0	201	89	7	153	54	3
38556048	Network_function_virtualization	201507	7	0	0	0	4	4	0	0	208	90	7	160	55	3
38556048	Network_function_virtualization	201508	9	0	0	0	3	2	0	0	217	93	7	167	57	3
38556048	Network_function_virtualization	201509	1	0	0	0	1	1	0	0	218	94	7	168	58	3
38556048	Network_function_virtualization	201511	13	0	0	0	4	2	0	0	231	98	7	179	60	3
38556048	Network_function_virtualization	201601	2	1	0	0	2	1	1	0	233	100	8	180	61	3
38556048	Network_function_virtualization	201602	3	0	0	0	2	2	0	0	236	102	8	183	63	3
38556048	Network_function_virtualization	201604	6	0	0	0	5	3	0	0	242	106	8	186	65	3
38556048	Network_function_virtualization	201605	8	1	0	0	4	3	1	0	250	110	9	192	68	3
38556048	Network_function_virtualization	201606	2	0	0	0	2	2	0	0	252	112	9	194	70	3
38556048	Network_function_virtualization	201607	2	0	0	0	2	1	0	0	254	113	9	195	70	3
38556048	Network_function_virtualization	201608	1	0	0	0	1	0	0	0	255	114	9	195	70	3
38556048	Network_function_virtualization	201609	3	0	0	0	3	3	0	0	258	116	9	198	72	3
38556048	Network_function_virtualization	201611	5	0	0	0	3	2	0	0	263	119	9	202	74	3
38556048	Network_function_virtualization	201612	1	0	0	0	1	1	0	0	264	120	9	203	75	3
38556048	Network_function_virtualization	201701	1	0	0	0	1	1	0	0	265	121	9	204	76	3
38556048	Network_function_virtualization	201702	1	0	0	0	1	1	0	0	266	122	9	205	77	3
38556048	Network_function_virtualization	201703	2	1	0	0	2	1	1	0	268	124	10	206	78	3
38556048	Network_function_virtualization	201704	4	0	0	0	3	2	0	0	272	127	10	208	80	3
38556048	Network_function_virtualization	201706	2	0	0	0	2	2	0	0	274	129	10	210	82	3
38556048	Network_function_virtualization	201707	1	0	0	0	1	1	0	0	275	129	10	211	82	3
38556048	Network_function_virtualization	201709	1	0	0	0	1	1	0	0	276	130	10	212	83	3
38556048	Network_function_virtualization	201710	3	0	0	0	2	2	0	0	279	132	10	215	85	3
38556048	Network_function_virtualization	201802	3	0	0	0	2	1	0	0	282	134	10	217	86	3
38556048	Network_function_virtualization	201803	1	0	0	0	1	1	0	0	283	135	10	218	87	3
38556048	Network_function_virtualization	201805	1	0	0	0	1	1	0	0	284	136	10	219	88	3
38556048	Network_function_virtualization	201806	1	0	0	0	1	1	0	0	285	137	10	220	89	3
38556048	Network_function_virtualization	201807	1	0	0	0	1	1	0	0	286	138	10	221	90	3
85024	Network_layer	200301	2	0	0	0	2	1	0	0	2	2	0	1	1	0
85024	Network_layer	200304	4	0	0	0	1	1	0	0	6	3	0	5	2	0
85024	Network_layer	200305	2	0	0	0	2	2	0	0	8	5	0	7	4	0
85024	Network_layer	200309	1	0	0	0	1	0	0	0	9	6	0	7	4	0
85024	Network_layer	200310	2	0	0	0	2	1	0	0	11	8	0	8	5	0
85024	Network_layer	200311	5	0	0	0	2	1	0	0	16	10	0	10	6	0
85024	Network_layer	200312	1	1	0	0	1	1	1	0	17	11	1	11	7	0
85024	Network_layer	200403	1	0	0	0	1	1	0	0	18	12	1	12	8	0
85024	Network_layer	200404	4	0	0	0	3	2	0	0	22	14	1	14	9	0
85024	Network_layer	200405	4	0	0	0	4	2	0	0	26	18	1	16	11	0
85024	Network_layer	200406	1	0	0	0	1	1	0	0	27	19	1	17	12	0
85024	Network_layer	200407	3	0	0	0	3	3	0	0	30	22	1	20	15	0
85024	Network_layer	200408	1	0	0	0	1	0	0	0	31	23	1	20	15	0
85024	Network_layer	200409	3	0	0	0	1	0	0	0	34	24	1	20	15	0
85024	Network_layer	200412	1	0	0	0	1	1	0	0	35	24	1	21	15	0
85024	Network_layer	200502	2	1	0	0	2	1	1	0	37	26	2	22	16	0
85024	Network_layer	200504	1	0	0	0	1	1	0	0	38	27	2	23	17	0
85024	Network_layer	200506	4	0	0	0	3	0	0	0	42	30	2	23	17	0
85024	Network_layer	200507	5	0	0	0	5	3	0	0	47	35	2	26	20	0
85024	Network_layer	200508	1	0	0	0	1	1	0	0	48	36	2	27	21	0
85024	Network_layer	200509	3	0	0	0	3	1	0	0	51	39	2	28	22	0
85024	Network_layer	200510	4	0	0	0	3	2	0	0	55	42	2	31	24	0
85024	Network_layer	200511	1	0	0	0	1	0	0	0	56	43	2	31	24	0
85024	Network_layer	200602	1	0	0	0	1	1	0	0	57	44	2	32	25	0
85024	Network_layer	200603	1	0	0	0	1	1	0	0	58	45	2	33	26	0
85024	Network_layer	200604	9	1	0	0	7	4	1	0	67	52	3	39	30	0
85024	Network_layer	200606	3	0	0	0	2	1	0	0	70	53	3	40	30	0
85024	Network_layer	200607	1	0	0	0	1	1	0	0	71	54	3	41	31	0
85024	Network_layer	200608	3	0	0	0	2	1	0	0	74	55	3	43	31	0
85024	Network_layer	200609	1	0	0	0	1	0	0	0	75	56	3	43	31	0
85024	Network_layer	200611	2	0	0	0	2	1	0	0	77	58	3	44	32	0
85024	Network_layer	200612	9	0	0	0	4	3	0	0	86	62	3	50	35	0
85024	Network_layer	200701	2	0	0	0	2	1	0	0	88	64	3	51	36	0
85024	Network_layer	200702	2	1	0	0	2	0	1	0	90	66	4	51	36	0
85024	Network_layer	200703	1	0	0	0	1	0	0	0	91	67	4	51	36	0
85024	Network_layer	200704	4	0	0	0	4	3	0	0	95	71	4	54	39	0
85024	Network_layer	200705	1	0	0	0	1	0	0	0	96	72	4	54	39	0
85024	Network_layer	200706	3	1	0	0	2	2	1	0	99	74	5	57	41	1
85024	Network_layer	200707	7	1	0	0	5	2	1	0	106	78	6	59	42	1
85024	Network_layer	200708	8	0	0	0	4	2	0	0	114	82	6	62	44	1
85024	Network_layer	200709	5	0	0	0	3	3	0	0	119	85	6	67	47	1
85024	Network_layer	200710	1	0	0	0	1	1	0	0	120	86	6	68	48	1
85024	Network_layer	200711	2	0	0	0	2	0	0	0	122	88	6	68	48	1
85024	Network_layer	200712	3	1	0	0	3	3	1	0	125	91	7	71	51	2
85024	Network_layer	200801	1	0	0	0	1	0	0	0	126	92	7	71	51	2
85024	Network_layer	200802	1	0	0	0	1	1	0	0	127	93	7	72	52	2
85024	Network_layer	200804	1	0	0	0	1	0	0	0	128	94	7	72	52	2
85024	Network_layer	200805	5	0	0	0	3	1	0	0	133	97	7	75	53	2
85024	Network_layer	200806	2	1	0	0	2	0	1	0	135	99	8	75	53	2
85024	Network_layer	200807	3	0	0	0	2	1	0	0	138	101	8	76	54	2
85024	Network_layer	200808	15	0	0	0	2	1	0	0	153	103	8	89	55	2
85024	Network_layer	200809	6	0	0	0	5	5	0	0	159	106	8	95	58	2
85024	Network_layer	200810	4	0	0	0	3	1	0	0	163	109	8	96	59	2
85024	Network_layer	200811	8	4	0	0	6	3	4	0	171	115	12	99	62	3
85024	Network_layer	200812	10	3	0	0	7	3	3	0	181	122	15	102	65	3
85024	Network_layer	200902	1	0	0	0	1	0	0	0	182	123	15	102	65	3
85024	Network_layer	200903	8	0	0	0	5	2	0	0	190	127	15	105	66	3
85024	Network_layer	200904	5	0	0	0	4	2	0	0	195	130	15	108	67	3
85024	Network_layer	200905	6	1	0	0	5	2	1	0	201	135	16	110	69	3
85024	Network_layer	200906	4	1	0	0	4	2	1	0	205	139	17	112	71	3
85024	Network_layer	200907	5	1	0	0	4	3	1	0	210	142	18	115	73	4
85024	Network_layer	200909	1	0	0	0	1	1	0	0	211	143	18	116	74	4
85024	Network_layer	200910	1	0	0	0	1	1	0	0	212	144	18	117	75	4
85024	Network_layer	201002	2	0	0	0	1	1	0	0	214	145	18	119	76	4
85024	Network_layer	201003	6	1	0	0	3	2	1	0	220	147	19	121	77	4
85024	Network_layer	201004	8	2	0	0	3	1	1	0	228	150	21	123	78	4
85024	Network_layer	201005	1	0	0	0	1	1	0	0	229	150	21	124	78	4
85024	Network_layer	201006	2	1	0	0	2	1	1	0	231	152	22	125	79	4
85024	Network_layer	201007	3	0	0	0	3	0	0	0	234	155	22	125	79	4
85024	Network_layer	201008	10	1	0	0	4	3	1	0	244	159	23	134	82	4
85024	Network_layer	201009	2	0	0	0	2	1	0	0	246	161	23	135	83	4
85024	Network_layer	201011	5	2	0	0	4	2	2	0	251	164	25	138	84	4
85024	Network_layer	201012	5	2	0	0	4	1	2	0	256	167	27	139	84	4
85024	Network_layer	201101	2	0	0	0	2	2	0	0	258	169	27	141	86	4
85024	Network_layer	201102	2	1	0	0	2	1	1	0	260	171	28	142	87	4
85024	Network_layer	201104	3	0	0	0	2	0	0	0	263	173	28	142	87	4
85024	Network_layer	201107	4	1	0	0	3	1	1	0	267	175	29	143	87	4
85024	Network_layer	201108	4	1	0	0	3	2	1	0	271	178	30	146	89	4
85024	Network_layer	201109	6	1	0	0	5	3	1	0	277	183	31	150	92	4
85024	Network_layer	201110	3	2	0	0	2	2	1	0	280	184	33	153	93	5
85024	Network_layer	201111	3	0	0	0	3	3	0	0	283	187	33	156	96	5
85024	Network_layer	201201	2	0	0	0	2	1	0	0	285	189	33	157	97	5
85024	Network_layer	201202	2	0	0	0	2	1	0	0	287	191	33	158	98	5
85024	Network_layer	201203	1	0	0	0	1	0	0	0	288	192	33	158	98	5
85024	Network_layer	201204	3	1	0	0	3	3	1	0	291	195	34	161	101	6
85024	Network_layer	201205	2	0	0	0	1	1	0	0	293	196	34	163	102	6
85024	Network_layer	201206	5	0	0	0	4	2	0	0	298	198	34	166	102	6
85024	Network_layer	201207	14	5	0	0	8	5	4	0	312	204	39	173	105	6
85024	Network_layer	201208	1	0	0	0	1	1	0	0	313	205	39	174	106	6
85024	Network_layer	201210	2	1	0	0	2	1	1	0	315	206	40	175	106	6
85024	Network_layer	201302	7	2	0	0	5	2	2	0	322	210	42	178	107	7
85024	Network_layer	201303	1	0	0	0	1	1	0	0	323	211	42	179	108	7
85024	Network_layer	201306	1	0	0	0	1	1	0	0	324	212	42	180	109	7
85024	Network_layer	201307	3	0	0	0	2	0	0	0	327	214	42	180	109	7
85024	Network_layer	201309	1	0	0	0	1	1	0	0	328	215	42	181	110	7
85024	Network_layer	201311	13	9	5	3	4	3	4	3	341	218	51	186	112	11
85024	Network_layer	201312	1	0	0	0	1	1	0	0	342	219	51	187	113	11
85024	Network_layer	201401	1	0	0	0	1	1	0	0	343	220	51	188	114	11
85024	Network_layer	201402	4	2	0	0	4	2	2	0	347	223	53	190	115	11
85024	Network_layer	201403	13	2	0	0	4	2	2	0	360	225	55	192	115	11
85024	Network_layer	201405	7	4	1	0	4	3	4	1	367	227	59	195	116	12
85024	Network_layer	201406	2	1	0	0	2	1	1	0	369	228	60	196	116	12
85024	Network_layer	201410	2	1	0	0	2	1	1	0	371	229	61	197	116	12
85024	Network_layer	201411	2	1	0	0	2	1	1	0	373	230	62	198	116	12
85024	Network_layer	201501	4	2	0	0	4	2	2	0	377	233	64	200	117	12
85024	Network_layer	201502	2	1	0	0	2	1	1	0	379	234	65	201	117	12
85024	Network_layer	201504	6	2	0	0	3	1	1	0	385	237	67	203	118	12
85024	Network_layer	201507	4	3	1	0	3	2	3	1	389	239	70	205	119	13
85024	Network_layer	201508	2	1	0	0	2	1	1	0	391	240	71	206	119	13
85024	Network_layer	201512	1	0	0	0	1	0	0	0	392	241	71	206	119	13
85024	Network_layer	201601	2	1	0	0	2	1	1	0	394	242	72	207	119	13
85024	Network_layer	201602	3	1	0	0	2	1	1	0	397	243	73	208	119	13
85024	Network_layer	201603	10	4	0	0	7	4	3	0	407	247	77	213	119	14
85024	Network_layer	201604	1	0	0	0	1	1	0	0	408	248	77	214	120	14
85024	Network_layer	201607	2	0	0	0	1	0	0	0	410	249	77	214	120	14
85024	Network_layer	201608	1	0	0	0	1	0	0	0	411	250	77	214	120	14
85024	Network_layer	201610	8	3	0	0	5	3	3	0	419	254	80	217	122	14
85024	Network_layer	201611	1	0	0	0	1	0	0	0	420	255	80	217	122	14
85024	Network_layer	201701	3	0	0	0	2	2	0	0	423	257	80	220	124	14
85024	Network_layer	201703	1	0	0	0	1	1	0	0	424	257	80	221	124	14
85024	Network_layer	201705	1	0	0	0	1	1	0	0	425	258	80	222	125	14
85024	Network_layer	201706	4	1	0	0	4	3	1	0	429	260	81	225	126	14
85024	Network_layer	201707	6	2	0	0	3	2	1	0	435	262	83	230	127	15
85024	Network_layer	201708	3	0	0	0	3	1	0	0	438	264	83	231	127	15
85024	Network_layer	201709	1	0	0	0	1	1	0	0	439	264	83	232	127	15
85024	Network_layer	201710	1	0	0	0	1	1	0	0	440	265	83	233	128	15
85024	Network_layer	201801	1	0	0	0	1	1	0	0	441	265	83	234	128	15
85024	Network_layer	201802	3	1	0	0	2	1	1	0	444	267	84	235	129	15
85024	Network_layer	201803	1	0	0	0	1	1	0	0	445	267	84	236	129	15
788676	Network_service	200408	3	0	0	0	2	2	0	0	3	2	0	3	2	0
788676	Network_service	200508	1	0	0	0	1	1	0	0	4	3	0	4	3	0
788676	Network_service	200510	2	0	0	0	2	2	0	0	6	5	0	6	5	0
788676	Network_service	200601	1	0	0	0	1	1	0	0	7	6	0	7	6	0
788676	Network_service	200603	2	0	0	0	2	2	0	0	9	8	0	9	8	0
788676	Network_service	200604	3	0	0	0	1	0	0	0	12	9	0	9	8	0
788676	Network_service	200605	2	0	0	0	2	2	0	0	14	11	0	11	10	0
788676	Network_service	200606	1	0	0	0	1	1	0	0	15	12	0	12	11	0
788676	Network_service	200704	1	0	0	0	1	1	0	0	16	13	0	13	12	0
788676	Network_service	200705	1	0	0	0	1	1	0	0	17	14	0	14	13	0
788676	Network_service	200706	7	0	0	0	1	0	0	0	24	15	0	14	13	0
788676	Network_service	200709	1	0	0	0	1	1	0	0	25	16	0	15	14	0
788676	Network_service	200802	1	0	0	0	1	0	0	0	26	17	0	15	14	0
788676	Network_service	200812	3	1	0	0	2	1	1	0	29	19	1	16	15	0
788676	Network_service	200902	1	0	0	0	1	1	0	0	30	20	1	17	16	0
788676	Network_service	200903	1	0	0	0	1	0	0	0	31	21	1	17	16	0
788676	Network_service	200907	2	0	0	0	2	1	0	0	33	23	1	18	17	0
788676	Network_service	200909	1	0	0	0	1	1	0	0	34	24	1	19	18	0
788676	Network_service	200911	2	1	0	0	2	1	1	0	36	26	2	20	19	0
788676	Network_service	200912	1	0	0	0	1	1	0	0	37	27	2	21	20	0
788676	Network_service	201008	1	0	0	0	1	1	0	0	38	28	2	22	21	0
788676	Network_service	201009	1	0	0	0	1	1	0	0	39	29	2	23	22	0
788676	Network_service	201010	1	0	0	0	1	0	0	0	40	30	2	23	22	0
788676	Network_service	201011	2	0	0	0	2	2	0	0	42	32	2	25	24	0
788676	Network_service	201102	2	0	0	0	2	2	0	0	44	34	2	27	26	0
788676	Network_service	201103	1	0	0	0	1	1	0	0	45	35	2	28	27	0
788676	Network_service	201105	1	0	0	0	1	0	0	0	46	36	2	28	27	0
788676	Network_service	201109	3	1	0	0	2	0	1	0	49	38	3	28	27	0
788676	Network_service	201201	1	0	0	0	1	1	0	0	50	39	3	29	28	0
788676	Network_service	201202	1	0	0	0	1	1	0	0	51	40	3	30	29	0
788676	Network_service	201203	2	0	0	0	1	1	0	0	53	41	3	32	30	0
788676	Network_service	201206	1	0	0	0	1	0	0	0	54	42	3	32	30	0
788676	Network_service	201209	2	1	0	0	2	1	1	0	56	44	4	33	31	0
788676	Network_service	201211	1	0	0	0	1	1	0	0	57	44	4	34	31	0
788676	Network_service	201302	1	0	0	0	1	0	0	0	58	45	4	34	31	0
788676	Network_service	201304	3	0	0	0	3	3	0	0	61	48	4	37	34	0
788676	Network_service	201305	10	0	0	0	2	2	0	0	71	50	4	47	36	0
788676	Network_service	201306	21	1	0	0	5	4	1	0	92	54	5	67	39	0
788676	Network_service	201308	1	0	0	0	1	1	0	0	93	54	5	68	39	0
788676	Network_service	201309	1	0	0	0	1	0	0	0	94	55	5	68	39	0
788676	Network_service	201310	1	0	0	0	1	0	0	0	95	56	5	68	39	0
788676	Network_service	201312	12	0	0	0	2	1	0	0	107	57	5	79	39	0
788676	Network_service	201407	1	0	0	0	1	1	0	0	108	58	5	80	40	0
788676	Network_service	201408	2	0	0	0	2	0	0	0	110	60	5	80	40	0
788676	Network_service	201411	3	0	0	0	1	1	0	0	113	61	5	83	41	0
788676	Network_service	201504	2	1	0	0	2	2	1	0	115	63	6	85	43	1
788676	Network_service	201512	2	0	0	0	1	0	0	0	117	64	6	85	43	1
788676	Network_service	201601	2	0	0	0	1	0	0	0	119	65	6	85	43	1
788676	Network_service	201603	3	1	0	0	2	2	1	0	122	67	7	88	45	1
788676	Network_service	201610	1	0	0	0	1	1	0	0	123	68	7	89	46	1
788676	Network_service	201704	1	0	0	0	1	1	0	0	124	69	7	90	47	1
788676	Network_service	201705	1	0	0	0	1	0	0	0	125	70	7	90	47	1
788676	Network_service	201710	4	0	0	0	4	2	0	0	129	74	7	92	49	1
788676	Network_service	201711	2	1	0	0	2	1	1	0	131	76	8	93	50	1
788676	Network_service	201712	1	0	0	0	1	0	0	0	132	77	8	93	50	1
31950932	Next_Generation_Mobile_Networks	201107	89	0	0	0	3	3	0	0	89	3	0	89	3	0
31950932	Next_Generation_Mobile_Networks	201401	1	0	0	0	1	1	0	0	90	4	0	90	4	0
31950932	Next_Generation_Mobile_Networks	201404	13	1	0	0	3	3	1	0	103	7	1	103	7	1
31950932	Next_Generation_Mobile_Networks	201406	1	0	0	0	1	1	0	0	104	7	1	104	7	1
31950932	Next_Generation_Mobile_Networks	201507	1	0	0	0	1	1	0	0	105	8	1	105	8	1
31950932	Next_Generation_Mobile_Networks	201508	6	0	0	0	2	2	0	0	111	10	1	111	10	1
31950932	Next_Generation_Mobile_Networks	201509	1	0	0	0	1	1	0	0	112	11	1	112	11	1
31950932	Next_Generation_Mobile_Networks	201510	2	0	0	0	1	1	0	0	114	11	1	114	11	1
31950932	Next_Generation_Mobile_Networks	201607	1	0	0	0	1	1	0	0	115	11	1	115	11	1
31950932	Next_Generation_Mobile_Networks	201611	1	0	0	0	1	0	0	0	116	12	1	115	11	1
31950932	Next_Generation_Mobile_Networks	201703	1	0	0	0	1	1	0	0	117	13	1	116	12	1
31950932	Next_Generation_Mobile_Networks	201801	1	0	0	0	1	0	0	0	118	14	1	116	12	1
31950932	Next_Generation_Mobile_Networks	201802	2	0	0	0	1	1	0	0	120	15	1	118	13	1
27125334	NixOS	201509	1	0	0	0	1	1	0	0	1	1	0	1	1	0
27125334	NixOS	201510	11	0	0	0	6	6	0	0	12	7	0	12	7	0
27125334	NixOS	201511	3	0	0	0	3	0	0	0	15	10	0	12	7	0
27125334	NixOS	201512	1	0	0	0	1	0	0	0	16	11	0	12	7	0
27125334	NixOS	201601	1	0	0	0	1	1	0	0	17	12	0	13	8	0
27125334	NixOS	201603	1	0	0	0	1	1	0	0	18	13	0	14	9	0
27125334	NixOS	201604	2	0	0	0	2	1	0	0	20	15	0	15	10	0
27125334	NixOS	201605	4	0	0	0	1	1	0	0	24	16	0	19	11	0
27125334	NixOS	201606	4	0	0	0	2	2	0	0	28	18	0	23	13	0
27125334	NixOS	201607	2	1	0	0	2	1	1	0	30	20	1	24	14	0
27125334	NixOS	201608	1	0	0	0	1	1	0	0	31	21	1	25	15	0
27125334	NixOS	201610	1	0	0	0	1	0	0	0	32	22	1	25	15	0
27125334	NixOS	201611	1	0	0	0	1	1	0	0	33	23	1	26	16	0
27125334	NixOS	201702	6	0	0	0	2	2	0	0	39	25	1	32	18	0
27125334	NixOS	201705	2	0	0	0	2	0	0	0	41	27	1	32	18	0
27125334	NixOS	201707	1	0	0	0	1	1	0	0	42	28	1	33	19	0
27125334	NixOS	201709	2	0	0	0	2	2	0	0	44	30	1	35	21	0
27125334	NixOS	201711	1	0	0	0	1	0	0	0	45	31	1	35	21	0
27125334	NixOS	201712	1	0	0	0	1	1	0	0	46	32	1	36	22	0
27125334	NixOS	201801	1	0	0	0	1	1	0	0	47	33	1	37	23	0
27125334	NixOS	201802	1	0	0	0	1	1	0	0	48	34	1	38	24	0
27125334	NixOS	201804	4	0	0	0	1	1	0	0	52	35	1	42	25	0
27125334	NixOS	201805	4	0	0	0	3	2	0	0	56	38	1	44	27	0
27125334	NixOS	201806	4	0	0	0	1	1	0	0	60	39	1	48	28	0
27125334	NixOS	201807	3	0	0	0	2	1	0	0	63	40	1	49	28	0
22747	OSI_model	200201	6	0	0	0	3	3	0	0	6	3	0	6	2	0
22747	OSI_model	200202	2	0	0	0	1	1	0	0	8	4	0	8	3	0
22747	OSI_model	200204	8	0	0	0	4	3	0	0	16	8	0	15	5	0
22747	OSI_model	200205	4	0	0	0	1	0	0	0	20	9	0	15	5	0
22747	OSI_model	200206	2	0	0	0	2	1	0	0	22	11	0	16	6	0
22747	OSI_model	200209	2	0	0	0	1	1	0	0	24	12	0	18	7	0
22747	OSI_model	200210	1	0	0	0	1	1	0	0	25	13	0	19	8	0
22747	OSI_model	200211	3	0	0	0	2	2	0	0	28	15	0	22	10	0
22747	OSI_model	200212	2	0	0	0	2	1	0	0	30	17	0	23	11	0
22747	OSI_model	200301	1	0	0	0	1	0	0	0	31	18	0	23	11	0
22747	OSI_model	200302	2	0	0	0	1	1	0	0	33	19	0	25	12	0
22747	OSI_model	200303	5	0	0	0	4	3	0	0	38	22	0	29	14	0
22747	OSI_model	200305	4	0	0	0	4	3	0	0	42	25	0	32	16	0
22747	OSI_model	200307	2	0	0	0	2	2	0	0	44	26	0	34	17	0
22747	OSI_model	200309	3	0	0	0	1	0	0	0	47	27	0	34	17	0
22747	OSI_model	200310	7	0	0	0	4	2	0	0	54	30	0	39	18	0
22747	OSI_model	200311	4	0	0	0	3	3	0	0	58	33	0	43	21	0
22747	OSI_model	200312	3	0	0	0	2	2	0	0	61	34	0	46	22	0
22747	OSI_model	200401	7	0	0	0	1	1	0	0	68	35	0	53	23	0
22747	OSI_model	200402	6	1	0	0	3	1	1	0	74	37	1	56	23	0
22747	OSI_model	200403	5	0	0	0	3	1	0	0	79	39	1	58	23	0
22747	OSI_model	200404	11	0	0	0	5	1	0	0	90	44	1	59	24	0
22747	OSI_model	200405	7	0	0	0	6	4	0	0	97	50	1	63	28	0
22747	OSI_model	200406	8	0	0	0	6	3	0	0	105	55	1	66	30	0
22747	OSI_model	200407	12	0	0	0	11	9	0	0	117	63	1	76	36	0
22747	OSI_model	200408	6	0	0	0	5	2	0	0	123	68	1	78	38	0
22747	OSI_model	200409	13	1	0	0	10	3	1	0	136	76	2	82	39	0
22747	OSI_model	200410	17	1	0	0	12	6	1	0	153	86	3	91	44	0
22747	OSI_model	200411	8	1	0	0	7	5	1	0	161	91	4	97	47	0
22747	OSI_model	200412	5	0	0	0	4	3	0	0	166	95	4	101	50	0
22747	OSI_model	200501	12	1	0	0	9	5	1	0	178	102	5	107	53	0
22747	OSI_model	200502	17	1	0	0	11	4	1	0	195	113	6	111	57	0
22747	OSI_model	200503	7	1	0	0	6	3	1	0	202	119	7	114	60	0
22747	OSI_model	200504	6	0	0	0	5	3	0	0	208	124	7	117	63	0
22747	OSI_model	200505	29	4	0	0	12	6	3	0	237	135	11	124	68	0
22747	OSI_model	200506	16	1	0	0	13	4	1	0	253	147	12	131	71	0
22747	OSI_model	200507	20	2	0	0	18	6	2	0	273	164	14	137	76	0
22747	OSI_model	200508	52	4	0	0	34	10	4	0	325	198	18	148	86	0
22747	OSI_model	200509	34	3	0	0	30	7	3	0	359	228	21	157	93	0
22747	OSI_model	200510	20	2	0	0	15	8	2	0	379	242	23	166	100	0
22747	OSI_model	200511	64	9	0	0	37	7	8	0	443	278	32	176	106	0
22747	OSI_model	200512	87	8	0	0	46	13	5	0	530	322	40	200	117	0
22747	OSI_model	200601	48	9	0	0	33	8	8	0	578	353	49	213	123	0
22747	OSI_model	200602	100	15	1	0	49	16	9	1	678	399	64	248	137	1
22747	OSI_model	200603	53	13	0	0	36	13	7	0	731	430	77	272	146	1
22747	OSI_model	200604	83	16	0	0	43	13	9	0	814	469	93	302	155	2
22747	OSI_model	200605	118	24	3	2	55	17	12	2	932	521	117	344	169	3
22747	OSI_model	200606	110	31	3	2	56	19	15	2	1042	567	148	383	180	4
22747	OSI_model	200607	81	13	0	0	56	21	11	0	1123	620	161	415	198	5
22747	OSI_model	200608	90	18	0	0	50	15	10	0	1213	665	179	442	209	6
22747	OSI_model	200609	77	14	0	0	46	18	12	0	1290	703	193	476	220	7
22747	OSI_model	200610	80	21	0	0	58	16	15	0	1370	756	214	502	233	8
22747	OSI_model	200611	68	14	0	0	41	10	6	0	1438	792	228	531	239	9
22747	OSI_model	200612	77	21	1	0	49	17	12	1	1515	835	249	561	250	10
22747	OSI_model	200701	80	18	1	0	51	22	10	1	1595	881	267	596	267	12
22747	OSI_model	200702	125	28	0	0	69	23	14	0	1720	945	295	638	287	12
22747	OSI_model	200703	126	33	0	0	68	26	20	0	1846	1005	328	682	305	13
22747	OSI_model	200704	154	42	2	1	61	26	23	2	2000	1055	370	730	321	17
22747	OSI_model	200705	75	17	0	0	48	17	12	0	2075	1100	387	756	335	17
22747	OSI_model	200706	105	23	0	0	51	19	12	0	2180	1144	410	800	348	18
22747	OSI_model	200707	47	11	0	0	31	11	7	0	2227	1171	421	822	355	19
22747	OSI_model	200708	50	12	1	0	32	11	8	1	2277	1194	433	841	359	21
22747	OSI_model	200709	39	8	0	0	26	14	6	0	2316	1216	441	863	369	24
22747	OSI_model	200710	87	20	0	0	46	14	13	0	2403	1258	461	894	380	26
22747	OSI_model	200711	91	25	0	0	59	18	16	0	2494	1309	486	927	393	26
22747	OSI_model	200712	46	14	0	0	32	13	11	0	2540	1337	500	945	402	26
22747	OSI_model	200801	59	15	0	0	30	15	8	0	2599	1362	515	981	412	30
22747	OSI_model	200802	86	27	0	0	50	22	17	0	2685	1405	542	1016	428	32
22747	OSI_model	200803	106	21	3	1	57	19	14	2	2791	1451	563	1045	437	35
22747	OSI_model	200804	76	21	1	0	51	20	14	1	2867	1495	584	1075	450	36
22747	OSI_model	200805	42	8	0	0	31	12	7	0	2909	1522	592	1089	458	37
22747	OSI_model	200806	72	16	0	0	46	19	11	0	2981	1563	608	1117	472	39
22747	OSI_model	200807	82	21	1	0	49	22	17	1	3063	1605	629	1160	487	42
22747	OSI_model	200808	47	12	0	0	25	11	5	0	3110	1628	641	1189	496	43
22747	OSI_model	200809	68	15	0	0	35	14	5	0	3178	1660	656	1226	507	45
22747	OSI_model	200810	77	25	0	0	53	18	17	0	3255	1707	681	1256	520	46
22747	OSI_model	200811	90	35	2	1	49	20	16	2	3345	1749	716	1300	534	48
22747	OSI_model	200812	66	19	0	0	42	18	11	0	3411	1783	735	1331	544	48
22747	OSI_model	200901	57	19	0	0	38	14	15	0	3468	1816	754	1352	553	50
22747	OSI_model	200902	73	21	0	0	52	21	13	0	3541	1862	775	1384	569	51
22747	OSI_model	200903	88	27	1	0	42	10	12	1	3629	1899	802	1409	574	53
22747	OSI_model	200904	68	18	0	0	38	17	12	0	3697	1928	820	1450	585	53
22747	OSI_model	200905	65	18	0	0	29	12	8	0	3762	1951	838	1489	592	55
22747	OSI_model	200906	41	13	0	0	27	11	8	0	3803	1975	851	1505	600	58
22747	OSI_model	200907	43	13	0	0	29	12	8	0	3846	2000	864	1523	608	58
22747	OSI_model	200908	38	12	0	0	25	12	10	0	3884	2017	876	1537	612	59
22747	OSI_model	200909	51	14	0	0	32	14	10	0	3935	2045	890	1558	622	61
22747	OSI_model	200910	55	11	0	0	27	14	5	0	3990	2068	901	1589	632	63
22747	OSI_model	200911	45	9	0	0	27	8	8	0	4035	2091	910	1601	637	63
22747	OSI_model	200912	45	14	0	0	28	10	8	0	4080	2115	924	1617	643	63
22747	OSI_model	201001	48	13	0	0	37	11	12	0	4128	2149	937	1631	651	65
22747	OSI_model	201002	66	17	0	0	41	8	8	0	4194	2184	954	1649	655	65
22747	OSI_model	201003	51	15	0	0	31	12	9	0	4245	2211	969	1678	664	70
22747	OSI_model	201004	112	28	0	0	55	19	16	0	4357	2261	997	1720	679	71
22747	OSI_model	201005	36	7	0	0	24	10	7	0	4393	2282	1004	1731	687	72
22747	OSI_model	201006	77	17	0	0	49	17	11	0	4470	2326	1021	1755	700	73
22747	OSI_model	201007	65	13	0	0	37	13	7	0	4535	2358	1034	1775	708	74
22747	OSI_model	201008	43	11	0	0	27	7	5	0	4578	2381	1045	1790	712	74
22747	OSI_model	201009	37	9	0	0	24	7	4	0	4615	2401	1054	1805	716	75
22747	OSI_model	201010	53	13	0	0	31	16	9	0	4668	2425	1067	1829	725	75
22747	OSI_model	201011	66	15	0	0	44	23	14	0	4734	2461	1082	1858	741	77
22747	OSI_model	201012	77	24	1	0	40	16	12	1	4811	2490	1106	1892	748	79
22747	OSI_model	201101	28	12	0	0	23	9	8	0	4839	2508	1118	1905	752	80
22747	OSI_model	201102	24	6	0	0	20	5	3	0	4863	2524	1124	1913	754	80
22747	OSI_model	201103	31	8	0	0	23	10	6	0	4894	2541	1132	1926	758	80
22747	OSI_model	201104	28	9	0	0	22	8	7	0	4922	2559	1141	1937	762	80
22747	OSI_model	201105	23	4	0	0	14	8	4	0	4945	2568	1145	1947	765	81
22747	OSI_model	201106	43	15	1	0	32	16	8	1	4988	2595	1160	1971	776	83
22747	OSI_model	201107	8	3	0	0	8	5	3	0	4996	2601	1163	1976	779	83
22747	OSI_model	201108	27	9	0	0	18	9	5	0	5023	2615	1172	1991	784	85
22747	OSI_model	201109	35	11	0	0	21	11	6	0	5058	2633	1183	2004	792	86
22747	OSI_model	201110	46	12	0	0	26	10	8	0	5104	2654	1195	2025	797	87
22747	OSI_model	201111	35	9	0	0	25	13	8	0	5139	2674	1204	2046	805	88
22747	OSI_model	201112	17	6	0	0	12	5	3	0	5156	2681	1210	2054	806	89
22747	OSI_model	201201	17	7	0	0	13	4	4	0	5173	2690	1217	2061	807	89
22747	OSI_model	201202	48	16	0	0	28	10	6	0	5221	2713	1233	2085	812	90
22747	OSI_model	201203	19	5	0	0	15	7	4	0	5240	2725	1238	2095	816	90
22747	OSI_model	201204	33	11	0	0	21	9	7	0	5273	2741	1249	2111	820	91
22747	OSI_model	201205	20	4	0	0	17	6	4	0	5293	2754	1253	2117	822	91
22747	OSI_model	201206	30	10	0	0	24	8	7	0	5323	2773	1263	2129	826	91
22747	OSI_model	201207	23	9	1	0	14	4	4	1	5346	2785	1272	2139	828	92
22747	OSI_model	201208	20	5	0	0	13	6	4	0	5366	2796	1277	2146	832	93
22747	OSI_model	201209	55	14	2	1	24	11	9	2	5421	2813	1291	2170	836	95
22747	OSI_model	201210	30	7	0	0	27	10	5	0	5451	2836	1298	2183	842	95
22747	OSI_model	201211	27	9	0	0	19	7	6	0	5478	2852	1307	2193	846	95
22747	OSI_model	201212	16	8	0	0	13	7	6	0	5494	2861	1315	2203	849	96
22747	OSI_model	201301	34	12	0	0	23	11	8	0	5528	2877	1327	2218	853	96
22747	OSI_model	201302	32	11	0	0	19	9	6	0	5560	2893	1338	2234	859	97
22747	OSI_model	201303	31	8	0	0	18	7	6	0	5591	2907	1346	2244	862	97
22747	OSI_model	201304	26	9	0	0	22	10	7	0	5617	2922	1355	2256	865	98
22747	OSI_model	201305	47	13	0	0	27	11	7	0	5664	2943	1368	2273	870	98
22747	OSI_model	201306	35	6	0	0	23	8	6	0	5699	2962	1374	2282	874	98
22747	OSI_model	201307	9	4	0	0	9	6	4	0	5708	2970	1378	2288	878	99
22747	OSI_model	201308	39	14	0	0	24	9	7	0	5747	2990	1392	2306	882	100
22747	OSI_model	201309	29	7	0	0	19	8	4	0	5776	3006	1399	2318	887	100
22747	OSI_model	201310	42	10	0	0	30	12	10	0	5818	3030	1409	2330	894	102
22747	OSI_model	201311	31	8	0	0	26	9	7	0	5849	3052	1417	2341	898	102
22747	OSI_model	201312	31	8	0	0	17	5	5	0	5880	3065	1425	2349	899	102
22747	OSI_model	201401	14	6	0	0	11	5	5	0	5894	3074	1431	2355	902	102
22747	OSI_model	201402	35	10	0	0	24	8	6	0	5929	3091	1441	2367	904	102
22747	OSI_model	201403	27	6	0	0	19	6	5	0	5956	3105	1447	2374	905	102
22747	OSI_model	201404	33	14	0	0	19	7	7	0	5989	3118	1461	2390	906	104
22747	OSI_model	201405	30	9	0	0	17	4	4	0	6019	3131	1470	2402	906	104
22747	OSI_model	201406	33	12	0	0	26	10	7	0	6052	3151	1482	2417	910	104
22747	OSI_model	201407	25	5	0	0	17	9	5	0	6077	3165	1487	2427	916	105
22747	OSI_model	201408	46	12	1	0	22	7	5	1	6123	3185	1499	2445	921	107
22747	OSI_model	201409	18	6	0	0	10	6	4	0	6141	3192	1505	2453	925	108
22747	OSI_model	201410	26	4	0	0	18	10	4	0	6167	3207	1509	2469	932	108
22747	OSI_model	201411	26	4	0	0	20	7	4	0	6193	3223	1513	2477	935	108
22747	OSI_model	201412	18	3	0	0	12	9	3	0	6211	3232	1516	2492	941	108
22747	OSI_model	201501	40	7	0	0	20	7	5	0	6251	3249	1523	2508	945	109
22747	OSI_model	201502	28	6	0	0	19	10	4	0	6279	3262	1529	2523	949	111
22747	OSI_model	201503	36	6	0	0	17	7	4	0	6315	3275	1535	2536	952	111
22747	OSI_model	201504	16	2	0	0	12	3	2	0	6331	3285	1537	2539	953	111
22747	OSI_model	201505	17	1	0	0	7	2	1	0	6348	3291	1538	2542	954	111
22747	OSI_model	201506	6	0	0	0	4	4	0	0	6354	3294	1538	2548	957	111
22747	OSI_model	201507	23	4	0	0	14	6	4	0	6377	3304	1542	2560	959	111
22747	OSI_model	201508	40	5	0	0	12	6	4	0	6417	3313	1547	2568	962	111
22747	OSI_model	201509	38	10	0	0	22	7	6	0	6455	3331	1557	2581	965	112
22747	OSI_model	201510	25	5	0	0	13	6	3	0	6480	3341	1562	2595	968	112
22747	OSI_model	201511	39	9	0	0	24	8	7	0	6519	3360	1571	2612	971	113
22747	OSI_model	201512	30	5	0	0	17	10	5	0	6549	3372	1576	2623	975	114
22747	OSI_model	201601	22	6	0	0	15	6	5	0	6571	3382	1582	2632	977	114
22747	OSI_model	201602	44	9	0	0	22	7	5	0	6615	3399	1591	2652	979	114
22747	OSI_model	201603	42	11	0	0	23	9	6	0	6657	3418	1602	2670	983	114
22747	OSI_model	201604	30	9	0	0	20	7	5	0	6687	3433	1611	2681	985	114
22747	OSI_model	201605	32	10	1	0	18	11	7	1	6719	3442	1621	2705	987	118
22747	OSI_model	201606	39	7	0	0	18	7	3	0	6758	3456	1628	2725	988	120
22747	OSI_model	201607	12	4	2	1	7	4	3	2	6770	3461	1632	2731	989	122
22747	OSI_model	201608	5	1	0	0	4	2	1	0	6775	3462	1633	2733	989	122
22747	OSI_model	201609	81	13	0	0	24	12	7	0	6856	3478	1646	2768	992	123
22747	OSI_model	201610	25	11	1	1	13	10	6	1	6881	3485	1657	2784	996	126
22747	OSI_model	201611	17	5	0	0	15	7	4	0	6898	3497	1662	2792	1000	126
22747	OSI_model	201612	25	9	0	0	17	8	6	0	6923	3509	1671	2805	1003	127
22747	OSI_model	201701	28	13	1	0	17	11	8	1	6951	3519	1684	2823	1006	134
22747	OSI_model	201702	57	17	1	1	24	12	11	1	7008	3538	1701	2842	1014	134
22747	OSI_model	201703	4	1	0	0	4	2	1	0	7012	3541	1702	2844	1015	134
22747	OSI_model	201704	15	5	0	0	12	7	5	0	7027	3549	1707	2853	1018	134
22747	OSI_model	201705	5	2	0	0	4	2	2	0	7032	3551	1709	2855	1018	134
22747	OSI_model	201706	7	2	0	0	6	5	2	0	7039	3556	1711	2861	1021	135
22747	OSI_model	201707	16	2	0	0	7	4	2	0	7055	3559	1713	2866	1022	135
22747	OSI_model	201708	25	10	0	0	14	9	6	0	7080	3570	1723	2881	1028	136
22747	OSI_model	201709	13	1	0	0	11	5	1	0	7093	3578	1724	2887	1030	136
22747	OSI_model	201710	28	8	3	1	14	10	6	2	7121	3589	1732	2903	1036	140
22747	OSI_model	201711	12	2	0	0	8	5	2	0	7133	3594	1734	2911	1038	140
22747	OSI_model	201712	11	4	0	0	10	5	4	0	7144	3601	1738	2916	1040	140
22747	OSI_model	201801	3	0	0	0	3	3	0	0	7147	3604	1738	2919	1042	140
22747	OSI_model	201802	5	2	0	0	4	3	1	0	7152	3607	1740	2923	1043	141
22747	OSI_model	201803	23	8	0	0	15	8	4	0	7175	3619	1748	2937	1046	144
22747	OSI_model	201804	6	3	0	0	6	3	3	0	7181	3623	1751	2940	1047	144
22747	OSI_model	201805	5	2	0	0	5	3	2	0	7186	3626	1753	2943	1048	144
22747	OSI_model	201806	23	4	0	0	13	11	2	0	7209	3636	1757	2964	1053	147
22747	OSI_model	201807	4	1	0	0	4	3	1	0	7213	3638	1758	2967	1054	147
22189692	Oauth	200904	1	0	0	0	1	1	0	0	1	1	0	1	1	0
49681	Ontology_(information_science)	200205	1	0	0	0	1	1	0	0	1	1	0	1	1	0
49681	Ontology_(information_science)	200206	3	0	0	0	2	1	0	0	4	3	0	3	2	0
49681	Ontology_(information_science)	200210	1	0	0	0	1	0	0	0	5	4	0	3	2	0
49681	Ontology_(information_science)	200211	2	0	0	0	1	1	0	0	7	5	0	5	3	0
49681	Ontology_(information_science)	200212	2	0	0	0	2	0	0	0	9	7	0	5	3	0
49681	Ontology_(information_science)	200302	4	0	0	0	4	1	0	0	13	11	0	6	4	0
49681	Ontology_(information_science)	200303	3	0	0	0	3	3	0	0	16	14	0	9	7	0
49681	Ontology_(information_science)	200304	2	0	0	0	2	0	0	0	18	16	0	9	7	0
49681	Ontology_(information_science)	200305	1	0	0	0	1	1	0	0	19	17	0	10	8	0
49681	Ontology_(information_science)	200306	2	0	0	0	1	0	0	0	21	18	0	10	8	0
49681	Ontology_(information_science)	200308	2	0	0	0	1	1	0	0	23	19	0	12	9	0
49681	Ontology_(information_science)	200309	9	0	0	0	2	1	0	0	32	21	0	19	10	0
49681	Ontology_(information_science)	200311	3	0	0	0	3	2	0	0	35	24	0	21	12	0
49681	Ontology_(information_science)	200312	4	0	0	0	3	2	0	0	39	26	0	24	13	0
49681	Ontology_(information_science)	200401	1	0	0	0	1	1	0	0	40	27	0	25	14	0
49681	Ontology_(information_science)	200402	2	0	0	0	1	0	0	0	42	28	0	25	14	0
49681	Ontology_(information_science)	200403	5	0	0	0	5	3	0	0	47	32	0	28	16	0
49681	Ontology_(information_science)	200404	1	0	0	0	1	1	0	0	48	33	0	29	17	0
49681	Ontology_(information_science)	200405	1	0	0	0	1	1	0	0	49	34	0	30	18	0
49681	Ontology_(information_science)	200406	7	0	0	0	3	3	0	0	56	37	0	37	21	0
49681	Ontology_(information_science)	200407	8	0	0	0	4	4	0	0	64	40	0	45	24	0
49681	Ontology_(information_science)	200409	8	0	0	0	7	4	0	0	72	46	0	49	27	0
49681	Ontology_(information_science)	200410	3	0	0	0	3	2	0	0	75	49	0	51	29	0
49681	Ontology_(information_science)	200411	7	1	0	0	5	2	1	0	82	54	1	53	31	0
49681	Ontology_(information_science)	200412	2	0	0	0	2	2	0	0	84	56	1	55	33	0
49681	Ontology_(information_science)	200501	7	0	0	0	4	2	0	0	91	59	1	59	34	0
49681	Ontology_(information_science)	200502	2	0	0	0	2	1	0	0	93	60	1	60	34	0
49681	Ontology_(information_science)	200503	21	2	0	0	8	3	2	0	114	67	3	65	37	1
49681	Ontology_(information_science)	200504	13	1	0	0	10	6	1	0	127	75	4	73	41	1
49681	Ontology_(information_science)	200505	29	0	0	0	9	7	0	0	156	82	4	80	46	1
49681	Ontology_(information_science)	200506	6	0	0	0	5	3	0	0	162	87	4	83	49	1
49681	Ontology_(information_science)	200507	17	0	0	0	11	5	0	0	179	97	4	90	53	1
49681	Ontology_(information_science)	200508	7	0	0	0	6	2	0	0	186	103	4	92	55	1
49681	Ontology_(information_science)	200509	4	1	0	0	4	2	1	0	190	107	5	94	57	1
49681	Ontology_(information_science)	200510	8	1	0	0	8	3	1	0	198	115	6	97	60	1
49681	Ontology_(information_science)	200511	5	0	0	0	5	2	0	0	203	120	6	99	62	1
49681	Ontology_(information_science)	200512	40	1	0	0	11	4	1	0	243	130	7	130	65	2
49681	Ontology_(information_science)	200601	16	2	0	0	13	5	1	0	259	142	9	138	69	2
49681	Ontology_(information_science)	200602	12	0	0	0	10	4	0	0	271	152	9	142	73	2
49681	Ontology_(information_science)	200603	23	0	0	0	13	7	0	0	294	164	9	154	79	2
49681	Ontology_(information_science)	200604	36	0	0	0	11	7	0	0	330	174	9	186	85	2
49681	Ontology_(information_science)	200605	41	0	0	0	19	11	0	0	371	189	9	216	92	2
49681	Ontology_(information_science)	200606	15	1	0	0	11	3	1	0	386	198	10	219	93	2
49681	Ontology_(information_science)	200607	15	0	0	0	8	5	0	0	401	205	10	225	98	2
49681	Ontology_(information_science)	200608	6	0	0	0	6	4	0	0	407	210	10	229	101	2
49681	Ontology_(information_science)	200609	8	1	0	0	7	3	1	0	415	215	11	232	102	2
49681	Ontology_(information_science)	200610	3	0	0	0	2	2	0	0	418	216	11	235	103	2
49681	Ontology_(information_science)	200611	20	1	0	0	15	11	1	0	438	231	12	247	114	2
49681	Ontology_(information_science)	200612	7	0	0	0	7	3	0	0	445	237	12	250	116	2
49681	Ontology_(information_science)	200701	4	0	0	0	4	1	0	0	449	240	12	251	116	2
49681	Ontology_(information_science)	200702	23	3	0	0	10	5	2	0	472	248	15	261	119	2
49681	Ontology_(information_science)	200703	13	0	0	0	6	5	0	0	485	253	15	273	123	2
49681	Ontology_(information_science)	200704	15	3	0	0	13	10	3	0	500	265	18	285	132	3
49681	Ontology_(information_science)	200705	8	0	0	0	8	3	0	0	508	273	18	288	135	3
49681	Ontology_(information_science)	200706	15	1	0	0	14	7	1	0	523	285	19	296	140	3
49681	Ontology_(information_science)	200707	13	0	0	0	4	1	0	0	536	289	19	305	141	3
49681	Ontology_(information_science)	200708	11	1	0	0	8	4	1	0	547	296	20	310	144	3
49681	Ontology_(information_science)	200709	5	0	0	0	4	3	0	0	552	300	20	313	147	3
49681	Ontology_(information_science)	200710	20	1	0	0	11	5	1	0	572	310	21	325	151	4
49681	Ontology_(information_science)	200711	4	0	0	0	4	3	0	0	576	313	21	328	153	4
49681	Ontology_(information_science)	200712	4	0	0	0	4	3	0	0	580	317	21	331	156	4
49681	Ontology_(information_science)	200801	8	0	0	0	5	3	0	0	588	321	21	335	158	4
49681	Ontology_(information_science)	200802	14	0	0	0	5	4	0	0	602	325	21	345	161	4
49681	Ontology_(information_science)	200803	14	2	0	0	8	4	2	0	616	331	23	354	163	5
49681	Ontology_(information_science)	200804	8	1	0	0	6	5	1	0	624	337	24	361	168	5
49681	Ontology_(information_science)	200805	6	0	0	0	6	2	0	0	630	342	24	363	169	5
49681	Ontology_(information_science)	200806	5	1	0	0	4	3	1	0	635	346	25	367	172	6
49681	Ontology_(information_science)	200807	6	0	0	0	6	3	0	0	641	350	25	370	173	6
49681	Ontology_(information_science)	200808	9	0	0	0	5	2	0	0	650	352	25	373	173	6
49681	Ontology_(information_science)	200809	4	0	0	0	3	2	0	0	654	354	25	376	174	6
49681	Ontology_(information_science)	200810	4	1	0	0	4	3	1	0	658	358	26	379	177	6
49681	Ontology_(information_science)	200811	21	0	0	0	4	4	0	0	679	362	26	400	181	6
49681	Ontology_(information_science)	200812	23	0	0	0	9	4	0	0	702	369	26	418	183	6
49681	Ontology_(information_science)	200901	13	1	0	0	9	8	1	0	715	374	27	430	187	6
49681	Ontology_(information_science)	200902	11	1	0	0	10	4	1	0	726	384	28	434	191	6
49681	Ontology_(information_science)	200903	2	0	0	0	2	2	0	0	728	385	28	436	192	6
49681	Ontology_(information_science)	200904	16	1	0	0	12	8	1	0	744	394	29	447	197	7
49681	Ontology_(information_science)	200905	9	2	0	0	7	5	2	0	753	401	31	453	202	8
49681	Ontology_(information_science)	200906	5	0	0	0	5	4	0	0	758	405	31	457	205	8
49681	Ontology_(information_science)	200907	9	1	0	0	8	7	1	0	767	411	32	465	210	9
49681	Ontology_(information_science)	200908	11	1	0	0	8	5	1	0	778	417	33	473	213	9
49681	Ontology_(information_science)	200909	10	1	0	0	5	5	1	0	788	418	34	483	214	10
49681	Ontology_(information_science)	200910	7	0	0	0	4	3	0	0	795	422	34	489	217	10
49681	Ontology_(information_science)	200911	5	0	0	0	3	3	0	0	800	425	34	494	220	10
49681	Ontology_(information_science)	200912	4	0	0	0	3	3	0	0	804	427	34	498	222	10
49681	Ontology_(information_science)	201001	5	0	0	0	4	3	0	0	809	430	34	502	224	10
49681	Ontology_(information_science)	201002	16	1	0	0	5	4	1	0	825	434	35	517	227	11
49681	Ontology_(information_science)	201003	12	1	0	0	8	7	1	0	837	438	36	528	230	11
49681	Ontology_(information_science)	201004	4	0	0	0	4	3	0	0	841	442	36	531	233	11
49681	Ontology_(information_science)	201005	5	0	0	0	4	3	0	0	846	446	36	535	236	11
49681	Ontology_(information_science)	201007	7	1	0	0	6	3	1	0	853	451	37	539	238	11
49681	Ontology_(information_science)	201008	3	0	0	0	2	2	0	0	856	453	37	542	240	11
49681	Ontology_(information_science)	201009	17	1	0	0	7	6	1	0	873	459	38	558	245	12
49681	Ontology_(information_science)	201010	4	1	0	0	4	3	1	0	877	461	39	561	246	12
49681	Ontology_(information_science)	201011	4	0	0	0	4	3	0	0	881	465	39	564	249	12
49681	Ontology_(information_science)	201012	3	1	0	0	3	1	1	0	884	468	40	565	250	12
49681	Ontology_(information_science)	201101	1	0	0	0	1	1	0	0	885	469	40	566	251	12
49681	Ontology_(information_science)	201102	1	0	0	0	1	1	0	0	886	470	40	567	252	12
49681	Ontology_(information_science)	201103	18	2	0	0	12	7	1	0	904	480	42	577	257	12
49681	Ontology_(information_science)	201104	6	0	0	0	5	2	0	0	910	485	42	579	259	12
49681	Ontology_(information_science)	201105	3	0	0	0	3	2	0	0	913	487	42	581	260	12
49681	Ontology_(information_science)	201106	11	1	0	0	6	4	1	0	924	493	43	589	264	12
49681	Ontology_(information_science)	201107	10	0	0	0	7	6	0	0	934	498	43	598	268	12
49681	Ontology_(information_science)	201108	7	1	0	0	7	6	1	0	941	504	44	604	273	12
49681	Ontology_(information_science)	201109	6	0	0	0	5	2	0	0	947	509	44	606	275	12
49681	Ontology_(information_science)	201110	5	0	0	0	4	4	0	0	952	511	44	611	277	12
49681	Ontology_(information_science)	201111	2	0	0	0	1	0	0	0	954	512	44	611	277	12
49681	Ontology_(information_science)	201112	11	2	0	0	8	4	2	0	965	518	46	617	279	12
49681	Ontology_(information_science)	201201	1	0	0	0	1	1	0	0	966	519	46	618	280	12
49681	Ontology_(information_science)	201202	6	0	0	0	5	2	0	0	972	524	46	620	282	12
49681	Ontology_(information_science)	201203	1	0	0	0	1	0	0	0	973	525	46	620	282	12
49681	Ontology_(information_science)	201204	5	1	0	0	5	3	1	0	978	528	47	623	283	12
49681	Ontology_(information_science)	201206	3	0	0	0	3	1	0	0	981	530	47	624	283	12
49681	Ontology_(information_science)	201207	4	0	0	0	3	3	0	0	985	533	47	628	286	12
49681	Ontology_(information_science)	201209	12	0	0	0	8	7	0	0	997	539	47	639	291	12
49681	Ontology_(information_science)	201210	2	0	0	0	2	2	0	0	999	541	47	641	293	12
49681	Ontology_(information_science)	201211	1	0	0	0	1	1	0	0	1000	542	47	642	294	12
49681	Ontology_(information_science)	201212	10	1	0	0	7	4	1	0	1010	548	48	647	297	12
49681	Ontology_(information_science)	201301	1	0	0	0	1	1	0	0	1011	548	48	648	297	12
49681	Ontology_(information_science)	201302	4	0	0	0	3	3	0	0	1015	550	48	652	299	12
49681	Ontology_(information_science)	201303	7	0	0	0	4	3	0	0	1022	553	48	658	301	12
49681	Ontology_(information_science)	201304	15	0	0	0	7	5	0	0	1037	559	48	665	305	12
49681	Ontology_(information_science)	201305	4	1	0	0	3	2	1	0	1041	560	49	668	305	12
49681	Ontology_(information_science)	201306	5	0	0	0	4	2	0	0	1046	564	49	670	307	12
49681	Ontology_(information_science)	201307	1	0	0	0	1	1	0	0	1047	565	49	671	308	12
49681	Ontology_(information_science)	201308	8	4	0	0	7	4	4	0	1055	571	53	675	311	13
49681	Ontology_(information_science)	201309	5	0	0	0	4	3	0	0	1060	573	53	679	311	13
49681	Ontology_(information_science)	201310	2	0	0	0	2	2	0	0	1062	575	53	681	313	13
49681	Ontology_(information_science)	201311	18	0	0	0	11	8	0	0	1080	583	53	693	318	13
49681	Ontology_(information_science)	201312	2	0	0	0	1	1	0	0	1082	584	53	695	319	13
49681	Ontology_(information_science)	201401	2	0	0	0	2	1	0	0	1084	586	53	696	320	13
49681	Ontology_(information_science)	201402	10	0	0	0	5	5	0	0	1094	590	53	706	324	13
49681	Ontology_(information_science)	201403	5	1	0	0	5	3	1	0	1099	595	54	709	326	13
49681	Ontology_(information_science)	201404	10	0	0	0	7	5	0	0	1109	602	54	715	331	13
49681	Ontology_(information_science)	201405	6	0	0	0	5	4	0	0	1115	605	54	720	333	13
49681	Ontology_(information_science)	201406	2	1	0	0	2	1	1	0	1117	606	55	721	333	13
49681	Ontology_(information_science)	201408	5	0	0	0	3	2	0	0	1122	608	55	723	334	13
49681	Ontology_(information_science)	201410	6	0	0	0	2	1	0	0	1128	609	55	724	334	13
49681	Ontology_(information_science)	201411	2	0	0	0	2	2	0	0	1130	610	55	726	335	13
49681	Ontology_(information_science)	201412	6	0	0	0	3	3	0	0	1136	613	55	732	338	13
49681	Ontology_(information_science)	201502	3	0	0	0	3	2	0	0	1139	615	55	734	339	13
49681	Ontology_(information_science)	201503	6	0	0	0	5	4	0	0	1145	619	55	739	342	13
49681	Ontology_(information_science)	201504	2	0	0	0	2	2	0	0	1147	620	55	741	343	13
49681	Ontology_(information_science)	201505	8	2	0	0	4	1	1	0	1155	623	57	743	343	13
49681	Ontology_(information_science)	201506	3	1	0	0	3	3	1	0	1158	625	58	746	344	14
49681	Ontology_(information_science)	201508	2	0	0	0	2	1	0	0	1160	626	58	747	344	14
49681	Ontology_(information_science)	201509	8	2	0	0	7	6	2	0	1168	630	60	753	347	15
49681	Ontology_(information_science)	201511	5	1	0	0	4	4	1	0	1173	633	61	758	350	16
49681	Ontology_(information_science)	201512	1	0	0	0	1	1	0	0	1174	634	61	759	351	16
49681	Ontology_(information_science)	201601	4	0	0	0	2	2	0	0	1178	635	61	763	352	16
49681	Ontology_(information_science)	201602	10	1	0	0	7	6	1	0	1188	640	62	772	356	16
49681	Ontology_(information_science)	201603	2	1	0	0	2	2	1	0	1190	642	63	774	358	17
49681	Ontology_(information_science)	201604	1	0	0	0	1	1	0	0	1191	643	63	775	359	17
49681	Ontology_(information_science)	201605	2	0	0	0	2	2	0	0	1193	644	63	777	360	17
49681	Ontology_(information_science)	201606	4	1	0	0	3	2	1	0	1197	646	64	780	361	17
49681	Ontology_(information_science)	201607	2	0	0	0	1	1	0	0	1199	647	64	782	362	17
49681	Ontology_(information_science)	201608	4	1	0	0	4	4	1	0	1203	650	65	786	365	18
49681	Ontology_(information_science)	201609	7	2	0	0	5	4	2	0	1210	655	67	792	369	20
49681	Ontology_(information_science)	201610	12	1	0	0	5	3	1	0	1222	660	68	802	372	20
49681	Ontology_(information_science)	201611	7	2	0	0	6	5	2	0	1229	664	70	807	375	20
49681	Ontology_(information_science)	201612	6	0	0	0	5	5	0	0	1235	667	70	813	378	20
49681	Ontology_(information_science)	201701	2	0	0	0	2	2	0	0	1237	669	70	815	379	20
49681	Ontology_(information_science)	201702	1	0	0	0	1	1	0	0	1238	670	70	816	380	20
49681	Ontology_(information_science)	201703	4	1	0	0	4	3	1	0	1242	672	71	819	381	20
49681	Ontology_(information_science)	201704	7	2	0	0	5	4	2	0	1249	676	73	825	384	21
49681	Ontology_(information_science)	201705	3	0	0	0	1	1	0	0	1252	676	73	828	384	21
49681	Ontology_(information_science)	201706	2	0	0	0	2	1	0	0	1254	678	73	829	385	21
49681	Ontology_(information_science)	201707	9	2	0	0	7	6	1	0	1263	683	75	837	389	23
49681	Ontology_(information_science)	201708	9	1	0	0	6	5	1	0	1272	689	76	844	394	23
49681	Ontology_(information_science)	201709	6	1	0	0	5	3	1	0	1278	692	77	847	395	23
49681	Ontology_(information_science)	201710	3	0	0	0	2	2	0	0	1281	693	77	850	396	23
49681	Ontology_(information_science)	201711	11	1	0	0	6	5	1	0	1292	697	78	860	399	23
49681	Ontology_(information_science)	201712	10	0	0	0	5	3	0	0	1302	701	78	868	401	23
49681	Ontology_(information_science)	201801	1	0	0	0	1	1	0	0	1303	701	78	869	401	23
49681	Ontology_(information_science)	201802	7	0	0	0	3	1	0	0	1310	704	78	872	402	23
49681	Ontology_(information_science)	201803	4	2	0	0	4	4	2	0	1314	707	80	876	404	25
49681	Ontology_(information_science)	201804	2	0	0	0	2	2	0	0	1316	707	80	878	404	25
49681	Ontology_(information_science)	201805	5	1	0	0	5	5	1	0	1321	710	81	883	407	26
49681	Ontology_(information_science)	201806	12	1	0	0	9	7	1	0	1333	716	82	893	411	26
49681	Ontology_(information_science)	201807	8	0	0	0	3	3	0	0	1341	717	82	901	412	26
1464042	Open-source_hardware	200505	3	0	0	0	2	2	0	0	3	2	0	3	2	0
1464042	Open-source_hardware	200506	1	0	0	0	1	1	0	0	4	2	0	4	2	0
1464042	Open-source_hardware	200510	1	0	0	0	1	1	0	0	5	3	0	5	3	0
1464042	Open-source_hardware	200512	6	0	0	0	5	2	0	0	11	8	0	7	5	0
1464042	Open-source_hardware	200601	7	0	0	0	3	1	0	0	18	11	0	8	6	0
1464042	Open-source_hardware	200602	1	0	0	0	1	1	0	0	19	12	0	9	7	0
1464042	Open-source_hardware	200603	7	0	0	0	5	1	0	0	26	17	0	10	8	0
1464042	Open-source_hardware	200604	4	0	0	0	4	3	0	0	30	21	0	13	11	0
1464042	Open-source_hardware	200605	5	0	0	0	4	2	0	0	35	25	0	16	13	0
1464042	Open-source_hardware	200606	5	0	0	0	5	4	0	0	40	30	0	20	17	0
1464042	Open-source_hardware	200607	14	0	0	0	7	6	0	0	54	37	0	32	23	0
1464042	Open-source_hardware	200608	4	2	0	0	3	1	1	0	58	40	2	34	24	0
1464042	Open-source_hardware	200609	8	0	0	0	6	4	0	0	66	45	2	39	27	0
1464042	Open-source_hardware	200610	12	0	0	0	4	2	0	0	78	48	2	49	28	0
1464042	Open-source_hardware	200611	1	0	0	0	1	1	0	0	79	49	2	50	29	0
1464042	Open-source_hardware	200612	8	0	0	0	2	1	0	0	87	50	2	51	29	0
1464042	Open-source_hardware	200701	16	1	0	0	9	7	1	0	103	58	3	64	35	0
1464042	Open-source_hardware	200702	27	0	0	0	14	8	0	0	130	69	3	83	40	0
1464042	Open-source_hardware	200703	9	2	0	0	8	2	2	0	139	77	5	85	42	0
1464042	Open-source_hardware	200704	3	0	0	0	3	1	0	0	142	80	5	86	43	0
1464042	Open-source_hardware	200705	12	0	0	0	5	4	0	0	154	84	5	97	46	0
1464042	Open-source_hardware	200706	17	1	0	0	12	8	1	0	171	93	6	109	52	0
1464042	Open-source_hardware	200707	6	2	0	0	5	5	2	0	177	98	8	115	57	2
1464042	Open-source_hardware	200708	6	0	0	0	4	2	0	0	183	101	8	118	58	2
1464042	Open-source_hardware	200709	10	1	0	0	10	5	1	0	193	110	9	123	62	2
1464042	Open-source_hardware	200710	9	0	0	0	8	5	0	0	202	116	9	128	65	2
1464042	Open-source_hardware	200711	5	1	0	0	5	3	1	0	207	120	10	131	67	2
1464042	Open-source_hardware	200712	11	1	0	0	8	4	1	0	218	128	11	136	71	2
1464042	Open-source_hardware	200801	2	0	0	0	2	1	0	0	220	130	11	137	72	2
1464042	Open-source_hardware	200802	9	0	0	0	7	3	0	0	229	136	11	141	74	2
1464042	Open-source_hardware	200803	41	0	0	0	4	4	0	0	270	137	11	182	75	2
1464042	Open-source_hardware	200804	22	3	0	0	11	9	2	0	292	146	14	200	82	2
1464042	Open-source_hardware	200805	6	0	0	0	5	3	0	0	298	150	14	204	84	2
1464042	Open-source_hardware	200806	7	1	0	0	7	4	1	0	305	156	15	208	87	2
1464042	Open-source_hardware	200807	13	0	0	0	9	6	0	0	318	161	15	217	89	2
1464042	Open-source_hardware	200808	24	0	0	0	10	6	0	0	342	169	15	236	93	2
1464042	Open-source_hardware	200809	6	0	0	0	4	3	0	0	348	172	15	241	95	2
1464042	Open-source_hardware	200810	4	0	0	0	3	2	0	0	352	174	15	244	96	2
1464042	Open-source_hardware	200811	17	1	0	0	7	4	1	0	369	178	16	258	97	2
1464042	Open-source_hardware	200812	56	9	3	2	22	14	6	2	425	195	25	303	106	8
1464042	Open-source_hardware	200901	6	1	0	0	4	2	1	0	431	198	26	305	107	8
1464042	Open-source_hardware	200902	8	0	0	0	6	3	0	0	439	203	26	308	109	8
1464042	Open-source_hardware	200903	27	3	1	0	10	6	3	1	466	211	29	320	113	9
1464042	Open-source_hardware	200904	9	0	0	0	7	1	0	0	475	217	29	321	113	9
1464042	Open-source_hardware	200905	14	6	2	1	7	6	4	2	489	222	35	334	117	14
1464042	Open-source_hardware	200906	10	0	0	0	4	2	0	0	499	224	35	337	117	14
1464042	Open-source_hardware	200907	2	0	0	0	1	1	0	0	501	225	35	339	118	14
1464042	Open-source_hardware	200908	12	2	0	0	8	4	2	0	513	232	37	347	121	15
1464042	Open-source_hardware	200909	10	3	0	0	6	3	3	0	523	236	40	350	122	15
1464042	Open-source_hardware	200910	7	2	0	0	6	5	1	0	530	242	42	356	127	16
1464042	Open-source_hardware	200911	7	0	0	0	7	4	0	0	537	248	42	360	130	16
1464042	Open-source_hardware	200912	16	2	0	0	10	5	2	0	553	255	44	365	132	16
1464042	Open-source_hardware	201001	72	1	0	0	26	12	1	0	625	277	45	400	140	17
1464042	Open-source_hardware	201002	17	2	0	0	10	8	2	0	642	286	47	413	147	19
1464042	Open-source_hardware	201003	2	0	0	0	2	2	0	0	644	287	47	415	148	19
1464042	Open-source_hardware	201004	1	0	0	0	1	0	0	0	645	288	47	415	148	19
1464042	Open-source_hardware	201005	5	0	0	0	5	5	0	0	650	293	47	420	153	19
1464042	Open-source_hardware	201006	6	1	0	0	5	4	1	0	656	295	48	424	154	20
1464042	Open-source_hardware	201007	1	0	0	0	1	1	0	0	657	295	48	425	154	20
1464042	Open-source_hardware	201008	2	0	0	0	1	1	0	0	659	296	48	427	155	20
1464042	Open-source_hardware	201009	6	0	0	0	5	5	0	0	665	299	48	433	158	20
1464042	Open-source_hardware	201010	5	0	0	0	4	2	0	0	670	303	48	436	160	20
1464042	Open-source_hardware	201011	10	1	0	0	6	3	1	0	680	306	49	443	160	20
1464042	Open-source_hardware	201012	3	0	0	0	3	3	0	0	683	308	49	446	162	20
1464042	Open-source_hardware	201101	4	0	0	0	4	3	0	0	687	309	49	449	162	20
1464042	Open-source_hardware	201102	1	0	0	0	1	1	0	0	688	310	49	450	163	20
1464042	Open-source_hardware	201103	6	0	0	0	6	6	0	0	694	316	49	456	169	20
1464042	Open-source_hardware	201104	3	0	0	0	3	1	0	0	697	319	49	457	170	20
1464042	Open-source_hardware	201105	5	0	0	0	5	3	0	0	702	323	49	460	172	20
1464042	Open-source_hardware	201106	4	0	0	0	3	1	0	0	706	325	49	462	172	20
1464042	Open-source_hardware	201107	3	0	0	0	3	2	0	0	709	328	49	464	174	20
1464042	Open-source_hardware	201108	4	0	0	0	3	1	0	0	713	331	49	466	175	20
1464042	Open-source_hardware	201109	1	0	0	0	1	0	0	0	714	332	49	466	175	20
1464042	Open-source_hardware	201110	4	0	0	0	1	1	0	0	718	333	49	470	176	20
1464042	Open-source_hardware	201111	1	0	0	0	1	1	0	0	719	334	49	471	177	20
1464042	Open-source_hardware	201112	4	0	0	0	3	1	0	0	723	337	49	473	178	20
1464042	Open-source_hardware	201201	6	3	0	0	4	3	2	0	729	339	52	478	179	22
1464042	Open-source_hardware	201202	1	0	0	0	1	1	0	0	730	339	52	479	179	22
1464042	Open-source_hardware	201203	2	0	0	0	2	2	0	0	732	341	52	481	181	22
1464042	Open-source_hardware	201204	6	0	0	0	5	3	0	0	738	345	52	484	183	22
1464042	Open-source_hardware	201205	2	0	0	0	2	2	0	0	740	347	52	486	185	22
1464042	Open-source_hardware	201208	5	1	0	0	4	3	1	0	745	350	53	490	187	23
1464042	Open-source_hardware	201209	4	0	0	0	4	4	0	0	749	354	53	494	191	23
1464042	Open-source_hardware	201210	4	0	0	0	3	3	0	0	753	356	53	498	193	23
1464042	Open-source_hardware	201211	4	0	0	0	3	2	0	0	757	358	53	501	194	23
1464042	Open-source_hardware	201212	7	0	0	0	6	3	0	0	764	364	53	504	197	23
1464042	Open-source_hardware	201301	5	0	0	0	4	3	0	0	769	367	53	507	199	23
1464042	Open-source_hardware	201302	11	1	0	0	7	6	1	0	780	370	54	517	201	23
1464042	Open-source_hardware	201303	2	1	0	0	2	1	1	0	782	372	55	518	202	23
1464042	Open-source_hardware	201304	17	4	0	0	10	6	2	0	799	380	59	527	206	23
1464042	Open-source_hardware	201305	13	2	0	0	9	7	1	0	812	385	61	538	209	24
1464042	Open-source_hardware	201306	2	0	0	0	2	2	0	0	814	386	61	540	210	24
1464042	Open-source_hardware	201308	2	0	0	0	2	2	0	0	816	387	61	542	211	24
1464042	Open-source_hardware	201309	2	0	0	0	1	1	0	0	818	388	61	544	212	24
1464042	Open-source_hardware	201310	1	0	0	0	1	0	0	0	819	389	61	544	212	24
1464042	Open-source_hardware	201311	7	2	0	0	5	3	2	0	826	393	63	547	214	24
1464042	Open-source_hardware	201312	5	0	0	0	3	3	0	0	831	395	63	552	216	24
1464042	Open-source_hardware	201401	1	0	0	0	1	1	0	0	832	396	63	553	217	24
1464042	Open-source_hardware	201402	3	0	0	0	3	3	0	0	835	397	63	556	218	24
1464042	Open-source_hardware	201403	3	0	0	0	1	1	0	0	838	398	63	559	219	24
1464042	Open-source_hardware	201404	4	1	0	0	4	3	1	0	842	401	64	562	221	25
1464042	Open-source_hardware	201405	8	0	0	0	4	3	0	0	850	402	64	569	221	25
1464042	Open-source_hardware	201406	2	0	0	0	1	1	0	0	852	402	64	571	221	25
1464042	Open-source_hardware	201407	1	0	0	0	1	0	0	0	853	403	64	571	221	25
1464042	Open-source_hardware	201408	2	0	0	0	1	1	0	0	855	404	64	573	222	25
1464042	Open-source_hardware	201409	1	0	0	0	1	1	0	0	856	404	64	574	222	25
1464042	Open-source_hardware	201411	2	0	0	0	2	1	0	0	858	405	64	575	222	25
1464042	Open-source_hardware	201412	7	0	0	0	2	2	0	0	865	406	64	582	223	25
1464042	Open-source_hardware	201501	8	0	0	0	3	3	0	0	873	407	64	590	224	25
1464042	Open-source_hardware	201502	5	2	0	0	4	2	1	0	878	409	66	593	224	25
1464042	Open-source_hardware	201503	20	1	0	0	8	5	1	0	898	416	67	610	228	26
1464042	Open-source_hardware	201504	4	0	0	0	4	3	0	0	902	419	67	613	230	26
1464042	Open-source_hardware	201505	6	0	0	0	2	2	0	0	908	420	67	619	231	26
1464042	Open-source_hardware	201507	6	1	0	0	6	6	1	0	914	425	68	625	236	27
1464042	Open-source_hardware	201508	4	0	0	0	3	2	0	0	918	428	68	628	237	27
1464042	Open-source_hardware	201509	8	2	0	0	6	5	2	0	926	429	70	635	237	28
1464042	Open-source_hardware	201510	9	3	0	0	7	5	3	0	935	432	73	640	238	29
1464042	Open-source_hardware	201511	1	0	0	0	1	1	0	0	936	433	73	641	239	29
1464042	Open-source_hardware	201512	2	0	0	0	1	1	0	0	938	434	73	643	240	29
1464042	Open-source_hardware	201601	2	1	0	0	2	1	1	0	940	435	74	644	240	29
1464042	Open-source_hardware	201602	4	0	0	0	3	2	0	0	944	438	74	647	242	29
1464042	Open-source_hardware	201603	18	0	0	0	8	5	0	0	962	445	74	659	247	29
1464042	Open-source_hardware	201604	23	0	0	0	8	6	0	0	985	451	74	679	251	29
1464042	Open-source_hardware	201606	3	0	0	0	3	2	0	0	988	454	74	681	253	29
1464042	Open-source_hardware	201608	1	0	0	0	1	1	0	0	989	455	74	682	254	29
1464042	Open-source_hardware	201609	1	0	0	0	1	1	0	0	990	455	74	683	254	29
1464042	Open-source_hardware	201610	7	0	0	0	4	3	0	0	997	458	74	689	256	29
1464042	Open-source_hardware	201611	1	0	0	0	1	1	0	0	998	459	74	690	257	29
1464042	Open-source_hardware	201612	2	0	0	0	2	1	0	0	1000	461	74	691	258	29
1464042	Open-source_hardware	201701	7	1	0	0	7	5	1	0	1007	466	75	696	261	29
1464042	Open-source_hardware	201703	5	0	0	0	5	3	0	0	1012	469	75	699	262	29
1464042	Open-source_hardware	201704	2	0	0	0	2	2	0	0	1014	470	75	701	263	29
1464042	Open-source_hardware	201705	10	0	0	0	5	2	0	0	1024	475	75	708	265	29
1464042	Open-source_hardware	201706	4	0	0	0	4	3	0	0	1028	477	75	711	266	29
1464042	Open-source_hardware	201707	11	0	0	0	9	9	0	0	1039	482	75	722	271	29
1464042	Open-source_hardware	201708	4	0	0	0	1	0	0	0	1043	483	75	722	271	29
1464042	Open-source_hardware	201709	1	0	0	0	1	0	0	0	1044	484	75	722	271	29
1464042	Open-source_hardware	201710	12	0	0	0	3	3	0	0	1056	486	75	734	273	29
1464042	Open-source_hardware	201711	9	0	0	0	8	6	0	0	1065	490	75	741	275	29
1464042	Open-source_hardware	201712	5	0	0	0	4	3	0	0	1070	492	75	744	276	29
1464042	Open-source_hardware	201801	2	0	0	0	2	2	0	0	1072	492	75	746	276	29
1464042	Open-source_hardware	201802	8	0	0	0	4	3	0	0	1080	495	75	753	278	29
1464042	Open-source_hardware	201803	1	0	0	0	1	1	0	0	1081	496	75	754	279	29
1464042	Open-source_hardware	201804	7	1	0	0	4	4	1	0	1088	499	76	761	282	30
1464042	Open-source_hardware	201806	2	0	0	0	2	2	0	0	1090	500	76	763	283	30
1464042	Open-source_hardware	201807	1	0	0	0	1	1	0	0	1091	501	76	764	284	30
18949571	OpenBSD	200110	1	0	0	0	1	1	0	0	1	1	0	1	1	0
18949571	OpenBSD	200202	1	0	0	0	1	1	0	0	2	2	0	2	2	0
18949571	OpenBSD	200203	1	0	0	0	1	1	0	0	3	3	0	3	3	0
18949571	OpenBSD	200209	1	0	0	0	1	1	0	0	4	4	0	4	4	0
18949571	OpenBSD	200210	2	0	0	0	2	2	0	0	6	6	0	6	6	0
18949571	OpenBSD	200211	3	0	0	0	2	2	0	0	9	8	0	9	8	0
18949571	OpenBSD	200301	2	0	0	0	2	1	0	0	11	10	0	10	9	0
18949571	OpenBSD	200302	1	0	0	0	1	0	0	0	12	11	0	10	9	0
18949571	OpenBSD	200306	1	0	0	0	1	0	0	0	13	12	0	10	9	0
18949571	OpenBSD	200307	1	0	0	0	1	1	0	0	14	13	0	11	10	0
18949571	OpenBSD	200308	1	0	0	0	1	1	0	0	15	14	0	12	11	0
18949571	OpenBSD	200309	1	0	0	0	1	1	0	0	16	15	0	13	12	0
18949571	OpenBSD	200310	1	0	0	0	1	1	0	0	17	16	0	14	13	0
18949571	OpenBSD	200311	5	0	0	0	5	2	0	0	22	21	0	16	15	0
18949571	OpenBSD	200312	3	0	0	0	3	2	0	0	25	23	0	18	16	0
18949571	OpenBSD	200401	2	0	0	0	2	0	0	0	27	25	0	18	16	0
18949571	OpenBSD	200402	3	0	0	0	2	2	0	0	30	27	0	21	18	0
18949571	OpenBSD	200403	5	0	0	0	4	3	0	0	35	30	0	25	20	0
18949571	OpenBSD	200404	14	2	0	0	5	3	2	0	49	33	2	29	21	2
18949571	OpenBSD	200405	8	0	0	0	7	4	0	0	57	39	2	33	24	2
18949571	OpenBSD	200406	7	0	0	0	7	5	0	0	64	45	2	38	28	2
18949571	OpenBSD	200407	8	0	0	0	7	6	0	0	72	50	2	45	32	2
18949571	OpenBSD	200408	7	1	0	0	6	3	1	0	79	55	3	48	34	2
18949571	OpenBSD	200409	9	0	0	0	9	7	0	0	88	62	3	55	39	2
18949571	OpenBSD	200410	9	1	0	0	8	6	1	0	97	68	4	62	43	2
18949571	OpenBSD	200411	12	0	0	0	7	5	0	0	109	74	4	70	47	2
18949571	OpenBSD	200412	4	0	0	0	2	2	0	0	113	75	4	74	48	2
18949571	OpenBSD	200501	5	0	0	0	5	3	0	0	118	78	4	77	49	2
18949571	OpenBSD	200502	1	0	0	0	1	1	0	0	119	79	4	78	50	2
18949571	OpenBSD	200503	1	0	0	0	1	1	0	0	120	80	4	79	51	2
18949571	OpenBSD	200504	5	0	0	0	5	5	0	0	125	82	4	84	53	2
18949571	OpenBSD	200505	11	0	0	0	8	4	0	0	136	88	4	91	55	2
18949571	OpenBSD	200506	12	0	0	0	10	7	0	0	148	95	4	100	59	2
18949571	OpenBSD	200507	5	1	0	0	5	3	1	0	153	99	5	103	61	2
18949571	OpenBSD	200508	7	2	0	0	6	5	1	0	160	103	7	109	64	3
18949571	OpenBSD	200509	52	3	1	0	22	12	3	1	212	122	10	128	73	6
18949571	OpenBSD	200510	137	4	0	0	24	11	2	0	349	139	14	242	79	7
18949571	OpenBSD	200511	242	7	0	0	37	14	5	0	591	168	21	451	85	7
18949571	OpenBSD	200512	100	7	1	0	21	13	5	1	691	177	28	538	90	10
18949571	OpenBSD	200601	138	5	1	0	11	6	3	1	829	182	33	665	91	11
18949571	OpenBSD	200602	290	12	4	1	28	17	7	4	1119	204	45	924	102	20
18949571	OpenBSD	200603	14	3	0	0	9	6	2	0	1133	209	48	933	104	21
18949571	OpenBSD	200604	18	2	0	0	16	7	2	0	1151	224	50	942	110	21
18949571	OpenBSD	200605	194	38	1	0	92	51	22	1	1345	310	88	1078	155	30
18949571	OpenBSD	200606	21	4	0	0	15	10	4	0	1366	322	92	1094	162	32
18949571	OpenBSD	200607	27	3	0	0	18	9	3	0	1393	335	95	1111	166	34
18949571	OpenBSD	200608	18	3	0	0	9	6	3	0	1411	341	98	1126	169	36
18949571	OpenBSD	200609	16	4	2	1	6	2	3	2	1427	345	102	1136	169	37
18949571	OpenBSD	200610	23	5	1	0	13	6	5	1	1450	355	107	1150	172	37
18949571	OpenBSD	200611	23	5	0	0	15	9	4	0	1473	368	112	1165	179	38
18949571	OpenBSD	200612	9	0	0	0	8	4	0	0	1482	374	112	1169	181	38
18949571	OpenBSD	200701	13	1	0	0	8	5	1	0	1495	381	113	1177	185	38
18949571	OpenBSD	200702	11	2	0	0	7	2	2	0	1506	386	115	1181	185	38
18949571	OpenBSD	200703	19	3	0	0	10	5	2	0	1525	392	118	1193	188	40
18949571	OpenBSD	200704	69	4	0	0	13	4	4	0	1594	402	122	1234	189	41
18949571	OpenBSD	200705	62	2	0	0	15	9	2	0	1656	412	124	1287	194	42
18949571	OpenBSD	200706	18	0	0	0	13	10	0	0	1674	422	124	1302	202	42
18949571	OpenBSD	200707	10	4	1	0	8	4	3	1	1684	429	128	1307	205	43
18949571	OpenBSD	200708	13	1	0	0	8	5	1	0	1697	435	129	1317	208	43
18949571	OpenBSD	200709	15	2	0	0	9	5	1	0	1712	441	131	1326	211	44
18949571	OpenBSD	200710	21	2	0	0	9	6	2	0	1733	447	133	1342	214	45
18949571	OpenBSD	200711	9	1	0	0	7	7	1	0	1742	450	134	1351	217	46
18949571	OpenBSD	200712	19	5	1	0	13	5	4	1	1761	461	139	1361	220	48
18949571	OpenBSD	200801	5	1	0	0	5	4	1	0	1766	464	140	1365	222	49
18949571	OpenBSD	200802	9	1	0	0	8	4	1	0	1775	471	141	1369	225	50
18949571	OpenBSD	200803	13	2	0	0	6	3	2	0	1788	474	143	1377	225	50
18949571	OpenBSD	200804	3	0	0	0	3	3	0	0	1791	476	143	1380	227	50
18949571	OpenBSD	200805	3	1	0	0	3	2	1	0	1794	478	144	1382	228	50
18949571	OpenBSD	200806	17	5	0	0	14	7	5	0	1811	490	149	1391	233	54
18949571	OpenBSD	200807	7	0	0	0	6	5	0	0	1818	495	149	1397	237	54
18949571	OpenBSD	200808	24	2	0	0	6	5	1	0	1842	499	151	1420	240	55
18949571	OpenBSD	200809	25	5	0	0	18	9	3	0	1867	513	156	1434	245	55
18949571	OpenBSD	200810	3	1	0	0	3	2	1	0	1870	515	157	1436	246	55
18949571	OpenBSD	200811	4	0	0	0	4	3	0	0	1874	518	157	1439	248	55
18949571	OpenBSD	200812	5	0	0	0	3	3	0	0	1879	521	157	1444	251	55
18949571	OpenBSD	200901	14	4	0	0	10	6	4	0	1893	530	161	1452	256	57
18949571	OpenBSD	200902	1	0	0	0	1	1	0	0	1894	531	161	1453	257	57
18949571	OpenBSD	200903	8	2	0	0	7	2	2	0	1902	537	163	1456	259	58
18949571	OpenBSD	200904	2	0	0	0	2	2	0	0	1904	539	163	1458	261	58
18949571	OpenBSD	200905	18	0	0	0	9	5	0	0	1922	545	163	1470	263	58
18949571	OpenBSD	200906	13	2	0	0	11	5	2	0	1935	553	165	1475	267	58
18949571	OpenBSD	200907	5	2	0	0	5	1	2	0	1940	558	167	1476	268	59
18949571	OpenBSD	200908	5	1	0	0	5	1	1	0	1945	563	168	1477	269	59
18949571	OpenBSD	200909	14	3	0	0	9	6	3	0	1959	570	171	1488	273	61
18949571	OpenBSD	200910	10	1	0	0	10	4	1	0	1969	579	172	1492	276	61
18949571	OpenBSD	200911	27	2	0	0	11	6	2	0	1996	587	174	1513	279	61
18949571	OpenBSD	200912	1	0	0	0	1	1	0	0	1997	588	174	1514	280	61
18949571	OpenBSD	201001	3	0	0	0	3	2	0	0	2000	591	174	1516	282	61
18949571	OpenBSD	201002	7	2	0	0	5	2	2	0	2007	595	176	1518	283	62
18949571	OpenBSD	201003	6	2	0	0	5	3	1	0	2013	599	178	1522	285	63
18949571	OpenBSD	201004	19	3	0	0	12	7	2	0	2032	608	181	1535	289	63
18949571	OpenBSD	201005	33	1	0	0	8	6	1	0	2065	613	182	1566	292	63
18949571	OpenBSD	201006	33	1	0	0	9	6	1	0	2098	619	183	1596	296	63
18949571	OpenBSD	201007	12	1	0	0	6	4	1	0	2110	624	184	1600	299	63
18949571	OpenBSD	201008	4	0	0	0	4	2	0	0	2114	627	184	1602	300	63
18949571	OpenBSD	201009	3	1	0	0	3	2	1	0	2117	630	185	1604	302	63
18949571	OpenBSD	201010	3	0	0	0	3	2	0	0	2120	631	185	1606	302	63
18949571	OpenBSD	201011	4	1	0	0	3	1	1	0	2124	633	186	1608	302	63
18949571	OpenBSD	201012	2	0	0	0	2	0	0	0	2126	635	186	1608	302	63
18949571	OpenBSD	201101	16	0	0	0	10	4	0	0	2142	645	186	1612	306	63
18949571	OpenBSD	201102	6	0	0	0	5	2	0	0	2148	648	186	1614	306	63
18949571	OpenBSD	201103	6	0	0	0	5	3	0	0	2154	652	186	1617	308	63
18949571	OpenBSD	201104	6	2	0	0	6	4	2	0	2160	656	188	1621	311	64
18949571	OpenBSD	201105	3	0	0	0	3	3	0	0	2163	658	188	1624	313	64
18949571	OpenBSD	201107	11	0	0	0	4	4	0	0	2174	662	188	1635	317	64
18949571	OpenBSD	201108	6	0	0	0	3	0	0	0	2180	665	188	1635	317	64
18949571	OpenBSD	201109	4	0	0	0	3	0	0	0	2184	668	188	1635	317	64
18949571	OpenBSD	201110	5	1	0	0	5	2	1	0	2189	671	189	1637	317	64
18949571	OpenBSD	201111	7	0	0	0	7	3	0	0	2196	677	189	1640	319	64
18949571	OpenBSD	201112	6	0	0	0	6	3	0	0	2202	682	189	1643	321	64
18949571	OpenBSD	201201	3	0	0	0	2	2	0	0	2205	683	189	1646	322	64
18949571	OpenBSD	201202	2	0	0	0	2	2	0	0	2207	685	189	1648	324	64
18949571	OpenBSD	201203	2	0	0	0	2	2	0	0	2209	686	189	1650	325	64
18949571	OpenBSD	201204	4	1	0	0	4	3	1	0	2213	689	190	1653	327	64
18949571	OpenBSD	201205	1	0	0	0	1	0	0	0	2214	690	190	1653	327	64
18949571	OpenBSD	201206	6	1	0	0	5	3	1	0	2220	694	191	1657	329	65
18949571	OpenBSD	201207	80	1	0	0	4	4	1	0	2300	698	192	1737	333	66
18949571	OpenBSD	201208	4	1	0	0	3	2	1	0	2304	700	193	1739	334	67
18949571	OpenBSD	201209	2	0	0	0	2	1	0	0	2306	701	193	1740	334	67
18949571	OpenBSD	201210	8	1	0	0	6	4	1	0	2314	706	194	1746	337	68
18949571	OpenBSD	201211	4	0	0	0	4	2	0	0	2318	710	194	1748	339	68
18949571	OpenBSD	201212	2	0	0	0	2	1	0	0	2320	711	194	1749	339	68
18949571	OpenBSD	201301	2	0	0	0	2	0	0	0	2322	712	194	1749	339	68
18949571	OpenBSD	201302	8	3	0	0	5	2	2	0	2330	717	197	1752	341	68
18949571	OpenBSD	201303	2	0	0	0	2	1	0	0	2332	718	197	1753	341	68
18949571	OpenBSD	201304	11	0	0	0	5	4	0	0	2343	722	197	1763	344	68
18949571	OpenBSD	201305	6	0	0	0	5	3	0	0	2349	727	197	1767	347	68
18949571	OpenBSD	201306	9	1	0	0	8	6	1	0	2358	732	198	1774	350	69
18949571	OpenBSD	201307	1	0	0	0	1	1	0	0	2359	732	198	1775	350	69
18949571	OpenBSD	201308	9	0	0	0	9	5	0	0	2368	741	198	1780	355	69
18949571	OpenBSD	201309	1	0	0	0	1	1	0	0	2369	742	198	1781	356	69
18949571	OpenBSD	201310	1	0	0	0	1	0	0	0	2370	743	198	1781	356	69
18949571	OpenBSD	201311	4	0	0	0	4	3	0	0	2374	745	198	1784	356	69
18949571	OpenBSD	201312	3	0	0	0	3	2	0	0	2377	747	198	1786	357	69
18949571	OpenBSD	201401	2	0	0	0	2	2	0	0	2379	749	198	1788	359	69
18949571	OpenBSD	201402	16	1	0	0	9	8	1	0	2395	754	199	1802	363	70
18949571	OpenBSD	201403	10	0	0	0	4	4	0	0	2405	755	199	1812	364	70
18949571	OpenBSD	201404	13	0	0	0	7	6	0	0	2418	760	199	1823	368	70
18949571	OpenBSD	201405	12	2	0	0	10	7	2	0	2430	768	201	1832	373	71
18949571	OpenBSD	201406	13	2	0	0	9	6	2	0	2443	774	203	1841	376	71
18949571	OpenBSD	201407	1	0	0	0	1	1	0	0	2444	775	203	1842	377	71
18949571	OpenBSD	201408	5	0	0	0	5	3	0	0	2449	778	203	1845	378	71
18949571	OpenBSD	201409	9	0	0	0	5	4	0	0	2458	781	203	1853	380	71
18949571	OpenBSD	201410	4	0	0	0	4	4	0	0	2462	784	203	1857	383	71
18949571	OpenBSD	201411	2	0	0	0	2	1	0	0	2464	785	203	1858	383	71
18949571	OpenBSD	201412	7	1	0	0	7	4	1	0	2471	791	204	1862	385	72
18949571	OpenBSD	201501	11	0	0	0	4	4	0	0	2482	792	204	1873	386	72
18949571	OpenBSD	201502	2	0	0	0	2	2	0	0	2484	794	204	1875	388	72
18949571	OpenBSD	201503	3	1	0	0	3	3	1	0	2487	796	205	1878	390	73
18949571	OpenBSD	201504	6	0	0	0	6	5	0	0	2493	801	205	1883	394	73
18949571	OpenBSD	201505	5	0	0	0	4	4	0	0	2498	803	205	1888	396	73
18949571	OpenBSD	201506	13	0	0	0	10	6	0	0	2511	811	205	1897	399	73
18949571	OpenBSD	201507	9	0	0	0	2	2	0	0	2520	813	205	1906	401	73
18949571	OpenBSD	201508	2	0	0	0	2	2	0	0	2522	814	205	1908	402	73
18949571	OpenBSD	201509	6	0	0	0	4	1	0	0	2528	818	205	1910	403	73
18949571	OpenBSD	201510	1	0	0	0	1	1	0	0	2529	819	205	1911	404	73
18949571	OpenBSD	201511	12	0	0	0	8	5	0	0	2541	823	205	1918	405	73
18949571	OpenBSD	201512	22	0	0	0	6	5	0	0	2563	825	205	1938	406	73
18949571	OpenBSD	201601	32	0	0	0	7	4	0	0	2595	829	205	1958	408	73
18949571	OpenBSD	201603	3	0	0	0	3	3	0	0	2598	831	205	1961	410	73
18949571	OpenBSD	201604	16	2	0	0	8	6	1	0	2614	837	207	1974	414	73
18949571	OpenBSD	201605	5	0	0	0	4	1	0	0	2619	840	207	1975	414	73
18949571	OpenBSD	201606	175	0	0	0	10	9	0	0	2794	845	207	2149	418	73
18949571	OpenBSD	201607	61	1	0	0	8	6	1	0	2855	850	208	2208	420	73
18949571	OpenBSD	201608	10	0	0	0	6	6	0	0	2865	852	208	2218	422	73
18949571	OpenBSD	201609	1	0	0	0	1	1	0	0	2866	852	208	2219	422	73
18949571	OpenBSD	201610	13	0	0	0	7	4	0	0	2879	857	208	2229	424	73
18949571	OpenBSD	201611	8	3	0	0	4	3	2	0	2887	859	211	2236	425	75
18949571	OpenBSD	201612	8	0	0	0	5	5	0	0	2895	862	211	2244	427	75
18949571	OpenBSD	201701	4	0	0	0	2	1	0	0	2899	863	211	2247	427	75
18949571	OpenBSD	201702	8	1	0	0	5	3	1	0	2907	865	212	2253	427	75
18949571	OpenBSD	201703	8	0	0	0	6	5	0	0	2915	868	212	2260	429	75
18949571	OpenBSD	201705	1	0	0	0	1	1	0	0	2916	869	212	2261	430	75
18949571	OpenBSD	201706	10	1	0	0	7	4	1	0	2926	873	213	2268	431	75
18949571	OpenBSD	201707	1	0	0	0	1	1	0	0	2927	874	213	2269	432	75
18949571	OpenBSD	201708	2	0	0	0	2	2	0	0	2929	875	213	2271	433	75
18949571	OpenBSD	201709	2	0	0	0	2	2	0	0	2931	876	213	2273	434	75
18949571	OpenBSD	201801	3	0	0	0	3	2	0	0	2934	878	213	2275	435	75
18949571	OpenBSD	201802	3	0	0	0	1	1	0	0	2937	878	213	2278	435	75
18949571	OpenBSD	201803	5	0	0	0	3	1	0	0	2942	880	213	2281	435	75
18949571	OpenBSD	201804	9	1	0	0	7	5	1	0	2951	885	214	2288	438	75
18949571	OpenBSD	201805	8	0	0	0	6	5	0	0	2959	890	214	2295	442	75
18949571	OpenBSD	201806	12	0	0	0	7	5	0	0	2971	895	214	2304	445	75
18949571	OpenBSD	201807	2	0	0	0	2	1	0	0	2973	897	214	2305	446	75
24942429	OpenFlow	201001	2	0	0	0	2	2	0	0	2	2	0	2	2	0
24942429	OpenFlow	201004	1	0	0	0	1	1	0	0	3	3	0	3	3	0
24942429	OpenFlow	201007	1	0	0	0	1	1	0	0	4	4	0	4	4	0
24942429	OpenFlow	201008	2	0	0	0	2	1	0	0	6	6	0	5	5	0
24942429	OpenFlow	201010	1	0	0	0	1	1	0	0	7	7	0	6	6	0
24942429	OpenFlow	201012	3	0	0	0	2	1	0	0	10	9	0	7	7	0
24942429	OpenFlow	201101	1	0	0	0	1	0	0	0	11	10	0	7	7	0
24942429	OpenFlow	201102	1	0	0	0	1	0	0	0	12	11	0	7	7	0
24942429	OpenFlow	201103	1	0	0	0	1	1	0	0	13	12	0	8	8	0
24942429	OpenFlow	201105	6	1	0	0	6	4	1	0	19	17	1	12	11	0
24942429	OpenFlow	201107	3	0	0	0	3	2	0	0	22	20	1	14	13	0
24942429	OpenFlow	201110	2	0	0	0	2	2	0	0	24	22	1	16	15	0
24942429	OpenFlow	201111	5	0	0	0	5	4	0	0	29	27	1	20	19	0
24942429	OpenFlow	201112	3	0	0	0	2	2	0	0	32	28	1	23	20	0
24942429	OpenFlow	201201	1	0	0	0	1	0	0	0	33	29	1	23	20	0
24942429	OpenFlow	201202	2	0	0	0	2	0	0	0	35	31	1	23	20	0
24942429	OpenFlow	201203	6	0	0	0	2	1	0	0	41	33	1	28	21	0
24942429	OpenFlow	201204	6	0	0	0	6	4	0	0	47	39	1	32	25	0
24942429	OpenFlow	201205	7	0	0	0	6	4	0	0	54	45	1	36	29	0
24942429	OpenFlow	201206	1	0	0	0	1	1	0	0	55	46	1	37	30	0
24942429	OpenFlow	201207	2	0	0	0	2	0	0	0	57	48	1	37	30	0
24942429	OpenFlow	201208	3	0	0	0	2	2	0	0	60	50	1	40	32	0
24942429	OpenFlow	201209	2	0	0	0	2	0	0	0	62	52	1	40	32	0
24942429	OpenFlow	201210	3	0	0	0	3	3	0	0	65	55	1	43	35	0
24942429	OpenFlow	201301	2	0	0	0	2	1	0	0	67	57	1	44	36	0
24942429	OpenFlow	201302	10	0	0	0	4	2	0	0	77	61	1	51	38	0
24942429	OpenFlow	201303	2	0	0	0	2	1	0	0	79	63	1	52	39	0
24942429	OpenFlow	201304	6	0	0	0	5	4	0	0	85	68	1	57	43	0
24942429	OpenFlow	201305	9	1	0	0	6	6	1	0	94	73	2	66	48	1
24942429	OpenFlow	201306	7	0	0	0	4	3	0	0	101	77	2	72	51	1
24942429	OpenFlow	201309	7	0	0	0	6	5	0	0	108	82	2	78	55	1
24942429	OpenFlow	201310	1	0	0	0	1	0	0	0	109	83	2	78	55	1
24942429	OpenFlow	201401	4	1	0	0	4	2	1	0	113	87	3	80	57	1
24942429	OpenFlow	201403	3	0	0	0	3	2	0	0	116	90	3	82	59	1
24942429	OpenFlow	201404	2	0	0	0	1	1	0	0	118	91	3	84	60	1
24942429	OpenFlow	201405	3	0	0	0	3	1	0	0	121	93	3	85	60	1
24942429	OpenFlow	201406	1	0	0	0	1	1	0	0	122	94	3	86	61	1
24942429	OpenFlow	201407	7	0	0	0	3	2	0	0	129	97	3	92	62	1
24942429	OpenFlow	201410	1	0	0	0	1	1	0	0	130	98	3	93	63	1
24942429	OpenFlow	201411	1	0	0	0	1	0	0	0	131	99	3	93	63	1
24942429	OpenFlow	201412	3	1	0	0	3	1	1	0	134	102	4	94	64	1
24942429	OpenFlow	201504	1	0	0	0	1	1	0	0	135	103	4	95	65	1
24942429	OpenFlow	201505	2	0	0	0	1	0	0	0	137	104	4	95	65	1
24942429	OpenFlow	201506	2	0	0	0	2	1	0	0	139	106	4	96	66	1
24942429	OpenFlow	201507	8	0	0	0	3	2	0	0	147	108	4	103	67	1
24942429	OpenFlow	201508	1	0	0	0	1	1	0	0	148	109	4	104	68	1
24942429	OpenFlow	201509	1	0	0	0	1	1	0	0	149	110	4	105	69	1
24942429	OpenFlow	201511	1	0	0	0	1	1	0	0	150	111	4	106	70	1
24942429	OpenFlow	201601	2	0	0	0	1	1	0	0	152	112	4	108	71	1
24942429	OpenFlow	201602	3	1	0	0	3	2	1	0	155	115	5	110	72	1
24942429	OpenFlow	201606	2	0	0	0	2	2	0	0	157	117	5	112	74	1
24942429	OpenFlow	201607	1	0	0	0	1	0	0	0	158	118	5	112	74	1
24942429	OpenFlow	201611	1	0	0	0	1	1	0	0	159	119	5	113	75	1
24942429	OpenFlow	201703	1	0	0	0	1	0	0	0	160	120	5	113	75	1
24942429	OpenFlow	201706	1	0	0	0	1	1	0	0	161	121	5	114	76	1
24942429	OpenFlow	201707	2	0	0	0	2	0	0	0	163	123	5	114	76	1
24942429	OpenFlow	201709	2	0	0	0	2	2	0	0	165	124	5	116	77	1
24942429	OpenFlow	201711	3	0	0	0	1	1	0	0	168	125	5	119	77	1
24942429	OpenFlow	201712	3	0	0	0	2	2	0	0	171	127	5	122	78	1
24942429	OpenFlow	201803	3	0	0	0	2	2	0	0	174	128	5	125	79	1
24942429	OpenFlow	201804	1	0	0	0	1	1	0	0	175	129	5	126	80	1
43388	Open_Shortest_Path_First	200208	3	0	0	0	3	2	0	0	3	3	0	2	2	0
43388	Open_Shortest_Path_First	200212	2	0	0	0	2	1	0	0	5	5	0	3	3	0
43388	Open_Shortest_Path_First	200303	2	0	0	0	1	1	0	0	7	6	0	5	4	0
43388	Open_Shortest_Path_First	200310	1	0	0	0	1	1	0	0	8	6	0	6	4	0
43388	Open_Shortest_Path_First	200312	2	0	0	0	1	0	0	0	10	7	0	6	4	0
43388	Open_Shortest_Path_First	200401	1	0	0	0	1	0	0	0	11	8	0	6	4	0
43388	Open_Shortest_Path_First	200402	1	0	0	0	1	1	0	0	12	9	0	7	5	0
43388	Open_Shortest_Path_First	200403	1	0	0	0	1	1	0	0	13	10	0	8	6	0
43388	Open_Shortest_Path_First	200405	2	0	0	0	2	2	0	0	15	12	0	10	8	0
43388	Open_Shortest_Path_First	200406	1	0	0	0	1	1	0	0	16	13	0	11	9	0
43388	Open_Shortest_Path_First	200407	3	1	0	0	3	2	1	0	19	16	1	13	11	0
43388	Open_Shortest_Path_First	200408	1	0	0	0	1	0	0	0	20	17	1	13	11	0
43388	Open_Shortest_Path_First	200409	1	0	0	0	1	1	0	0	21	18	1	14	12	0
43388	Open_Shortest_Path_First	200410	2	0	0	0	2	1	0	0	23	20	1	15	13	0
43388	Open_Shortest_Path_First	200411	4	1	0	0	4	3	1	0	27	23	2	18	15	0
43388	Open_Shortest_Path_First	200412	1	0	0	0	1	1	0	0	28	24	2	19	16	0
43388	Open_Shortest_Path_First	200502	4	0	0	0	3	1	0	0	32	27	2	20	17	0
43388	Open_Shortest_Path_First	200504	3	0	0	0	3	0	0	0	35	30	2	20	17	0
43388	Open_Shortest_Path_First	200505	3	0	0	0	3	2	0	0	38	33	2	22	19	0
43388	Open_Shortest_Path_First	200506	5	0	0	0	2	1	0	0	43	35	2	26	20	0
43388	Open_Shortest_Path_First	200507	11	0	0	0	6	2	0	0	54	40	2	30	21	0
43388	Open_Shortest_Path_First	200508	3	0	0	0	2	2	0	0	57	41	2	33	22	0
43388	Open_Shortest_Path_First	200509	19	6	1	0	10	3	2	1	76	50	8	44	24	2
43388	Open_Shortest_Path_First	200510	2	0	0	0	2	2	0	0	78	51	8	46	25	2
43388	Open_Shortest_Path_First	200511	12	1	0	0	9	1	1	0	90	60	9	47	26	2
43388	Open_Shortest_Path_First	200512	6	0	0	0	5	1	0	0	96	64	9	48	27	2
43388	Open_Shortest_Path_First	200601	3	0	0	0	3	1	0	0	99	66	9	49	28	2
43388	Open_Shortest_Path_First	200602	1	0	0	0	1	0	0	0	100	67	9	49	28	2
43388	Open_Shortest_Path_First	200603	19	3	1	0	9	6	2	1	119	74	12	61	32	5
43388	Open_Shortest_Path_First	200604	4	0	0	0	4	1	0	0	123	78	12	62	33	5
43388	Open_Shortest_Path_First	200605	9	0	0	0	8	3	0	0	132	86	12	65	36	5
43388	Open_Shortest_Path_First	200606	30	1	0	0	15	6	1	0	162	98	13	80	39	5
43388	Open_Shortest_Path_First	200607	14	2	0	0	8	5	1	0	176	104	15	89	42	5
43388	Open_Shortest_Path_First	200608	4	0	0	0	3	1	0	0	180	107	15	90	43	5
43388	Open_Shortest_Path_First	200609	5	1	0	0	5	3	1	0	185	111	16	93	46	5
43388	Open_Shortest_Path_First	200610	6	2	0	0	5	1	2	0	191	116	18	94	47	5
43388	Open_Shortest_Path_First	200611	11	2	0	0	10	5	2	0	202	126	20	99	52	5
43388	Open_Shortest_Path_First	200612	6	1	0	0	6	1	1	0	208	132	21	100	53	5
43388	Open_Shortest_Path_First	200701	3	0	0	0	3	1	0	0	211	135	21	101	54	5
43388	Open_Shortest_Path_First	200702	11	0	0	0	9	4	0	0	222	144	21	105	58	5
43388	Open_Shortest_Path_First	200703	4	1	0	0	4	2	1	0	226	147	22	107	59	5
43388	Open_Shortest_Path_First	200704	12	2	0	0	8	4	2	0	238	155	24	112	63	5
43388	Open_Shortest_Path_First	200705	14	3	0	0	10	3	3	0	252	164	27	116	65	5
43388	Open_Shortest_Path_First	200706	17	0	0	0	8	1	0	0	269	172	27	117	66	5
43388	Open_Shortest_Path_First	200707	14	1	0	0	6	2	1	0	283	177	28	126	67	5
43388	Open_Shortest_Path_First	200708	15	1	0	0	13	4	1	0	298	187	29	132	69	5
43388	Open_Shortest_Path_First	200709	8	2	0	0	8	5	2	0	306	193	31	137	72	5
43388	Open_Shortest_Path_First	200710	34	8	0	0	21	8	7	0	340	212	39	148	78	5
43388	Open_Shortest_Path_First	200711	19	2	0	0	10	7	2	0	359	220	41	163	83	5
43388	Open_Shortest_Path_First	200712	10	1	0	0	6	2	1	0	369	225	42	166	84	5
43388	Open_Shortest_Path_First	200801	15	4	0	0	10	5	3	0	384	233	46	172	87	6
43388	Open_Shortest_Path_First	200802	5	2	0	0	4	2	2	0	389	236	48	174	88	6
43388	Open_Shortest_Path_First	200803	14	4	0	0	11	6	3	0	403	246	52	183	93	8
43388	Open_Shortest_Path_First	200804	13	2	0	0	12	5	2	0	416	257	54	188	97	8
43388	Open_Shortest_Path_First	200805	5	0	0	0	2	0	0	0	421	259	54	188	97	8
43388	Open_Shortest_Path_First	200806	6	1	0	0	5	2	1	0	427	263	55	190	98	8
43388	Open_Shortest_Path_First	200807	10	0	0	0	5	2	0	0	437	268	55	195	100	8
43388	Open_Shortest_Path_First	200808	25	1	0	0	12	9	1	0	462	280	56	213	109	9
43388	Open_Shortest_Path_First	200809	6	0	0	0	5	4	0	0	468	284	56	217	112	9
43388	Open_Shortest_Path_First	200810	7	2	0	0	6	3	2	0	475	289	58	221	114	9
43388	Open_Shortest_Path_First	200811	9	3	0	0	8	5	3	0	484	294	61	227	116	9
43388	Open_Shortest_Path_First	200812	6	0	0	0	4	3	0	0	490	297	61	231	118	9
43388	Open_Shortest_Path_First	200901	11	1	0	0	8	4	1	0	501	304	62	235	121	9
43388	Open_Shortest_Path_First	200902	7	1	0	0	5	2	1	0	508	308	63	239	122	9
43388	Open_Shortest_Path_First	200903	9	0	0	0	5	2	0	0	517	313	63	244	124	9
43388	Open_Shortest_Path_First	200904	16	1	0	0	10	4	1	0	533	322	64	252	127	9
43388	Open_Shortest_Path_First	200905	6	2	0	0	5	3	2	0	539	327	66	255	130	9
43388	Open_Shortest_Path_First	200906	26	3	0	0	13	6	1	0	565	338	69	272	134	10
43388	Open_Shortest_Path_First	200907	19	2	0	0	11	6	1	0	584	346	71	284	137	11
43388	Open_Shortest_Path_First	200908	9	2	0	0	8	5	2	0	593	351	73	290	139	11
43388	Open_Shortest_Path_First	200909	8	2	0	0	8	4	2	0	601	358	75	294	142	11
43388	Open_Shortest_Path_First	200910	13	5	0	0	8	4	2	0	614	364	80	303	144	12
43388	Open_Shortest_Path_First	200911	10	1	0	0	6	6	1	0	624	368	81	313	148	13
43388	Open_Shortest_Path_First	200912	9	0	0	0	6	3	0	0	633	373	81	318	150	13
43388	Open_Shortest_Path_First	201001	9	2	0	0	9	3	2	0	642	382	83	321	153	13
43388	Open_Shortest_Path_First	201002	6	0	0	0	2	1	0	0	648	384	83	322	154	13
43388	Open_Shortest_Path_First	201003	19	1	0	0	13	5	1	0	667	396	84	328	158	13
43388	Open_Shortest_Path_First	201004	21	0	0	0	7	3	0	0	688	401	84	344	159	13
43388	Open_Shortest_Path_First	201005	14	3	0	0	8	5	3	0	702	407	87	351	162	13
43388	Open_Shortest_Path_First	201006	17	2	0	0	12	5	1	0	719	416	89	357	164	13
43388	Open_Shortest_Path_First	201007	7	1	0	0	6	5	1	0	726	421	90	363	168	13
43388	Open_Shortest_Path_First	201008	2	1	0	0	2	1	1	0	728	423	91	364	169	13
43388	Open_Shortest_Path_First	201009	20	2	0	0	9	7	1	0	748	428	93	382	172	13
43388	Open_Shortest_Path_First	201010	9	1	0	0	5	3	1	0	757	432	94	388	174	14
43388	Open_Shortest_Path_First	201011	5	2	0	0	5	3	2	0	762	436	96	391	176	14
43388	Open_Shortest_Path_First	201012	12	2	0	0	7	4	2	0	774	443	98	398	180	14
43388	Open_Shortest_Path_First	201101	9	2	0	0	8	3	2	0	783	451	100	401	183	15
43388	Open_Shortest_Path_First	201102	3	1	0	0	3	1	1	0	786	453	101	402	183	15
43388	Open_Shortest_Path_First	201103	6	0	0	0	6	3	0	0	792	458	101	405	186	15
43388	Open_Shortest_Path_First	201104	12	2	0	0	8	3	2	0	804	464	103	409	187	15
43388	Open_Shortest_Path_First	201105	6	1	0	0	4	3	1	0	810	466	104	412	188	15
43388	Open_Shortest_Path_First	201106	7	3	0	0	7	5	3	0	817	471	107	417	191	17
43388	Open_Shortest_Path_First	201107	3	0	0	0	3	1	0	0	820	473	107	418	191	17
43388	Open_Shortest_Path_First	201108	4	1	0	0	4	2	1	0	824	476	108	420	192	17
43388	Open_Shortest_Path_First	201109	5	2	0	0	5	2	2	0	829	480	110	422	193	17
43388	Open_Shortest_Path_First	201110	4	1	0	0	4	2	1	0	833	483	111	424	194	17
43388	Open_Shortest_Path_First	201111	16	3	0	0	9	2	1	0	849	491	114	428	195	17
43388	Open_Shortest_Path_First	201112	7	2	0	0	6	4	2	0	856	495	116	433	197	17
43388	Open_Shortest_Path_First	201201	9	1	0	0	6	3	1	0	865	499	117	437	198	17
43388	Open_Shortest_Path_First	201202	3	0	0	0	3	2	0	0	868	502	117	439	200	17
43388	Open_Shortest_Path_First	201203	8	0	0	0	6	2	0	0	876	507	117	441	201	17
43388	Open_Shortest_Path_First	201204	6	1	0	0	3	2	1	0	882	509	118	446	202	17
43388	Open_Shortest_Path_First	201205	9	2	0	0	6	2	2	0	891	514	120	448	203	17
43388	Open_Shortest_Path_First	201206	11	5	1	0	8	4	4	1	902	519	125	454	204	19
43388	Open_Shortest_Path_First	201207	6	2	0	0	5	2	2	0	908	524	127	456	206	19
43388	Open_Shortest_Path_First	201208	10	2	0	0	9	4	2	0	918	531	129	460	208	19
43388	Open_Shortest_Path_First	201209	4	1	0	0	3	3	1	0	922	534	130	464	211	20
43388	Open_Shortest_Path_First	201210	4	1	0	0	4	1	1	0	926	538	131	465	212	20
43388	Open_Shortest_Path_First	201211	11	2	0	0	8	3	2	0	937	545	133	468	214	20
43388	Open_Shortest_Path_First	201212	14	1	0	0	8	4	1	0	951	552	134	473	217	20
43388	Open_Shortest_Path_First	201301	7	1	0	0	6	3	1	0	958	557	135	477	219	20
43388	Open_Shortest_Path_First	201302	6	1	0	0	5	4	1	0	964	560	136	482	221	20
43388	Open_Shortest_Path_First	201303	6	1	0	0	6	3	1	0	970	565	137	485	223	20
43388	Open_Shortest_Path_First	201304	11	3	0	0	10	4	3	0	981	572	140	489	223	20
43388	Open_Shortest_Path_First	201305	24	10	0	0	9	8	7	0	1005	578	150	500	228	21
43388	Open_Shortest_Path_First	201306	2	1	0	0	2	1	1	0	1007	580	151	501	229	21
43388	Open_Shortest_Path_First	201307	12	2	0	0	5	2	2	0	1019	584	153	503	230	21
43388	Open_Shortest_Path_First	201308	3	0	0	0	3	1	0	0	1022	587	153	504	231	21
43388	Open_Shortest_Path_First	201309	7	1	0	0	6	1	1	0	1029	592	154	505	231	21
43388	Open_Shortest_Path_First	201310	6	1	0	0	6	4	1	0	1035	598	155	509	235	21
43388	Open_Shortest_Path_First	201311	5	0	0	0	4	1	0	0	1040	602	155	510	236	21
43388	Open_Shortest_Path_First	201312	1	0	0	0	1	0	0	0	1041	603	155	510	236	21
43388	Open_Shortest_Path_First	201401	10	3	0	0	7	2	2	0	1051	609	158	513	237	21
43388	Open_Shortest_Path_First	201402	3	1	0	0	3	2	1	0	1054	612	159	515	239	21
43388	Open_Shortest_Path_First	201403	3	0	0	0	2	1	0	0	1057	614	159	516	240	21
43388	Open_Shortest_Path_First	201404	30	2	0	0	16	7	2	0	1087	626	161	535	244	21
43388	Open_Shortest_Path_First	201405	7	1	0	0	5	2	1	0	1094	630	162	538	245	21
43388	Open_Shortest_Path_First	201406	10	2	0	0	6	6	2	0	1104	634	164	548	248	22
43388	Open_Shortest_Path_First	201407	14	1	0	0	5	3	1	0	1118	637	165	560	249	22
43388	Open_Shortest_Path_First	201408	31	0	0	0	6	5	0	0	1149	640	165	590	250	22
43388	Open_Shortest_Path_First	201409	2	1	0	0	2	1	1	0	1151	641	166	591	250	22
43388	Open_Shortest_Path_First	201410	9	3	0	0	8	3	3	0	1160	647	169	594	252	22
43388	Open_Shortest_Path_First	201411	3	1	0	0	3	1	1	0	1163	650	170	595	253	22
43388	Open_Shortest_Path_First	201501	5	1	0	0	4	1	1	0	1168	654	171	596	254	22
43388	Open_Shortest_Path_First	201502	10	4	0	0	7	4	4	0	1178	659	175	600	256	22
43388	Open_Shortest_Path_First	201503	2	1	0	0	2	1	1	0	1180	660	176	601	256	22
43388	Open_Shortest_Path_First	201504	8	2	0	0	5	3	2	0	1188	663	178	605	257	22
43388	Open_Shortest_Path_First	201505	4	0	0	0	4	3	0	0	1192	666	178	608	259	22
43388	Open_Shortest_Path_First	201506	6	2	0	0	4	4	2	0	1198	667	180	614	260	24
43388	Open_Shortest_Path_First	201507	1	0	0	0	1	0	0	0	1199	668	180	614	260	24
43388	Open_Shortest_Path_First	201508	4	1	0	0	4	3	1	0	1203	671	181	617	262	24
43388	Open_Shortest_Path_First	201509	5	1	0	0	3	3	1	0	1208	674	182	622	264	25
43388	Open_Shortest_Path_First	201511	4	2	0	0	4	2	2	0	1212	676	184	624	264	25
43388	Open_Shortest_Path_First	201601	5	2	0	0	5	2	2	0	1217	680	186	626	265	25
43388	Open_Shortest_Path_First	201603	1	0	0	0	1	1	0	0	1218	681	186	627	265	25
43388	Open_Shortest_Path_First	201604	3	1	0	0	3	1	1	0	1221	684	187	628	266	25
43388	Open_Shortest_Path_First	201605	8	1	0	0	3	2	1	0	1229	686	188	635	267	25
43388	Open_Shortest_Path_First	201606	9	0	0	0	4	2	0	0	1238	689	188	637	268	25
43388	Open_Shortest_Path_First	201607	8	0	0	0	4	4	0	0	1246	691	188	645	270	25
43388	Open_Shortest_Path_First	201608	9	1	0	0	6	3	1	0	1255	695	189	649	270	25
43388	Open_Shortest_Path_First	201610	5	1	0	0	4	4	1	0	1260	698	190	654	271	26
43388	Open_Shortest_Path_First	201611	5	2	0	0	5	2	2	0	1265	701	192	656	271	26
43388	Open_Shortest_Path_First	201612	5	1	0	0	5	4	1	0	1270	704	193	660	273	26
43388	Open_Shortest_Path_First	201701	2	1	0	0	2	1	1	0	1272	705	194	661	273	26
43388	Open_Shortest_Path_First	201702	10	1	0	0	5	3	1	0	1282	708	195	665	274	26
43388	Open_Shortest_Path_First	201703	2	0	0	0	1	0	0	0	1284	709	195	665	274	26
43388	Open_Shortest_Path_First	201704	7	1	0	0	4	1	1	0	1291	713	196	666	275	26
43388	Open_Shortest_Path_First	201705	1	0	0	0	1	1	0	0	1292	713	196	667	275	26
43388	Open_Shortest_Path_First	201707	4	0	0	0	4	2	0	0	1296	716	196	669	276	26
43388	Open_Shortest_Path_First	201708	9	1	0	0	5	2	1	0	1305	719	197	673	276	26
43388	Open_Shortest_Path_First	201709	4	0	0	0	3	1	0	0	1309	722	197	674	277	26
43388	Open_Shortest_Path_First	201711	4	1	0	0	4	4	1	0	1313	724	198	678	279	27
43388	Open_Shortest_Path_First	201712	7	1	0	0	6	6	1	0	1320	728	199	685	283	28
43388	Open_Shortest_Path_First	201801	5	0	0	0	4	4	0	0	1325	731	199	690	285	28
43388	Open_Shortest_Path_First	201802	9	1	0	0	8	6	1	0	1334	735	200	697	286	28
43388	Open_Shortest_Path_First	201803	2	0	0	0	1	1	0	0	1336	735	200	699	286	28
43388	Open_Shortest_Path_First	201804	1	0	0	0	1	1	0	0	1337	736	200	700	287	28
43388	Open_Shortest_Path_First	201805	6	0	0	0	5	3	0	0	1343	741	200	703	289	28
43388	Open_Shortest_Path_First	201806	6	1	0	0	6	3	1	0	1349	747	201	706	292	28
43388	Open_Shortest_Path_First	201807	3	1	0	0	3	1	1	0	1352	749	202	707	292	28
28698611	Over-the-top_media_services	201010	11	0	0	0	3	3	0	0	11	3	0	11	3	0
28698611	Over-the-top_media_services	201101	1	0	0	0	1	1	0	0	12	4	0	12	4	0
28698611	Over-the-top_media_services	201105	9	0	0	0	3	2	0	0	21	6	0	18	5	0
28698611	Over-the-top_media_services	201106	2	0	0	0	2	2	0	0	23	8	0	20	7	0
28698611	Over-the-top_media_services	201107	1	0	0	0	1	1	0	0	24	9	0	21	8	0
28698611	Over-the-top_media_services	201108	4	0	0	0	4	3	0	0	28	13	0	24	11	0
28698611	Over-the-top_media_services	201109	6	0	0	0	5	3	0	0	34	18	0	27	14	0
28698611	Over-the-top_media_services	201110	4	1	0	0	3	3	1	0	38	20	1	31	16	1
28698611	Over-the-top_media_services	201111	2	0	0	0	1	1	0	0	40	21	1	33	17	1
28698611	Over-the-top_media_services	201112	2	0	0	0	2	2	0	0	42	23	1	35	19	1
28698611	Over-the-top_media_services	201201	1	0	0	0	1	0	0	0	43	24	1	35	19	1
28698611	Over-the-top_media_services	201205	3	0	0	0	3	1	0	0	46	27	1	36	20	1
28698611	Over-the-top_media_services	201206	2	0	0	0	1	1	0	0	48	28	1	38	21	1
28698611	Over-the-top_media_services	201207	1	0	0	0	1	0	0	0	49	29	1	38	21	1
28698611	Over-the-top_media_services	201209	3	0	0	0	2	1	0	0	52	31	1	39	22	1
28698611	Over-the-top_media_services	201210	4	0	0	0	4	2	0	0	56	35	1	41	24	1
28698611	Over-the-top_media_services	201211	1	0	0	0	1	0	0	0	57	36	1	41	24	1
28698611	Over-the-top_media_services	201212	2	0	0	0	2	2	0	0	59	38	1	43	26	1
28698611	Over-the-top_media_services	201301	1	0	0	0	1	1	0	0	60	39	1	44	27	1
28698611	Over-the-top_media_services	201302	6	1	0	0	6	5	1	0	66	43	2	49	30	1
28698611	Over-the-top_media_services	201303	3	0	0	0	3	2	0	0	69	46	2	51	32	1
28698611	Over-the-top_media_services	201304	12	2	0	0	5	3	1	0	81	49	4	61	33	3
28698611	Over-the-top_media_services	201305	3	0	0	0	3	1	0	0	84	52	4	62	34	3
28698611	Over-the-top_media_services	201306	1	0	0	0	1	1	0	0	85	53	4	63	35	3
28698611	Over-the-top_media_services	201307	7	0	0	0	2	1	0	0	92	55	4	69	36	3
28698611	Over-the-top_media_services	201308	3	0	0	0	3	2	0	0	95	58	4	71	38	3
28698611	Over-the-top_media_services	201309	3	0	0	0	2	2	0	0	98	59	4	74	39	3
28698611	Over-the-top_media_services	201310	4	0	0	0	4	3	0	0	102	63	4	77	42	3
28698611	Over-the-top_media_services	201311	8	3	0	0	6	3	2	0	110	66	7	80	43	3
28698611	Over-the-top_media_services	201312	1	0	0	0	1	0	0	0	111	67	7	80	43	3
28698611	Over-the-top_media_services	201401	1	0	0	0	1	0	0	0	112	68	7	80	43	3
28698611	Over-the-top_media_services	201402	10	0	0	0	6	3	0	0	122	74	7	84	46	3
28698611	Over-the-top_media_services	201403	3	0	0	0	3	2	0	0	125	77	7	86	48	3
28698611	Over-the-top_media_services	201404	2	0	0	0	2	1	0	0	127	79	7	87	49	3
28698611	Over-the-top_media_services	201405	7	1	0	0	5	2	1	0	134	83	8	90	50	4
28698611	Over-the-top_media_services	201406	1	0	0	0	1	0	0	0	135	84	8	90	50	4
28698611	Over-the-top_media_services	201407	4	0	0	0	3	2	0	0	139	86	8	93	51	4
28698611	Over-the-top_media_services	201408	1	0	0	0	1	1	0	0	140	87	8	94	51	4
28698611	Over-the-top_media_services	201409	1	0	0	0	1	0	0	0	141	88	8	94	51	4
28698611	Over-the-top_media_services	201410	2	0	0	0	2	2	0	0	143	90	8	96	53	4
28698611	Over-the-top_media_services	201411	1	0	0	0	1	0	0	0	144	91	8	96	53	4
28698611	Over-the-top_media_services	201412	7	0	0	0	7	6	0	0	151	97	8	102	58	4
28698611	Over-the-top_media_services	201501	1	0	0	0	1	0	0	0	152	98	8	102	58	4
28698611	Over-the-top_media_services	201502	2	0	0	0	1	1	0	0	154	98	8	104	58	4
28698611	Over-the-top_media_services	201503	7	0	0	0	6	3	0	0	161	104	8	108	61	4
28698611	Over-the-top_media_services	201504	8	0	0	0	6	3	0	0	169	108	8	112	62	4
28698611	Over-the-top_media_services	201505	2	0	0	0	2	2	0	0	171	110	8	114	64	4
28698611	Over-the-top_media_services	201506	11	1	0	0	8	5	1	0	182	118	9	120	69	4
28698611	Over-the-top_media_services	201507	5	1	0	0	3	2	1	0	187	121	10	124	71	5
28698611	Over-the-top_media_services	201508	4	0	0	0	3	1	0	0	191	122	10	125	71	5
28698611	Over-the-top_media_services	201509	14	1	0	0	7	5	1	0	205	128	11	137	75	5
28698611	Over-the-top_media_services	201510	2	0	0	0	2	1	0	0	207	130	11	138	76	5
28698611	Over-the-top_media_services	201512	2	0	0	0	2	1	0	0	209	131	11	139	76	5
28698611	Over-the-top_media_services	201601	2	0	0	0	2	0	0	0	211	133	11	139	76	5
28698611	Over-the-top_media_services	201602	7	0	0	0	7	6	0	0	218	139	11	145	81	5
28698611	Over-the-top_media_services	201603	12	2	0	0	10	8	2	0	230	146	13	154	86	6
28698611	Over-the-top_media_services	201604	3	0	0	0	2	2	0	0	233	148	13	157	88	6
28698611	Over-the-top_media_services	201605	6	0	0	0	5	4	0	0	239	153	13	162	92	6
28698611	Over-the-top_media_services	201606	11	2	0	0	9	4	1	0	250	161	15	167	95	6
28698611	Over-the-top_media_services	201607	9	1	0	0	7	4	1	0	259	166	16	173	97	7
28698611	Over-the-top_media_services	201608	5	0	0	0	3	3	0	0	264	167	16	178	97	7
28698611	Over-the-top_media_services	201609	3	1	0	0	2	2	1	0	267	169	17	181	98	8
28698611	Over-the-top_media_services	201611	1	0	0	0	1	1	0	0	268	170	17	182	99	8
28698611	Over-the-top_media_services	201612	5	1	0	0	4	3	1	0	273	173	18	186	101	9
28698611	Over-the-top_media_services	201701	36	1	0	0	8	5	1	0	309	178	19	204	103	9
28698611	Over-the-top_media_services	201702	3	0	0	0	2	2	0	0	312	180	19	207	105	9
28698611	Over-the-top_media_services	201703	3	1	0	0	3	2	1	0	315	183	20	209	107	9
28698611	Over-the-top_media_services	201704	1	0	0	0	1	1	0	0	316	184	20	210	108	9
28698611	Over-the-top_media_services	201705	6	0	0	0	4	1	0	0	322	188	20	211	109	9
28698611	Over-the-top_media_services	201706	1	0	0	0	1	1	0	0	323	189	20	212	110	9
28698611	Over-the-top_media_services	201707	4	1	0	0	3	1	1	0	327	192	21	213	111	9
28698611	Over-the-top_media_services	201708	3	1	0	0	2	2	1	0	330	194	22	216	113	10
28698611	Over-the-top_media_services	201709	3	0	0	0	3	3	0	0	333	197	22	219	116	10
28698611	Over-the-top_media_services	201710	1	0	0	0	1	1	0	0	334	198	22	220	117	10
28698611	Over-the-top_media_services	201711	7	0	0	0	3	3	0	0	341	199	22	227	118	10
28698611	Over-the-top_media_services	201712	4	1	0	0	4	2	1	0	345	202	23	229	119	10
28698611	Over-the-top_media_services	201801	4	0	0	0	4	2	0	0	349	206	23	231	121	10
28698611	Over-the-top_media_services	201803	3	0	0	0	3	1	0	0	352	209	23	232	122	10
28698611	Over-the-top_media_services	201804	3	0	0	0	3	2	0	0	355	212	23	234	124	10
28698611	Over-the-top_media_services	201805	2	1	0	0	2	1	1	0	357	214	24	235	125	10
28698611	Over-the-top_media_services	201806	18	1	0	0	8	6	1	0	375	220	25	249	129	10
1014669	Overlay_network	200410	9	0	0	0	1	1	0	0	9	1	0	9	1	0
1014669	Overlay_network	200411	2	0	0	0	2	0	0	0	11	3	0	9	1	0
1014669	Overlay_network	200412	5	1	0	0	4	2	1	0	16	7	1	11	3	0
1014669	Overlay_network	200502	1	0	0	0	1	0	0	0	17	8	1	11	3	0
1014669	Overlay_network	200506	1	0	0	0	1	0	0	0	18	9	1	11	3	0
1014669	Overlay_network	200507	2	0	0	0	2	1	0	0	20	11	1	12	4	0
1014669	Overlay_network	200508	5	0	0	0	2	1	0	0	25	13	1	14	5	0
1014669	Overlay_network	200509	8	1	0	0	5	4	1	0	33	17	2	21	8	0
1014669	Overlay_network	200510	3	0	0	0	3	3	0	0	36	19	2	24	10	0
1014669	Overlay_network	200511	6	0	0	0	3	2	0	0	42	21	2	27	11	0
1014669	Overlay_network	200603	4	2	0	0	3	3	1	0	46	22	4	31	12	1
1014669	Overlay_network	200605	1	0	0	0	1	1	0	0	47	23	4	32	13	1
1014669	Overlay_network	200608	1	0	0	0	1	1	0	0	48	24	4	33	14	1
1014669	Overlay_network	200609	2	1	0	0	2	1	1	0	50	26	5	34	15	1
1014669	Overlay_network	200610	4	1	0	0	4	3	1	0	54	30	6	37	18	1
1014669	Overlay_network	200611	2	0	0	0	2	1	0	0	56	32	6	38	19	1
1014669	Overlay_network	200612	3	1	0	0	3	2	1	0	59	33	7	40	19	1
1014669	Overlay_network	200702	1	0	0	0	1	0	0	0	60	34	7	40	19	1
1014669	Overlay_network	200703	3	0	0	0	3	2	0	0	63	37	7	42	21	1
1014669	Overlay_network	200705	2	0	0	0	1	0	0	0	65	38	7	42	21	1
1014669	Overlay_network	200706	1	0	0	0	1	0	0	0	66	39	7	42	21	1
1014669	Overlay_network	200707	3	0	0	0	1	0	0	0	69	40	7	42	21	1
1014669	Overlay_network	200708	3	0	0	0	2	2	0	0	72	41	7	45	22	1
1014669	Overlay_network	200711	1	0	0	0	1	1	0	0	73	41	7	46	22	1
1014669	Overlay_network	200712	3	0	0	0	2	0	0	0	76	43	7	46	22	1
1014669	Overlay_network	200801	4	1	0	0	4	3	1	0	80	46	8	49	24	1
1014669	Overlay_network	200802	4	0	0	0	4	3	0	0	84	49	8	52	26	1
1014669	Overlay_network	200803	1	0	0	0	1	0	0	0	85	50	8	52	26	1
1014669	Overlay_network	200805	1	0	0	0	1	1	0	0	86	51	8	53	27	1
1014669	Overlay_network	200810	1	0	0	0	1	1	0	0	87	52	8	54	28	1
1014669	Overlay_network	200901	1	0	0	0	1	1	0	0	88	53	8	55	29	1
1014669	Overlay_network	200904	1	0	0	0	1	1	0	0	89	54	8	56	30	1
1014669	Overlay_network	200905	1	0	0	0	1	0	0	0	90	55	8	56	30	1
1014669	Overlay_network	200907	1	0	0	0	1	1	0	0	91	55	8	57	30	1
1014669	Overlay_network	200908	1	0	0	0	1	1	0	0	92	56	8	58	31	1
1014669	Overlay_network	201001	2	1	0	0	2	1	1	0	94	57	9	59	31	1
1014669	Overlay_network	201002	1	0	0	0	1	1	0	0	95	58	9	60	32	1
1014669	Overlay_network	201004	2	1	0	0	2	1	1	0	97	59	10	61	32	1
1014669	Overlay_network	201005	10	0	0	0	2	2	0	0	107	61	10	71	34	1
1014669	Overlay_network	201006	2	0	0	0	2	2	0	0	109	63	10	73	36	1
1014669	Overlay_network	201009	3	1	0	0	3	3	1	0	112	65	11	76	38	2
1014669	Overlay_network	201012	2	0	0	0	2	2	0	0	114	67	11	78	40	2
1014669	Overlay_network	201101	1	0	0	0	1	0	0	0	115	68	11	78	40	2
1014669	Overlay_network	201103	2	0	0	0	2	1	0	0	117	70	11	79	41	2
1014669	Overlay_network	201104	2	0	0	0	1	0	0	0	119	71	11	79	41	2
1014669	Overlay_network	201107	2	0	0	0	2	2	0	0	121	71	11	81	41	2
1014669	Overlay_network	201108	1	0	0	0	1	1	0	0	122	72	11	82	42	2
1014669	Overlay_network	201109	1	0	0	0	1	1	0	0	123	73	11	83	43	2
1014669	Overlay_network	201110	3	0	0	0	3	2	0	0	126	76	11	85	45	2
1014669	Overlay_network	201111	1	0	0	0	1	0	0	0	127	77	11	85	45	2
1014669	Overlay_network	201112	3	0	0	0	2	1	0	0	130	79	11	86	46	2
1014669	Overlay_network	201201	1	0	0	0	1	1	0	0	131	79	11	87	46	2
1014669	Overlay_network	201202	1	0	0	0	1	0	0	0	132	80	11	87	46	2
1014669	Overlay_network	201204	2	0	0	0	2	0	0	0	134	82	11	87	46	2
1014669	Overlay_network	201207	1	0	0	0	1	1	0	0	135	83	11	88	47	2
1014669	Overlay_network	201209	3	0	0	0	2	1	0	0	138	84	11	89	47	2
1014669	Overlay_network	201210	3	1	0	0	2	1	1	0	141	86	12	90	48	2
1014669	Overlay_network	201211	5	2	0	0	4	4	1	0	146	89	14	95	50	3
1014669	Overlay_network	201212	1	0	0	0	1	1	0	0	147	90	14	96	51	3
1014669	Overlay_network	201301	1	0	0	0	1	1	0	0	148	91	14	97	52	3
1014669	Overlay_network	201302	1	0	0	0	1	1	0	0	149	91	14	98	52	3
1014669	Overlay_network	201303	6	1	0	0	5	3	1	0	155	96	15	101	55	3
1014669	Overlay_network	201304	1	0	0	0	1	1	0	0	156	97	15	102	56	3
1014669	Overlay_network	201309	1	0	0	0	1	0	0	0	157	98	15	102	56	3
1014669	Overlay_network	201311	2	0	0	0	1	0	0	0	159	99	15	102	56	3
1014669	Overlay_network	201401	1	0	0	0	1	0	0	0	160	100	15	102	56	3
1014669	Overlay_network	201402	1	0	0	0	1	1	0	0	161	101	15	103	57	3
1014669	Overlay_network	201406	2	1	0	0	2	1	1	0	163	103	16	104	58	3
1014669	Overlay_network	201407	3	1	0	0	3	2	1	0	166	106	17	106	60	3
1014669	Overlay_network	201408	1	0	0	0	1	1	0	0	167	107	17	107	61	3
1014669	Overlay_network	201412	1	0	0	0	1	1	0	0	168	108	17	108	62	3
1014669	Overlay_network	201502	1	0	0	0	1	0	0	0	169	109	17	108	62	3
1014669	Overlay_network	201503	2	0	0	0	1	0	0	0	171	110	17	108	62	3
1014669	Overlay_network	201506	1	0	0	0	1	1	0	0	172	111	17	109	63	3
1014669	Overlay_network	201508	3	0	0	0	2	2	0	0	175	113	17	112	65	3
1014669	Overlay_network	201509	4	1	0	0	4	2	1	0	179	117	18	114	67	3
1014669	Overlay_network	201609	1	0	0	0	1	0	0	0	180	118	18	114	67	3
1014669	Overlay_network	201610	2	0	0	0	1	1	0	0	182	119	18	116	68	3
1014669	Overlay_network	201702	1	0	0	0	1	1	0	0	183	119	18	117	68	3
1014669	Overlay_network	201704	1	0	0	0	1	1	0	0	184	120	18	118	69	3
1014669	Overlay_network	201705	1	0	0	0	1	0	0	0	185	121	18	118	69	3
1014669	Overlay_network	201706	4	1	0	0	4	2	1	0	189	125	19	120	70	4
1014669	Overlay_network	201707	3	1	0	0	3	2	1	0	192	128	20	122	72	4
1014669	Overlay_network	201708	2	0	0	0	1	0	0	0	194	129	20	122	72	4
1014669	Overlay_network	201709	2	0	0	0	2	2	0	0	196	131	20	124	74	4
1014669	Overlay_network	201712	1	0	0	0	1	1	0	0	197	132	20	125	75	4
1014669	Overlay_network	201801	2	0	0	0	2	2	0	0	199	134	20	127	77	4
1014669	Overlay_network	201802	1	0	0	0	1	1	0	0	200	135	20	128	78	4
1014669	Overlay_network	201803	4	1	0	0	4	2	1	0	204	139	21	130	80	5
1014669	Overlay_network	201805	1	0	0	0	1	1	0	0	205	140	21	131	81	5
1014669	Overlay_network	201806	1	0	0	0	1	0	0	0	206	141	21	131	81	5
1014669	Overlay_network	201807	2	1	0	0	2	1	1	0	208	143	22	132	82	5
143320	PCI_Express	200303	5	0	0	0	2	2	0	0	5	2	0	5	2	0
143320	PCI_Express	200307	1	0	0	0	1	0	0	0	6	3	0	5	2	0
143320	PCI_Express	200401	1	0	0	0	1	1	0	0	7	4	0	6	3	0
143320	PCI_Express	200403	2	0	0	0	1	0	0	0	9	5	0	6	3	0
143320	PCI_Express	200404	1	0	0	0	1	0	0	0	10	6	0	6	3	0
143320	PCI_Express	200405	2	0	0	0	2	0	0	0	12	8	0	6	3	0
143320	PCI_Express	200406	1	0	0	0	1	1	0	0	13	9	0	7	4	0
143320	PCI_Express	200407	3	0	0	0	3	1	0	0	16	11	0	8	4	0
143320	PCI_Express	200408	2	0	0	0	2	2	0	0	18	13	0	10	6	0
143320	PCI_Express	200409	2	0	0	0	2	2	0	0	20	15	0	12	8	0
143320	PCI_Express	200410	5	1	0	0	4	3	1	0	25	19	1	16	11	1
143320	PCI_Express	200411	5	0	0	0	3	2	0	0	30	21	1	19	13	1
143320	PCI_Express	200412	1	0	0	0	1	1	0	0	31	22	1	20	14	1
143320	PCI_Express	200501	8	3	0	0	7	3	2	0	39	28	4	24	16	1
143320	PCI_Express	200502	5	0	0	0	5	3	0	0	44	32	4	27	18	1
143320	PCI_Express	200503	6	1	0	0	6	3	1	0	50	38	5	30	21	1
143320	PCI_Express	200504	3	0	0	0	3	2	0	0	53	40	5	32	22	1
143320	PCI_Express	200505	4	0	0	0	4	3	0	0	57	44	5	35	25	1
143320	PCI_Express	200506	18	1	0	0	12	5	1	0	75	54	6	40	28	1
143320	PCI_Express	200507	1	0	0	0	1	0	0	0	76	55	6	40	28	1
143320	PCI_Express	200508	22	2	0	0	17	9	2	0	98	71	8	49	36	1
143320	PCI_Express	200509	13	0	0	0	9	5	0	0	111	79	8	58	40	1
143320	PCI_Express	200510	16	1	0	0	11	3	1	0	127	89	9	61	42	1
143320	PCI_Express	200511	10	0	0	0	8	5	0	0	137	97	9	68	47	1
143320	PCI_Express	200512	16	3	0	0	12	7	3	0	153	107	12	77	52	1
143320	PCI_Express	200601	20	1	0	0	15	7	1	0	173	122	13	86	59	1
143320	PCI_Express	200602	25	2	0	0	13	7	1	0	198	134	15	101	65	1
143320	PCI_Express	200603	12	1	0	0	10	6	1	0	210	143	16	109	70	1
143320	PCI_Express	200604	8	1	0	0	8	2	1	0	218	151	17	111	72	1
143320	PCI_Express	200605	13	3	0	0	10	7	2	0	231	160	20	120	78	1
143320	PCI_Express	200606	9	3	0	0	7	3	2	0	240	166	23	125	80	1
143320	PCI_Express	200607	13	2	0	0	11	6	1	0	253	176	25	133	85	1
143320	PCI_Express	200608	18	0	0	0	11	7	0	0	271	186	25	147	91	1
143320	PCI_Express	200609	30	3	0	0	23	12	1	0	301	206	28	163	101	1
143320	PCI_Express	200610	24	3	0	0	20	10	3	0	325	221	31	173	107	1
143320	PCI_Express	200611	25	3	0	0	16	5	3	0	350	235	34	179	110	1
143320	PCI_Express	200612	44	7	0	0	23	14	5	0	394	254	41	206	120	3
143320	PCI_Express	200701	31	3	0	0	23	13	2	0	425	274	44	226	130	3
143320	PCI_Express	200702	43	4	0	0	27	14	4	0	468	295	48	253	139	3
143320	PCI_Express	200703	39	2	0	0	25	14	2	0	507	314	50	279	148	3
143320	PCI_Express	200704	32	3	0	0	20	10	3	0	539	329	53	297	153	4
143320	PCI_Express	200705	31	3	0	0	22	9	3	0	570	347	56	313	158	4
143320	PCI_Express	200706	17	2	0	0	14	8	2	0	587	359	58	324	164	4
143320	PCI_Express	200707	28	1	0	0	20	8	1	0	615	377	59	333	171	4
143320	PCI_Express	200708	38	5	0	0	24	10	4	0	653	397	64	348	179	5
143320	PCI_Express	200709	29	2	0	0	21	6	2	0	682	415	66	355	182	5
143320	PCI_Express	200710	51	8	0	0	30	13	6	0	733	440	74	373	191	6
143320	PCI_Express	200711	54	7	0	0	34	13	6	0	787	471	81	399	201	6
143320	PCI_Express	200712	48	6	0	0	30	20	5	0	835	498	87	435	218	8
143320	PCI_Express	200801	26	6	0	0	17	8	1	0	861	512	93	451	223	9
143320	PCI_Express	200802	41	5	0	0	24	10	5	0	902	533	98	472	230	10
143320	PCI_Express	200803	12	2	0	0	11	6	2	0	914	542	100	478	234	10
143320	PCI_Express	200804	31	3	1	0	21	9	2	1	945	558	103	492	238	11
143320	PCI_Express	200805	41	5	0	0	24	7	3	0	986	579	108	507	244	11
143320	PCI_Express	200806	12	2	0	0	9	6	2	0	998	587	110	515	249	11
143320	PCI_Express	200807	13	2	0	0	11	3	1	0	1011	597	112	519	251	11
143320	PCI_Express	200808	15	4	0	0	9	4	3	0	1026	605	116	524	254	12
143320	PCI_Express	200809	17	3	0	0	13	8	3	0	1043	618	119	534	262	13
143320	PCI_Express	200810	18	0	0	0	12	6	0	0	1061	628	119	543	266	13
143320	PCI_Express	200811	26	6	0	0	19	10	5	0	1087	644	125	556	273	13
143320	PCI_Express	200812	59	9	0	0	36	15	8	0	1146	675	134	585	284	14
143320	PCI_Express	200901	30	3	1	0	18	6	3	1	1176	691	137	599	288	16
143320	PCI_Express	200902	18	2	0	0	15	8	2	0	1194	704	139	607	294	16
143320	PCI_Express	200903	23	2	0	0	15	9	2	0	1217	714	141	623	298	17
143320	PCI_Express	200904	20	3	0	0	14	6	3	0	1237	724	144	631	300	17
143320	PCI_Express	200905	13	4	0	0	9	2	3	0	1250	732	148	633	301	18
143320	PCI_Express	200906	10	3	0	0	9	6	2	0	1260	739	151	640	305	19
143320	PCI_Express	200907	20	2	0	0	13	4	2	0	1280	750	153	644	307	19
143320	PCI_Express	200908	18	3	0	0	15	6	3	0	1298	762	156	650	310	19
143320	PCI_Express	200909	28	0	0	0	13	5	0	0	1326	775	156	658	315	19
143320	PCI_Express	200910	27	3	0	0	19	7	3	0	1353	793	159	670	321	19
143320	PCI_Express	200911	19	0	0	0	13	7	0	0	1372	806	159	681	328	19
143320	PCI_Express	200912	24	4	0	0	19	13	4	0	1396	821	163	698	337	19
143320	PCI_Express	201001	16	2	0	0	15	6	2	0	1412	832	165	704	339	19
143320	PCI_Express	201002	9	1	0	0	7	3	1	0	1421	838	166	708	341	19
143320	PCI_Express	201003	17	4	0	0	12	5	3	0	1438	849	170	714	345	19
143320	PCI_Express	201004	14	0	0	0	6	3	0	0	1452	855	170	717	348	19
143320	PCI_Express	201005	15	2	0	0	11	6	2	0	1467	862	172	724	352	19
143320	PCI_Express	201006	21	4	0	0	16	9	1	0	1488	876	176	736	359	20
143320	PCI_Express	201007	14	2	0	0	11	6	2	0	1502	886	178	744	364	20
143320	PCI_Express	201008	51	5	0	0	23	5	4	0	1553	906	183	750	366	21
143320	PCI_Express	201009	30	4	0	0	24	11	4	0	1583	928	187	765	375	22
143320	PCI_Express	201010	17	3	0	0	16	7	3	0	1600	942	190	773	380	22
143320	PCI_Express	201011	18	4	0	0	11	6	4	0	1618	952	194	781	385	22
143320	PCI_Express	201012	23	4	0	0	16	8	2	0	1641	964	198	791	390	23
143320	PCI_Express	201101	15	3	0	0	14	7	2	0	1656	975	201	799	394	23
143320	PCI_Express	201102	15	1	0	0	12	4	1	0	1671	986	202	806	397	23
143320	PCI_Express	201103	21	4	0	0	12	4	3	0	1692	995	206	814	398	23
143320	PCI_Express	201104	25	5	3	2	17	7	3	2	1717	1009	211	827	403	28
143320	PCI_Express	201105	17	0	0	0	11	3	0	0	1734	1019	211	832	405	28
143320	PCI_Express	201106	25	2	0	0	14	6	1	0	1759	1031	213	839	409	29
143320	PCI_Express	201107	19	4	0	0	15	8	3	0	1778	1042	217	851	413	30
143320	PCI_Express	201108	14	1	0	0	12	4	1	0	1792	1053	218	856	416	30
143320	PCI_Express	201109	14	2	0	0	12	7	2	0	1806	1063	220	863	421	30
143320	PCI_Express	201110	32	6	0	0	18	11	6	0	1838	1080	226	874	431	30
143320	PCI_Express	201111	12	0	0	0	9	4	0	0	1850	1089	226	880	435	30
143320	PCI_Express	201112	5	0	0	0	4	2	0	0	1855	1092	226	883	436	30
143320	PCI_Express	201201	23	2	0	0	14	8	2	0	1878	1103	228	899	441	30
143320	PCI_Express	201202	19	1	0	0	14	7	1	0	1897	1115	229	908	446	30
143320	PCI_Express	201203	17	1	0	0	10	6	1	0	1914	1123	230	918	450	30
143320	PCI_Express	201204	19	1	0	0	14	8	1	0	1933	1135	231	930	456	30
143320	PCI_Express	201205	12	1	0	0	10	2	1	0	1945	1144	232	932	457	30
143320	PCI_Express	201206	4	1	0	0	4	2	1	0	1949	1147	233	934	458	30
143320	PCI_Express	201207	16	1	0	0	11	5	1	0	1965	1157	234	940	462	30
143320	PCI_Express	201208	26	1	0	0	16	7	1	0	1991	1169	235	956	466	30
143320	PCI_Express	201209	14	1	0	0	12	6	1	0	2005	1179	236	962	470	30
143320	PCI_Express	201210	9	1	0	0	9	5	1	0	2014	1187	237	967	474	30
143320	PCI_Express	201211	19	2	0	0	14	8	2	0	2033	1198	239	978	479	30
143320	PCI_Express	201212	10	0	0	0	8	7	0	0	2043	1205	239	986	485	30
143320	PCI_Express	201301	23	2	0	0	11	6	1	0	2066	1214	241	1002	489	30
143320	PCI_Express	201302	11	3	0	0	8	4	2	0	2077	1220	244	1009	491	30
143320	PCI_Express	201303	15	0	0	0	6	3	0	0	2092	1226	244	1017	494	30
143320	PCI_Express	201304	11	2	0	0	7	4	2	0	2103	1231	246	1025	496	30
143320	PCI_Express	201305	14	2	0	0	9	4	1	0	2117	1238	248	1032	498	30
143320	PCI_Express	201306	24	1	0	0	9	4	1	0	2141	1246	249	1036	501	31
143320	PCI_Express	201307	12	3	0	0	9	4	3	0	2153	1253	252	1042	503	32
143320	PCI_Express	201308	8	1	0	0	7	5	1	0	2161	1259	253	1048	507	32
143320	PCI_Express	201309	10	0	0	0	10	5	0	0	2171	1268	253	1053	511	32
143320	PCI_Express	201310	11	1	0	0	7	5	1	0	2182	1273	254	1062	514	32
143320	PCI_Express	201311	11	1	0	0	5	1	1	0	2193	1278	255	1063	515	32
143320	PCI_Express	201312	12	0	0	0	8	3	0	0	2205	1284	255	1067	516	32
143320	PCI_Express	201401	35	1	0	0	9	4	1	0	2240	1291	256	1096	519	32
143320	PCI_Express	201402	35	3	0	0	11	8	2	0	2275	1297	259	1124	523	34
143320	PCI_Express	201403	21	4	0	0	10	4	4	0	2296	1304	263	1135	525	35
143320	PCI_Express	201405	21	2	0	0	6	4	1	0	2317	1308	265	1153	527	35
143320	PCI_Express	201406	18	0	0	0	6	5	0	0	2335	1313	265	1167	531	35
143320	PCI_Express	201407	4	1	0	0	4	3	1	0	2339	1314	266	1170	531	35
143320	PCI_Express	201408	16	1	0	0	6	4	1	0	2355	1317	267	1183	532	35
143320	PCI_Express	201409	9	1	0	0	4	1	1	0	2364	1320	268	1184	532	35
143320	PCI_Express	201410	22	3	0	0	7	6	2	0	2386	1324	271	1204	535	37
143320	PCI_Express	201411	6	1	0	0	4	2	1	0	2392	1327	272	1208	536	37
143320	PCI_Express	201412	25	1	0	0	4	2	1	0	2417	1330	273	1231	537	38
143320	PCI_Express	201501	22	1	0	0	6	6	1	0	2439	1331	274	1253	538	39
143320	PCI_Express	201502	14	2	0	0	8	3	2	0	2453	1337	276	1262	539	39
143320	PCI_Express	201503	9	2	0	0	6	2	1	0	2462	1341	278	1266	539	39
143320	PCI_Express	201504	17	2	0	0	8	6	2	0	2479	1347	280	1280	543	40
143320	PCI_Express	201505	19	4	1	0	7	6	3	1	2498	1352	284	1298	547	43
143320	PCI_Express	201506	9	3	1	1	7	6	3	1	2507	1356	287	1306	550	45
143320	PCI_Express	201507	11	1	0	0	3	2	1	0	2518	1357	288	1316	550	45
143320	PCI_Express	201508	6	1	0	0	5	4	1	0	2524	1360	289	1321	552	45
143320	PCI_Express	201510	3	0	0	0	1	1	0	0	2527	1361	289	1324	553	45
143320	PCI_Express	201511	22	3	0	0	8	4	2	0	2549	1366	292	1340	555	46
143320	PCI_Express	201512	11	2	1	0	3	2	2	1	2560	1367	294	1349	555	47
143320	PCI_Express	201601	1	0	0	0	1	1	0	0	2561	1368	294	1350	556	47
143320	PCI_Express	201602	9	1	0	0	4	2	1	0	2570	1370	295	1356	556	47
143320	PCI_Express	201603	29	4	0	0	11	7	3	0	2599	1377	299	1379	559	49
143320	PCI_Express	201604	17	6	0	0	8	5	4	0	2616	1384	305	1386	563	49
143320	PCI_Express	201605	4	1	0	0	3	2	1	0	2620	1385	306	1389	563	49
143320	PCI_Express	201606	5	0	0	0	4	4	0	0	2625	1387	306	1394	565	49
143320	PCI_Express	201607	8	1	0	0	6	3	1	0	2633	1391	307	1397	566	49
143320	PCI_Express	201608	11	2	0	0	10	4	2	0	2644	1398	309	1402	567	49
143320	PCI_Express	201609	45	3	0	0	19	7	1	0	2689	1415	312	1418	572	49
143320	PCI_Express	201610	7	2	0	0	7	5	2	0	2696	1421	314	1423	574	49
143320	PCI_Express	201611	5	1	0	0	5	2	1	0	2701	1425	315	1425	574	49
143320	PCI_Express	201612	6	1	0	0	5	4	1	0	2707	1429	316	1430	577	49
143320	PCI_Express	201701	9	2	0	0	6	5	1	0	2716	1432	318	1438	578	50
143320	PCI_Express	201702	2	0	0	0	2	2	0	0	2718	1433	318	1440	579	50
143320	PCI_Express	201703	7	1	0	0	5	4	1	0	2725	1437	319	1446	582	50
143320	PCI_Express	201704	16	1	0	0	12	8	1	0	2741	1444	320	1458	587	50
143320	PCI_Express	201705	11	0	0	0	5	4	0	0	2752	1446	320	1465	588	50
143320	PCI_Express	201706	7	3	0	0	7	5	3	0	2759	1450	323	1470	589	52
143320	PCI_Express	201707	18	2	0	0	12	8	1	0	2777	1457	325	1481	592	53
143320	PCI_Express	201708	9	0	0	0	9	5	0	0	2786	1464	325	1486	594	53
143320	PCI_Express	201709	11	1	0	0	6	4	1	0	2797	1466	326	1490	595	53
143320	PCI_Express	201710	3	0	0	0	3	3	0	0	2800	1469	326	1493	598	53
143320	PCI_Express	201711	12	3	0	0	9	6	3	0	2812	1475	329	1501	601	55
143320	PCI_Express	201712	3	0	0	0	3	3	0	0	2815	1477	329	1504	603	55
143320	PCI_Express	201801	10	1	0	0	6	2	1	0	2825	1482	330	1508	604	55
143320	PCI_Express	201802	9	1	0	0	8	4	1	0	2834	1487	331	1512	606	55
143320	PCI_Express	201803	1	0	0	0	1	0	0	0	2835	1488	331	1512	606	55
143320	PCI_Express	201804	5	0	0	0	5	4	0	0	2840	1491	331	1516	608	55
143320	PCI_Express	201805	8	0	0	0	6	4	0	0	2848	1494	331	1522	609	55
143320	PCI_Express	201806	17	0	0	0	11	8	0	0	2865	1502	331	1536	614	55
143320	PCI_Express	201807	9	0	0	0	5	3	0	0	2874	1506	331	1543	616	55
24131	PHP	200202	2	0	0	0	2	2	0	0	2	2	0	2	1	0
24131	PHP	200203	3	0	0	0	2	2	0	0	5	4	0	5	2	0
24131	PHP	200205	1	0	0	0	1	1	0	0	6	5	0	6	3	0
24131	PHP	200206	1	0	0	0	1	1	0	0	7	6	0	7	4	0
24131	PHP	200207	3	0	0	0	3	2	0	0	10	9	0	9	6	0
24131	PHP	200208	7	0	0	0	3	2	0	0	17	11	0	11	7	0
24131	PHP	200209	2	0	0	0	2	1	0	0	19	13	0	12	8	0
24131	PHP	200210	2	0	0	0	2	1	0	0	21	15	0	13	9	0
24131	PHP	200211	3	0	0	0	3	2	0	0	24	18	0	15	11	0
24131	PHP	200301	4	0	0	0	4	2	0	0	28	22	0	17	13	0
24131	PHP	200302	7	0	0	0	7	3	0	0	35	29	0	20	16	0
24131	PHP	200303	1	0	0	0	1	1	0	0	36	30	0	21	17	0
24131	PHP	200304	2	0	0	0	2	2	0	0	38	32	0	23	19	0
24131	PHP	200305	2	0	0	0	2	2	0	0	40	33	0	25	20	0
24131	PHP	200306	1	0	0	0	1	0	0	0	41	34	0	25	20	0
24131	PHP	200307	3	0	0	0	3	1	0	0	44	37	0	26	21	0
24131	PHP	200308	5	0	0	0	5	3	0	0	49	42	0	29	24	0
24131	PHP	200309	11	0	0	0	7	5	0	0	60	48	0	38	28	0
24131	PHP	200310	10	0	0	0	7	3	0	0	70	55	0	44	31	0
24131	PHP	200311	7	0	0	0	6	4	0	0	77	60	0	49	34	0
24131	PHP	200312	15	1	0	0	10	4	1	0	92	70	1	53	38	0
24131	PHP	200401	6	0	0	0	6	2	0	0	98	76	1	55	40	0
24131	PHP	200402	12	0	0	0	8	7	0	0	110	84	1	66	47	0
24131	PHP	200403	20	1	0	0	14	6	1	0	130	98	2	75	53	0
24131	PHP	200404	30	1	0	0	22	13	1	0	160	115	3	92	61	1
24131	PHP	200405	21	0	0	0	14	13	0	0	181	127	3	112	72	1
24131	PHP	200406	31	3	0	0	22	15	3	0	212	146	6	136	84	1
24131	PHP	200407	33	3	0	0	18	10	2	0	245	160	9	159	89	2
24131	PHP	200408	70	1	0	0	35	23	1	0	315	191	10	210	108	2
24131	PHP	200409	32	3	0	0	17	10	3	0	347	203	13	232	114	2
24131	PHP	200410	108	5	0	0	37	19	4	0	455	234	18	306	128	5
24131	PHP	200411	38	1	0	0	25	14	1	0	493	254	19	333	137	6
24131	PHP	200412	72	5	0	0	31	11	4	0	565	279	24	371	143	7
24131	PHP	200501	66	5	0	0	26	11	3	0	631	302	29	419	151	8
24131	PHP	200502	66	8	0	0	29	11	4	0	697	325	37	458	158	9
24131	PHP	200503	247	37	0	0	57	21	18	0	944	375	74	513	173	14
24131	PHP	200504	220	23	0	0	58	28	17	0	1164	426	97	592	194	18
24131	PHP	200505	158	14	0	0	46	24	10	0	1322	462	111	637	208	19
24131	PHP	200506	169	26	0	0	44	22	14	0	1491	498	137	686	222	19
24131	PHP	200507	152	26	0	0	43	23	15	0	1643	535	163	726	239	20
24131	PHP	200508	55	1	0	0	34	18	1	0	1698	564	164	754	252	20
24131	PHP	200509	89	14	0	0	52	29	10	0	1787	608	178	803	273	23
24131	PHP	200510	55	10	1	0	43	20	8	1	1842	644	188	827	287	26
24131	PHP	200511	67	11	0	0	45	17	7	0	1909	684	199	855	299	26
24131	PHP	200512	67	7	0	0	45	19	5	0	1976	721	206	887	310	27
24131	PHP	200601	119	16	0	0	61	31	11	0	2095	772	222	954	332	30
24131	PHP	200602	127	11	0	0	74	35	8	0	2222	839	233	1021	361	31
24131	PHP	200603	76	7	0	0	60	25	6	0	2298	892	240	1056	381	32
24131	PHP	200604	90	12	0	0	59	35	10	0	2388	941	252	1111	406	35
24131	PHP	200605	96	26	1	0	65	30	13	1	2484	995	278	1161	426	39
24131	PHP	200606	111	21	0	0	56	24	14	0	2595	1042	299	1230	441	43
24131	PHP	200607	148	33	2	0	73	35	20	1	2743	1103	332	1319	465	49
24131	PHP	200608	109	23	0	0	59	36	10	0	2852	1147	355	1393	487	61
24131	PHP	200609	123	18	0	0	58	32	13	0	2975	1191	373	1466	507	68
24131	PHP	200610	123	36	3	0	61	24	17	3	3098	1237	409	1541	518	74
24131	PHP	200611	133	38	0	0	83	37	20	0	3231	1307	447	1614	542	76
24131	PHP	200612	169	23	1	0	73	43	15	1	3400	1366	470	1732	573	81
24131	PHP	200701	68	14	0	0	48	28	8	0	3468	1403	484	1776	590	84
24131	PHP	200702	113	28	1	0	61	29	14	1	3581	1451	512	1839	607	88
24131	PHP	200703	116	27	0	0	65	34	12	0	3697	1507	539	1914	632	92
24131	PHP	200704	113	26	0	0	65	32	14	0	3810	1560	565	1987	652	96
24131	PHP	200705	120	33	0	0	57	25	14	0	3930	1607	598	2064	667	100
24131	PHP	200706	124	28	3	0	54	30	14	2	4054	1651	626	2155	688	112
24131	PHP	200707	108	30	4	1	58	34	19	4	4162	1693	656	2220	708	122
24131	PHP	200708	88	18	0	0	41	24	7	0	4250	1725	674	2275	724	125
24131	PHP	200709	119	28	1	0	61	34	11	1	4369	1773	702	2362	745	134
24131	PHP	200710	94	23	0	0	57	29	16	0	4463	1815	725	2414	759	137
24131	PHP	200711	78	18	0	0	47	26	11	0	4541	1849	743	2455	772	139
24131	PHP	200712	70	21	0	0	50	20	12	0	4611	1887	764	2485	781	142
24131	PHP	200801	102	24	1	0	53	26	12	1	4713	1928	788	2554	795	146
24131	PHP	200802	82	23	1	0	55	23	11	1	4795	1975	811	2597	810	149
24131	PHP	200803	199	36	3	1	65	40	21	3	4994	2028	847	2761	838	167
24131	PHP	200804	347	34	9	3	67	38	19	7	5341	2079	881	3051	860	181
24131	PHP	200805	55	7	0	0	36	19	5	0	5396	2107	888	3087	871	182
24131	PHP	200806	59	15	1	0	45	26	13	1	5455	2143	903	3122	890	188
24131	PHP	200807	66	20	1	0	48	26	13	1	5521	2179	923	3162	904	194
24131	PHP	200808	71	15	2	1	49	26	12	2	5592	2216	938	3203	918	196
24131	PHP	200809	90	10	0	0	55	27	8	0	5682	2258	948	3251	934	197
24131	PHP	200810	36	7	0	0	30	15	6	0	5718	2281	955	3269	944	197
24131	PHP	200811	74	21	1	0	53	32	15	1	5792	2325	976	3317	967	205
24131	PHP	200812	61	17	0	0	38	21	9	0	5853	2353	993	3357	979	211
24131	PHP	200901	60	15	0	0	41	28	14	0	5913	2387	1008	3396	1000	216
24131	PHP	200902	42	15	0	0	31	15	11	0	5955	2410	1023	3416	1007	218
24131	PHP	200903	67	12	1	0	41	23	9	1	6022	2444	1035	3452	1024	220
24131	PHP	200904	68	9	0	0	40	22	6	0	6090	2477	1044	3490	1040	224
24131	PHP	200905	57	12	0	0	35	15	7	0	6147	2504	1056	3518	1048	226
24131	PHP	200906	48	11	0	0	36	17	6	0	6195	2532	1067	3542	1058	226
24131	PHP	200907	62	10	0	0	39	21	6	0	6257	2563	1077	3581	1071	228
24131	PHP	200908	45	12	0	0	38	18	10	0	6302	2593	1089	3604	1081	228
24131	PHP	200909	35	8	0	0	28	20	7	0	6337	2614	1097	3628	1094	230
24131	PHP	200910	35	8	0	0	25	13	4	0	6372	2635	1105	3647	1103	230
24131	PHP	200911	48	18	0	0	35	18	12	0	6420	2661	1123	3672	1112	235
24131	PHP	200912	45	10	0	0	34	23	7	0	6465	2686	1133	3702	1126	237
24131	PHP	201001	38	7	0	0	28	15	6	0	6503	2707	1140	3724	1134	238
24131	PHP	201002	53	13	0	0	35	21	10	0	6556	2733	1153	3756	1146	241
24131	PHP	201003	47	10	0	0	31	17	9	0	6603	2758	1163	3783	1158	242
24131	PHP	201004	54	14	0	0	41	26	11	0	6657	2789	1177	3820	1175	246
24131	PHP	201005	59	17	1	0	46	26	13	1	6716	2823	1194	3851	1190	251
24131	PHP	201006	57	16	1	0	38	22	14	1	6773	2855	1210	3883	1206	256
24131	PHP	201007	47	12	1	0	37	15	9	1	6820	2887	1222	3907	1218	259
24131	PHP	201008	56	9	1	0	33	21	8	1	6876	2911	1231	3946	1230	264
24131	PHP	201009	50	10	0	0	29	15	9	0	6926	2933	1241	3972	1238	265
24131	PHP	201010	50	9	0	0	30	16	7	0	6976	2956	1250	4004	1247	265
24131	PHP	201011	48	15	0	0	36	22	11	0	7024	2984	1265	4031	1261	269
24131	PHP	201012	36	9	0	0	32	16	9	0	7060	3009	1274	4049	1270	271
24131	PHP	201101	27	5	0	0	17	8	4	0	7087	3020	1279	4065	1272	271
24131	PHP	201102	64	13	0	0	40	20	12	0	7151	3048	1292	4093	1281	271
24131	PHP	201103	25	6	0	0	21	12	6	0	7176	3062	1298	4108	1286	271
24131	PHP	201104	52	12	1	0	34	23	8	1	7228	3084	1310	4147	1297	277
24131	PHP	201105	36	8	0	0	21	11	5	0	7264	3100	1318	4166	1303	279
24131	PHP	201106	38	7	0	0	21	11	3	0	7302	3115	1325	4190	1308	281
24131	PHP	201107	22	3	0	0	16	11	3	0	7324	3126	1328	4203	1314	281
24131	PHP	201108	31	4	0	0	16	9	2	0	7355	3137	1332	4226	1318	283
24131	PHP	201109	42	7	0	0	31	12	6	0	7397	3163	1339	4244	1325	283
24131	PHP	201110	15	5	0	0	14	6	5	0	7412	3172	1344	4251	1327	283
24131	PHP	201111	33	10	0	0	27	16	7	0	7445	3195	1354	4273	1341	288
24131	PHP	201112	30	2	0	0	22	14	1	0	7475	3213	1356	4291	1352	288
24131	PHP	201201	24	6	0	0	20	12	5	0	7499	3225	1362	4305	1357	289
24131	PHP	201202	32	6	0	0	27	13	4	0	7531	3246	1368	4320	1366	289
24131	PHP	201203	30	5	0	0	22	14	5	0	7561	3260	1373	4334	1373	291
24131	PHP	201204	28	3	0	0	22	14	3	0	7589	3277	1376	4349	1382	291
24131	PHP	201205	31	6	0	0	24	11	5	0	7620	3295	1382	4363	1387	292
24131	PHP	201206	23	4	0	0	16	10	3	0	7643	3309	1386	4377	1395	293
24131	PHP	201207	32	3	0	0	27	14	3	0	7675	3329	1389	4394	1403	294
24131	PHP	201208	52	16	2	0	32	17	12	2	7727	3352	1405	4421	1411	299
24131	PHP	201209	24	5	0	0	20	11	5	0	7751	3365	1410	4435	1415	300
24131	PHP	201210	25	5	0	0	21	10	5	0	7776	3383	1415	4445	1422	300
24131	PHP	201211	26	3	0	0	22	14	3	0	7802	3398	1418	4463	1427	301
24131	PHP	201212	24	6	0	0	20	10	5	0	7826	3412	1424	4474	1431	301
24131	PHP	201301	36	6	0	0	27	13	4	0	7862	3435	1430	4490	1441	302
24131	PHP	201302	32	7	0	0	26	14	5	0	7894	3459	1437	4507	1452	302
24131	PHP	201303	31	3	0	0	27	13	3	0	7925	3482	1440	4522	1461	302
24131	PHP	201304	48	7	0	0	35	19	6	0	7973	3508	1447	4554	1471	303
24131	PHP	201305	36	8	0	0	29	19	7	0	8009	3534	1455	4575	1487	303
24131	PHP	201306	23	5	0	0	19	6	3	0	8032	3548	1460	4585	1489	303
24131	PHP	201307	41	8	0	0	29	15	5	0	8073	3573	1468	4607	1500	303
24131	PHP	201308	25	8	0	0	21	9	6	0	8098	3589	1476	4618	1504	303
24131	PHP	201309	47	5	0	0	28	20	5	0	8145	3608	1481	4652	1516	305
24131	PHP	201310	39	6	0	0	19	9	3	0	8184	3621	1487	4676	1519	306
24131	PHP	201311	38	5	0	0	22	12	3	0	8222	3640	1492	4704	1528	308
24131	PHP	201312	38	10	1	0	25	11	6	1	8260	3661	1502	4726	1535	310
24131	PHP	201401	35	7	0	0	21	13	7	0	8295	3677	1509	4753	1543	311
24131	PHP	201402	49	9	0	0	28	12	7	0	8344	3696	1518	4772	1547	311
24131	PHP	201403	65	8	0	0	17	9	3	0	8409	3709	1526	4827	1552	313
24131	PHP	201404	60	8	0	0	28	16	7	0	8469	3732	1534	4871	1564	315
24131	PHP	201405	39	10	0	0	30	15	8	0	8508	3754	1544	4892	1571	315
24131	PHP	201406	62	9	0	0	26	18	6	0	8570	3774	1553	4944	1583	320
24131	PHP	201407	49	8	0	0	22	12	6	0	8619	3787	1561	4973	1587	321
24131	PHP	201408	91	5	0	0	19	17	4	0	8710	3797	1566	5062	1596	325
24131	PHP	201409	66	9	0	0	32	16	6	0	8776	3819	1575	5104	1603	326
24131	PHP	201410	22	3	0	0	15	13	3	0	8798	3826	1578	5124	1609	328
24131	PHP	201411	24	4	0	0	16	10	4	0	8822	3836	1582	5140	1612	328
24131	PHP	201412	19	4	0	0	11	7	2	0	8841	3844	1586	5152	1616	329
24131	PHP	201501	61	14	3	2	14	6	3	2	8902	3854	1600	5202	1618	334
24131	PHP	201502	50	9	1	1	15	8	5	1	8952	3864	1609	5240	1621	336
24131	PHP	201503	47	21	1	0	30	19	13	1	8999	3887	1630	5273	1631	349
24131	PHP	201504	31	5	0	0	21	9	5	0	9030	3903	1635	5291	1635	349
24131	PHP	201505	45	7	0	0	26	17	5	0	9075	3920	1642	5325	1643	351
24131	PHP	201506	36	4	0	0	14	8	2	0	9111	3929	1646	5354	1646	352
24131	PHP	201507	18	6	1	0	15	8	4	1	9129	3942	1652	5364	1652	353
24131	PHP	201508	23	4	0	0	17	14	4	0	9152	3954	1656	5384	1661	356
24131	PHP	201509	28	5	0	0	20	16	4	0	9180	3968	1661	5405	1669	358
24131	PHP	201510	33	5	0	0	22	14	3	0	9213	3981	1666	5421	1675	358
24131	PHP	201511	10	2	0	0	8	5	2	0	9223	3985	1668	5428	1677	358
24131	PHP	201512	60	4	2	1	20	12	3	2	9283	3999	1672	5478	1683	361
24131	PHP	201601	61	16	4	1	42	25	10	3	9344	4028	1688	5518	1695	368
24131	PHP	201602	39	5	1	0	21	15	5	1	9383	4040	1693	5542	1703	373
24131	PHP	201603	24	5	0	0	17	11	4	0	9407	4053	1698	5556	1711	373
24131	PHP	201604	13	2	0	0	10	7	2	0	9420	4060	1700	5563	1715	374
24131	PHP	201605	15	3	0	0	11	7	2	0	9435	4067	1703	5573	1719	376
24131	PHP	201606	40	13	1	0	25	14	8	1	9475	4085	1716	5599	1727	381
24131	PHP	201607	21	5	0	0	17	11	3	0	9496	4096	1721	5613	1733	382
24131	PHP	201608	23	6	1	0	14	7	4	1	9519	4106	1727	5629	1737	386
24131	PHP	201609	28	4	0	0	23	11	4	0	9547	4125	1731	5641	1744	388
24131	PHP	201610	12	2	0	0	11	6	2	0	9559	4132	1733	5648	1747	388
24131	PHP	201611	42	10	0	0	23	12	6	0	9601	4148	1743	5664	1752	390
24131	PHP	201612	13	2	0	0	11	8	2	0	9614	4155	1745	5674	1756	390
24131	PHP	201701	22	4	0	0	14	10	4	0	9636	4164	1749	5692	1760	391
24131	PHP	201702	18	3	0	0	14	10	3	0	9654	4170	1752	5705	1760	392
24131	PHP	201703	28	8	0	0	22	16	6	0	9682	4184	1760	5727	1768	397
24131	PHP	201704	22	8	0	0	19	12	7	0	9704	4197	1768	5741	1775	399
24131	PHP	201705	20	7	0	0	17	10	6	0	9724	4207	1775	5754	1778	401
24131	PHP	201706	7	0	0	0	5	2	0	0	9731	4211	1775	5757	1780	401
24131	PHP	201707	11	3	0	0	11	5	3	0	9742	4222	1778	5762	1785	402
24131	PHP	201708	22	9	0	0	18	13	9	0	9764	4234	1787	5776	1791	406
24131	PHP	201709	14	4	0	0	11	6	3	0	9778	4242	1791	5784	1795	408
24131	PHP	201710	7	2	0	0	7	3	2	0	9785	4247	1793	5787	1797	408
24131	PHP	201711	19	5	2	1	13	7	3	2	9804	4258	1798	5798	1802	411
24131	PHP	201712	34	6	0	0	24	15	5	0	9838	4275	1804	5817	1811	412
24131	PHP	201801	26	2	0	0	19	15	2	0	9864	4291	1806	5838	1822	412
24131	PHP	201802	23	1	0	0	18	9	1	0	9887	4305	1807	5849	1825	412
24131	PHP	201803	10	1	0	0	10	6	1	0	9897	4314	1808	5855	1829	412
24131	PHP	201804	17	4	0	0	15	8	4	0	9914	4327	1812	5863	1834	414
24131	PHP	201805	26	5	0	0	22	15	5	0	9940	4343	1817	5880	1843	417
24131	PHP	201806	19	4	0	0	14	11	4	0	9959	4353	1821	5896	1848	421
24131	PHP	201807	26	4	0	0	20	12	4	0	9985	4368	1825	5912	1855	422
616418	PKCS	200405	5	0	0	0	2	2	0	0	5	2	0	5	2	0
616418	PKCS	200406	3	0	0	0	1	1	0	0	8	2	0	8	2	0
616418	PKCS	200410	1	0	0	0	1	1	0	0	9	3	0	9	3	0
616418	PKCS	200411	8	0	0	0	3	2	0	0	17	6	0	16	5	0
616418	PKCS	200412	7	1	0	0	4	3	1	0	24	9	1	22	7	0
616418	PKCS	200503	2	0	0	0	2	2	0	0	26	10	1	24	8	0
616418	PKCS	200508	2	0	0	0	1	1	0	0	28	10	1	26	8	0
616418	PKCS	200509	2	0	0	0	2	2	0	0	30	12	1	28	10	0
616418	PKCS	200510	3	0	0	0	2	2	0	0	33	13	1	31	11	0
616418	PKCS	200512	3	0	0	0	2	1	0	0	36	15	1	32	12	0
616418	PKCS	200602	6	0	0	0	6	4	0	0	42	21	1	36	16	0
616418	PKCS	200603	1	0	0	0	1	1	0	0	43	22	1	37	17	0
616418	PKCS	200606	2	0	0	0	2	1	0	0	45	24	1	38	18	0
616418	PKCS	200607	2	0	0	0	2	2	0	0	47	26	1	40	20	0
616418	PKCS	200608	2	1	0	0	2	0	1	0	49	28	2	40	20	0
616418	PKCS	200609	1	0	0	0	1	0	0	0	50	29	2	40	20	0
616418	PKCS	200610	1	0	0	0	1	0	0	0	51	30	2	40	20	0
616418	PKCS	200611	1	0	0	0	1	0	0	0	52	31	2	40	20	0
616418	PKCS	200612	1	0	0	0	1	0	0	0	53	32	2	40	20	0
616418	PKCS	200701	8	3	0	0	7	4	2	0	61	39	5	45	24	1
616418	PKCS	200702	3	0	0	0	2	2	0	0	64	41	5	48	26	1
616418	PKCS	200704	1	0	0	0	1	1	0	0	65	42	5	49	27	1
616418	PKCS	200705	1	0	0	0	1	1	0	0	66	42	5	50	27	1
616418	PKCS	200706	2	0	0	0	1	1	0	0	68	43	5	52	28	1
616418	PKCS	200707	2	0	0	0	2	1	0	0	70	45	5	53	29	1
616418	PKCS	200710	1	0	0	0	1	1	0	0	71	46	5	54	30	1
616418	PKCS	200711	3	0	0	0	2	2	0	0	74	48	5	57	32	1
616418	PKCS	200801	1	0	0	0	1	1	0	0	75	49	5	58	33	1
616418	PKCS	200802	1	0	0	0	1	0	0	0	76	50	5	58	33	1
616418	PKCS	200803	2	0	0	0	2	2	0	0	78	52	5	60	35	1
616418	PKCS	200804	2	0	0	0	2	2	0	0	80	54	5	62	37	1
616418	PKCS	200805	1	0	0	0	1	1	0	0	81	55	5	63	38	1
616418	PKCS	200806	2	0	0	0	2	1	0	0	83	57	5	64	39	1
616418	PKCS	200807	1	0	0	0	1	1	0	0	84	58	5	65	40	1
616418	PKCS	200808	1	0	0	0	1	1	0	0	85	59	5	66	41	1
616418	PKCS	200809	6	1	0	0	4	2	1	0	91	63	6	70	43	1
616418	PKCS	200811	1	0	0	0	1	0	0	0	92	64	6	70	43	1
616418	PKCS	200901	2	1	0	0	2	2	1	0	94	66	7	72	45	2
616418	PKCS	200902	2	0	0	0	2	1	0	0	96	68	7	73	46	2
616418	PKCS	200903	2	0	0	0	2	1	0	0	98	70	7	74	47	2
616418	PKCS	200907	1	0	0	0	1	1	0	0	99	71	7	75	48	2
616418	PKCS	200908	1	0	0	0	1	0	0	0	100	72	7	75	48	2
616418	PKCS	200909	2	0	0	0	1	0	0	0	102	73	7	75	48	2
616418	PKCS	200911	2	0	0	0	2	2	0	0	104	75	7	77	50	2
616418	PKCS	200912	3	0	0	0	2	1	0	0	107	76	7	79	50	2
616418	PKCS	201001	1	0	0	0	1	0	0	0	108	77	7	79	50	2
616418	PKCS	201002	2	0	0	0	1	1	0	0	110	78	7	81	51	2
616418	PKCS	201003	1	0	0	0	1	0	0	0	111	79	7	81	51	2
616418	PKCS	201005	1	0	0	0	1	1	0	0	112	80	7	82	52	2
616418	PKCS	201006	2	0	0	0	2	1	0	0	114	82	7	83	53	2
616418	PKCS	201011	2	0	0	0	2	2	0	0	116	83	7	85	54	2
616418	PKCS	201012	1	0	0	0	1	1	0	0	117	84	7	86	55	2
616418	PKCS	201102	1	0	0	0	1	0	0	0	118	85	7	86	55	2
616418	PKCS	201103	2	0	0	0	2	1	0	0	120	87	7	87	56	2
616418	PKCS	201104	2	0	0	0	2	0	0	0	122	89	7	87	56	2
616418	PKCS	201107	8	0	0	0	3	1	0	0	130	92	7	88	57	2
616418	PKCS	201111	4	0	0	0	3	2	0	0	134	94	7	90	58	2
616418	PKCS	201202	1	0	0	0	1	1	0	0	135	95	7	91	59	2
616418	PKCS	201203	1	0	0	0	1	0	0	0	136	96	7	91	59	2
616418	PKCS	201205	1	0	0	0	1	1	0	0	137	96	7	92	59	2
616418	PKCS	201210	2	0	0	0	2	1	0	0	139	98	7	93	60	2
616418	PKCS	201211	2	0	0	0	2	2	0	0	141	100	7	95	62	2
616418	PKCS	201301	1	0	0	0	1	0	0	0	142	101	7	95	62	2
616418	PKCS	201302	1	0	0	0	1	0	0	0	143	102	7	95	62	2
616418	PKCS	201303	1	0	0	0	1	1	0	0	144	103	7	96	63	2
616418	PKCS	201308	2	0	0	0	2	2	0	0	146	105	7	98	65	2
616418	PKCS	201309	1	0	0	0	1	0	0	0	147	106	7	98	65	2
616418	PKCS	201310	1	0	0	0	1	1	0	0	148	107	7	99	66	2
616418	PKCS	201401	1	0	0	0	1	1	0	0	149	108	7	100	67	2
616418	PKCS	201403	2	0	0	0	2	2	0	0	151	110	7	102	69	2
616418	PKCS	201404	2	0	0	0	1	1	0	0	153	111	7	104	70	2
616418	PKCS	201406	1	0	0	0	1	1	0	0	154	112	7	105	71	2
616418	PKCS	201410	1	0	0	0	1	1	0	0	155	113	7	106	72	2
616418	PKCS	201412	3	0	0	0	3	3	0	0	158	115	7	109	74	2
616418	PKCS	201501	4	0	0	0	3	0	0	0	162	118	7	109	74	2
616418	PKCS	201502	2	0	0	0	2	2	0	0	164	119	7	111	75	2
616418	PKCS	201505	18	1	0	0	2	2	1	0	182	121	8	129	77	3
616418	PKCS	201602	1	0	0	0	1	1	0	0	183	122	8	130	78	3
616418	PKCS	201604	2	0	0	0	2	1	0	0	185	124	8	131	79	3
616418	PKCS	201606	2	0	0	0	2	2	0	0	187	126	8	133	81	3
616418	PKCS	201608	1	0	0	0	1	1	0	0	188	127	8	134	82	3
616418	PKCS	201609	1	0	0	0	1	1	0	0	189	128	8	135	83	3
616418	PKCS	201612	1	0	0	0	1	1	0	0	190	129	8	136	84	3
616418	PKCS	201702	1	0	0	0	1	1	0	0	191	130	8	137	85	3
616418	PKCS	201706	3	1	0	0	3	1	1	0	194	132	9	138	85	3
616418	PKCS	201709	1	0	0	0	1	1	0	0	195	133	9	139	86	3
616418	PKCS	201710	1	0	0	0	1	1	0	0	196	134	9	140	87	3
616418	PKCS	201803	1	0	0	0	1	1	0	0	197	135	9	141	88	3
616418	PKCS	201804	3	0	0	0	3	3	0	0	200	138	9	144	91	3
47017	Package_manager	200209	1	0	0	0	1	0	0	0	1	1	0	0	0	0
47017	Package_manager	200210	1	0	0	0	1	1	0	0	2	2	0	1	1	0
47017	Package_manager	200212	1	0	0	0	1	1	0	0	3	3	0	2	2	0
47017	Package_manager	200302	2	0	0	0	2	2	0	0	5	5	0	4	4	0
47017	Package_manager	200304	2	0	0	0	2	0	0	0	7	7	0	4	4	0
47017	Package_manager	200308	1	0	0	0	1	1	0	0	8	8	0	5	5	0
47017	Package_manager	200309	3	0	0	0	2	2	0	0	11	10	0	8	7	0
47017	Package_manager	200310	2	0	0	0	2	1	0	0	13	12	0	9	8	0
47017	Package_manager	200311	2	0	0	0	2	1	0	0	15	14	0	10	9	0
47017	Package_manager	200402	2	0	0	0	2	1	0	0	17	16	0	11	10	0
47017	Package_manager	200404	2	0	0	0	1	0	0	0	19	17	0	11	10	0
47017	Package_manager	200406	1	0	0	0	1	0	0	0	20	18	0	11	10	0
47017	Package_manager	200408	1	0	0	0	1	1	0	0	21	19	0	12	11	0
47017	Package_manager	200410	1	0	0	0	1	0	0	0	22	20	0	12	11	0
47017	Package_manager	200411	1	0	0	0	1	1	0	0	23	21	0	13	12	0
47017	Package_manager	200412	1	0	0	0	1	0	0	0	24	22	0	13	12	0
47017	Package_manager	200502	3	0	0	0	3	1	0	0	27	25	0	14	13	0
47017	Package_manager	200503	3	0	0	0	3	3	0	0	30	27	0	17	15	0
47017	Package_manager	200504	1	0	0	0	1	1	0	0	31	28	0	18	16	0
47017	Package_manager	200505	3	0	0	0	3	2	0	0	34	31	0	20	18	0
47017	Package_manager	200506	7	0	0	0	3	3	0	0	41	33	0	27	20	0
47017	Package_manager	200507	2	0	0	0	2	1	0	0	43	35	0	28	21	0
47017	Package_manager	200508	5	0	0	0	4	3	0	0	48	39	0	32	24	0
47017	Package_manager	200509	3	0	0	0	1	0	0	0	51	40	0	32	24	0
47017	Package_manager	200510	1	0	0	0	1	1	0	0	52	41	0	33	25	0
47017	Package_manager	200511	4	0	0	0	4	2	0	0	56	45	0	35	27	0
47017	Package_manager	200512	5	0	0	0	5	1	0	0	61	50	0	36	28	0
47017	Package_manager	200601	5	0	0	0	3	2	0	0	66	53	0	38	30	0
47017	Package_manager	200602	6	0	0	0	4	3	0	0	72	56	0	43	32	0
47017	Package_manager	200603	1	0	0	0	1	1	0	0	73	57	0	44	33	0
47017	Package_manager	200604	8	1	0	0	6	4	1	0	81	62	1	49	36	0
47017	Package_manager	200605	7	0	0	0	7	4	0	0	88	68	1	53	39	0
47017	Package_manager	200606	19	0	0	0	3	2	0	0	107	70	1	71	40	0
47017	Package_manager	200607	12	0	0	0	3	2	0	0	119	72	1	82	41	0
47017	Package_manager	200608	9	0	0	0	1	1	0	0	128	72	1	91	41	0
47017	Package_manager	200610	4	0	0	0	4	4	0	0	132	76	1	95	45	0
47017	Package_manager	200611	2	0	0	0	2	2	0	0	134	77	1	97	46	0
47017	Package_manager	200612	1	0	0	0	1	0	0	0	135	78	1	97	46	0
47017	Package_manager	200701	1	0	0	0	1	1	0	0	136	79	1	98	47	0
47017	Package_manager	200702	6	0	0	0	6	3	0	0	142	83	1	101	48	0
47017	Package_manager	200703	4	1	0	0	4	1	1	0	146	87	2	102	49	0
47017	Package_manager	200704	6	0	0	0	5	3	0	0	152	92	2	106	52	0
47017	Package_manager	200705	13	0	0	0	7	7	0	0	165	96	2	119	56	0
47017	Package_manager	200706	3	0	0	0	3	2	0	0	168	99	2	121	58	0
47017	Package_manager	200707	2	0	0	0	1	1	0	0	170	100	2	123	59	0
47017	Package_manager	200708	10	0	0	0	8	4	0	0	180	106	2	129	61	0
47017	Package_manager	200709	1	0	0	0	1	1	0	0	181	107	2	130	62	0
47017	Package_manager	200710	7	0	0	0	6	3	0	0	188	113	2	133	65	0
47017	Package_manager	200711	8	0	0	0	4	1	0	0	196	117	2	134	66	0
47017	Package_manager	200712	7	0	0	0	5	3	0	0	203	122	2	139	69	0
47017	Package_manager	200801	19	0	0	0	10	5	0	0	222	130	2	153	73	0
47017	Package_manager	200802	7	0	0	0	6	3	0	0	229	135	2	157	75	0
47017	Package_manager	200803	6	0	0	0	5	3	0	0	235	140	2	161	78	0
47017	Package_manager	200804	15	1	0	0	5	4	1	0	250	144	3	175	81	0
47017	Package_manager	200805	4	0	0	0	3	2	0	0	254	146	3	177	82	0
47017	Package_manager	200806	11	0	0	0	6	3	0	0	265	151	3	184	84	0
47017	Package_manager	200807	5	0	0	0	5	3	0	0	270	156	3	187	87	0
47017	Package_manager	200808	5	1	0	0	5	4	1	0	275	161	4	191	91	1
47017	Package_manager	200809	4	0	0	0	3	2	0	0	279	163	4	194	92	1
47017	Package_manager	200810	3	0	0	0	2	1	0	0	282	165	4	196	93	1
47017	Package_manager	200811	9	0	0	0	8	2	0	0	291	172	4	198	95	1
47017	Package_manager	200812	10	0	0	0	7	5	0	0	301	177	4	206	98	1
47017	Package_manager	200901	6	0	0	0	4	2	0	0	307	181	4	209	100	1
47017	Package_manager	200902	6	0	0	0	5	4	0	0	313	185	4	214	103	1
47017	Package_manager	200904	8	1	0	0	5	5	1	0	321	187	5	222	105	2
47017	Package_manager	200905	9	0	0	0	6	4	0	0	330	193	5	229	109	2
47017	Package_manager	200906	6	0	0	0	5	2	0	0	336	197	5	232	110	2
47017	Package_manager	200907	9	0	0	0	5	2	0	0	345	201	5	238	111	2
47017	Package_manager	200908	5	0	0	0	5	4	0	0	350	206	5	242	115	2
47017	Package_manager	200909	8	1	0	0	4	3	1	0	358	209	6	249	117	2
47017	Package_manager	200910	14	0	0	0	10	6	0	0	372	218	6	257	122	2
47017	Package_manager	200911	5	0	0	0	4	1	0	0	377	221	6	258	122	2
47017	Package_manager	200912	2	0	0	0	1	0	0	0	379	222	6	258	122	2
47017	Package_manager	201001	4	0	0	0	3	2	0	0	383	224	6	261	123	2
47017	Package_manager	201002	6	1	0	0	5	5	1	0	389	227	7	267	126	3
47017	Package_manager	201003	3	0	0	0	3	0	0	0	392	230	7	267	126	3
47017	Package_manager	201004	11	0	0	0	8	6	0	0	403	237	7	275	131	3
47017	Package_manager	201005	8	0	0	0	5	4	0	0	411	241	7	282	134	3
47017	Package_manager	201006	6	0	0	0	3	1	0	0	417	244	7	283	135	3
47017	Package_manager	201007	7	0	0	0	2	1	0	0	424	244	7	284	135	3
47017	Package_manager	201008	12	0	0	0	8	4	0	0	436	249	7	290	136	3
47017	Package_manager	201009	16	1	0	0	12	9	1	0	452	259	8	303	143	4
47017	Package_manager	201010	11	0	0	0	4	4	0	0	463	261	8	314	145	4
47017	Package_manager	201012	5	2	0	0	3	1	1	0	468	263	10	316	145	4
47017	Package_manager	201101	1	0	0	0	1	0	0	0	469	264	10	316	145	4
47017	Package_manager	201102	4	1	0	0	4	2	1	0	473	268	11	318	147	4
47017	Package_manager	201103	1	0	0	0	1	1	0	0	474	269	11	319	148	4
47017	Package_manager	201107	2	0	0	0	2	2	0	0	476	271	11	321	150	4
47017	Package_manager	201109	4	0	0	0	2	2	0	0	480	272	11	325	151	4
47017	Package_manager	201110	1	0	0	0	1	1	0	0	481	273	11	326	152	4
47017	Package_manager	201111	1	0	0	0	1	0	0	0	482	274	11	326	152	4
47017	Package_manager	201112	5	0	0	0	2	2	0	0	487	276	11	331	154	4
47017	Package_manager	201201	3	1	0	0	3	2	1	0	490	279	12	333	156	4
47017	Package_manager	201202	8	0	0	0	4	4	0	0	498	280	12	341	157	4
47017	Package_manager	201203	1	0	0	0	1	0	0	0	499	281	12	341	157	4
47017	Package_manager	201204	1	0	0	0	1	1	0	0	500	282	12	342	158	4
47017	Package_manager	201206	1	0	0	0	1	1	0	0	501	283	12	343	159	4
47017	Package_manager	201207	4	0	0	0	1	1	0	0	505	284	12	347	160	4
47017	Package_manager	201209	1	0	0	0	1	0	0	0	506	285	12	347	160	4
47017	Package_manager	201211	1	0	0	0	1	0	0	0	507	286	12	347	160	4
47017	Package_manager	201212	2	0	0	0	2	2	0	0	509	288	12	349	162	4
47017	Package_manager	201302	3	1	0	0	3	2	1	0	512	291	13	351	164	4
47017	Package_manager	201304	2	0	0	0	2	2	0	0	514	293	13	353	166	4
47017	Package_manager	201305	2	0	0	0	2	2	0	0	516	295	13	355	167	4
47017	Package_manager	201307	1	0	0	0	1	1	0	0	517	296	13	356	168	4
47017	Package_manager	201308	1	0	0	0	1	1	0	0	518	297	13	357	169	4
47017	Package_manager	201310	2	0	0	0	1	1	0	0	520	298	13	359	170	4
47017	Package_manager	201311	11	0	0	0	5	1	0	0	531	303	13	360	171	4
47017	Package_manager	201312	2	0	0	0	1	0	0	0	533	303	13	360	171	4
47017	Package_manager	201401	1	0	0	0	1	1	0	0	534	304	13	361	172	4
47017	Package_manager	201402	1	0	0	0	1	1	0	0	535	305	13	362	173	4
47017	Package_manager	201404	1	0	0	0	1	1	0	0	536	306	13	363	174	4
47017	Package_manager	201405	4	0	0	0	3	3	0	0	540	308	13	367	176	4
47017	Package_manager	201410	1	0	0	0	1	1	0	0	541	308	13	368	176	4
47017	Package_manager	201412	6	0	0	0	4	4	0	0	547	310	13	374	178	4
47017	Package_manager	201501	2	0	0	0	2	2	0	0	549	311	13	376	179	4
47017	Package_manager	201503	2	1	0	0	2	1	1	0	551	312	14	377	179	4
47017	Package_manager	201505	3	1	0	0	2	2	1	0	554	313	15	380	180	5
47017	Package_manager	201506	11	0	0	0	3	3	0	0	565	315	15	391	182	5
47017	Package_manager	201508	2	0	0	0	2	2	0	0	567	316	15	393	183	5
47017	Package_manager	201510	3	0	0	0	2	2	0	0	570	316	15	396	183	5
47017	Package_manager	201511	1	0	0	0	1	1	0	0	571	317	15	397	184	5
47017	Package_manager	201512	5	0	0	0	1	1	0	0	576	318	15	402	185	5
47017	Package_manager	201602	4	1	0	0	3	1	1	0	580	321	16	403	186	5
47017	Package_manager	201603	6	0	0	0	5	4	0	0	586	323	16	407	187	5
47017	Package_manager	201605	1	0	0	0	1	1	0	0	587	323	16	408	187	5
47017	Package_manager	201606	3	0	0	0	3	2	0	0	590	325	16	410	188	5
47017	Package_manager	201608	3	0	0	0	3	2	0	0	593	326	16	412	188	5
47017	Package_manager	201609	4	0	0	0	3	1	0	0	597	328	16	413	188	5
47017	Package_manager	201610	2	0	0	0	2	2	0	0	599	329	16	415	189	5
47017	Package_manager	201611	3	1	0	0	3	2	1	0	602	332	17	417	191	5
47017	Package_manager	201701	23	1	0	0	7	5	1	0	625	337	18	435	194	6
47017	Package_manager	201702	2	0	0	0	2	1	0	0	627	339	18	436	195	6
47017	Package_manager	201703	9	3	0	0	7	3	2	0	636	345	21	441	197	6
47017	Package_manager	201704	2	0	0	0	2	0	0	0	638	347	21	441	197	6
47017	Package_manager	201705	2	1	0	0	2	1	1	0	640	348	22	442	197	6
47017	Package_manager	201706	2	0	0	0	2	2	0	0	642	350	22	444	199	6
47017	Package_manager	201707	14	4	0	0	3	2	2	0	656	353	26	448	201	6
47017	Package_manager	201708	3	1	0	0	3	0	1	0	659	356	27	448	201	6
47017	Package_manager	201709	3	0	0	0	2	1	0	0	662	358	27	449	202	6
47017	Package_manager	201710	5	1	0	0	5	5	1	0	667	363	28	454	206	7
47017	Package_manager	201711	1	0	0	0	1	0	0	0	668	364	28	454	206	7
47017	Package_manager	201712	3	1	0	0	3	2	1	0	671	366	29	456	207	7
47017	Package_manager	201801	2	0	0	0	2	1	0	0	673	367	29	457	207	7
47017	Package_manager	201803	1	0	0	0	1	1	0	0	674	367	29	458	207	7
47017	Package_manager	201805	5	0	0	0	3	3	0	0	679	370	29	463	210	7
47017	Package_manager	201806	2	0	0	0	2	2	0	0	681	372	29	465	212	7
47017	Package_manager	201807	3	1	0	0	3	2	1	0	684	375	30	467	214	7
24107	Peer-to-peer	200111	1	0	0	0	1	1	0	0	1	1	0	1	1	0
24107	Peer-to-peer	200202	1	0	0	0	1	1	0	0	2	2	0	2	2	0
24107	Peer-to-peer	200203	1	0	0	0	1	1	0	0	3	3	0	3	3	0
24107	Peer-to-peer	200208	2	0	0	0	2	1	0	0	5	5	0	4	4	0
24107	Peer-to-peer	200209	3	0	0	0	3	1	0	0	8	8	0	5	5	0
24107	Peer-to-peer	200210	3	0	0	0	3	2	0	0	11	11	0	7	7	0
24107	Peer-to-peer	200212	1	0	0	0	1	1	0	0	12	12	0	8	8	0
24107	Peer-to-peer	200301	1	0	0	0	1	1	0	0	13	13	0	9	9	0
24107	Peer-to-peer	200302	3	0	0	0	3	3	0	0	16	16	0	12	12	0
24107	Peer-to-peer	200303	13	0	0	0	5	3	0	0	29	20	0	23	14	0
24107	Peer-to-peer	200304	7	0	0	0	6	5	0	0	36	24	0	28	17	0
24107	Peer-to-peer	200305	2	0	0	0	2	2	0	0	38	25	0	30	18	0
24107	Peer-to-peer	200306	3	0	0	0	3	3	0	0	41	28	0	33	21	0
24107	Peer-to-peer	200307	12	0	0	0	8	5	0	0	53	33	0	41	23	0
24107	Peer-to-peer	200308	3	0	0	0	3	2	0	0	56	36	0	43	25	0
24107	Peer-to-peer	200309	8	0	0	0	5	4	0	0	64	40	0	50	28	0
24107	Peer-to-peer	200310	7	0	0	0	3	2	0	0	71	43	0	55	30	0
24107	Peer-to-peer	200311	6	0	0	0	6	6	0	0	77	46	0	61	33	0
24107	Peer-to-peer	200312	6	0	0	0	6	3	0	0	83	51	0	64	35	0
24107	Peer-to-peer	200401	5	0	0	0	4	2	0	0	88	55	0	67	37	0
24107	Peer-to-peer	200402	4	1	0	0	4	1	1	0	92	59	1	68	38	0
24107	Peer-to-peer	200403	3	1	0	0	2	2	1	0	95	61	2	71	40	1
24107	Peer-to-peer	200404	17	1	0	0	13	6	1	0	112	74	3	80	46	1
24107	Peer-to-peer	200405	14	0	0	0	8	4	0	0	126	82	3	87	50	1
24107	Peer-to-peer	200406	11	0	0	0	10	8	0	0	137	90	3	96	56	1
24107	Peer-to-peer	200407	10	1	0	0	8	5	1	0	147	98	4	101	61	2
24107	Peer-to-peer	200408	41	2	0	0	21	10	2	0	188	118	6	126	70	3
24107	Peer-to-peer	200409	18	0	0	0	16	8	0	0	206	133	6	134	77	3
24107	Peer-to-peer	200410	21	2	0	0	16	8	2	0	227	149	8	146	85	3
24107	Peer-to-peer	200411	23	1	0	0	20	8	1	0	250	167	9	155	91	3
24107	Peer-to-peer	200412	54	4	0	0	31	13	4	0	304	196	13	173	102	3
24107	Peer-to-peer	200501	30	1	0	0	20	12	1	0	334	215	14	192	113	3
24107	Peer-to-peer	200502	26	3	0	0	21	6	3	0	360	235	17	198	118	3
24107	Peer-to-peer	200503	19	1	0	0	15	8	1	0	379	248	18	209	124	3
24107	Peer-to-peer	200504	51	3	0	0	39	16	3	0	430	284	21	230	138	4
24107	Peer-to-peer	200505	62	8	0	0	37	15	7	0	492	318	29	255	150	4
24107	Peer-to-peer	200506	60	7	0	0	43	17	7	0	552	353	36	284	161	5
24107	Peer-to-peer	200507	30	3	0	0	19	8	3	0	582	366	39	295	164	5
24107	Peer-to-peer	200508	40	2	0	0	31	14	2	0	622	395	41	312	177	5
24107	Peer-to-peer	200509	29	3	0	0	26	14	3	0	651	418	44	327	188	5
24107	Peer-to-peer	200510	43	9	0	0	33	15	8	0	694	449	53	347	201	7
24107	Peer-to-peer	200511	47	5	0	0	31	11	4	0	741	474	58	365	207	7
24107	Peer-to-peer	200512	59	14	0	0	40	17	7	0	800	510	72	394	221	9
24107	Peer-to-peer	200601	68	15	0	0	39	17	9	0	868	543	87	432	233	11
24107	Peer-to-peer	200602	76	17	0	0	39	19	8	0	944	578	104	482	248	18
24107	Peer-to-peer	200603	42	8	0	0	27	15	6	0	986	600	112	507	259	20
24107	Peer-to-peer	200604	63	13	0	0	35	18	9	0	1049	630	125	545	272	24
24107	Peer-to-peer	200605	45	9	0	0	27	12	5	0	1094	653	134	569	280	27
24107	Peer-to-peer	200606	63	13	0	0	33	16	5	0	1157	678	147	607	289	30
24107	Peer-to-peer	200607	44	9	0	0	24	9	4	0	1201	698	156	626	294	32
24107	Peer-to-peer	200608	22	2	0	0	16	7	2	0	1223	710	158	636	298	32
24107	Peer-to-peer	200609	28	6	0	0	22	12	4	0	1251	730	164	651	308	33
24107	Peer-to-peer	200610	79	14	0	0	48	18	6	0	1330	774	178	683	323	34
24107	Peer-to-peer	200611	114	34	1	0	59	23	19	1	1444	825	212	733	339	38
24107	Peer-to-peer	200612	28	7	0	0	21	11	6	0	1472	841	219	747	345	38
24107	Peer-to-peer	200701	42	8	0	0	29	16	7	0	1514	866	227	771	357	39
24107	Peer-to-peer	200702	65	9	0	0	34	12	7	0	1579	896	236	795	365	39
24107	Peer-to-peer	200703	67	10	0	0	39	24	7	0	1646	926	246	828	381	40
24107	Peer-to-peer	200704	64	14	0	0	38	21	11	0	1710	959	260	866	397	41
24107	Peer-to-peer	200705	49	8	0	0	39	17	8	0	1759	992	268	888	408	42
24107	Peer-to-peer	200706	29	4	0	0	22	11	4	0	1788	1012	272	902	417	42
24107	Peer-to-peer	200707	14	3	0	0	10	7	3	0	1802	1019	275	910	421	43
24107	Peer-to-peer	200708	43	7	1	0	25	13	5	1	1845	1042	282	930	432	46
24107	Peer-to-peer	200709	34	3	0	0	23	15	3	0	1879	1061	285	953	443	46
24107	Peer-to-peer	200710	68	21	3	2	32	19	11	2	1947	1086	306	986	455	49
24107	Peer-to-peer	200711	43	4	1	1	23	14	4	1	1990	1101	310	1018	462	50
24107	Peer-to-peer	200712	16	2	0	0	12	6	2	0	2006	1111	312	1026	466	50
24107	Peer-to-peer	200801	29	5	0	0	23	8	5	0	2035	1131	317	1037	471	50
24107	Peer-to-peer	200802	24	7	0	0	19	9	5	0	2059	1146	324	1046	477	51
24107	Peer-to-peer	200803	31	8	0	0	22	12	8	0	2090	1162	332	1059	483	52
24107	Peer-to-peer	200804	52	11	0	0	29	16	9	0	2142	1187	343	1077	496	53
24107	Peer-to-peer	200805	61	18	1	0	32	11	13	1	2203	1212	361	1093	501	56
24107	Peer-to-peer	200806	33	7	0	0	29	14	7	0	2236	1236	368	1109	511	56
24107	Peer-to-peer	200807	32	10	0	0	23	12	7	0	2268	1255	378	1124	520	57
24107	Peer-to-peer	200808	28	6	0	0	17	8	4	0	2296	1269	384	1136	525	57
24107	Peer-to-peer	200809	40	7	0	0	22	8	3	0	2336	1288	391	1153	531	58
24107	Peer-to-peer	200810	55	17	2	1	30	13	11	2	2391	1312	408	1173	539	60
24107	Peer-to-peer	200811	29	13	2	1	23	11	10	2	2420	1332	421	1186	549	63
24107	Peer-to-peer	200812	17	4	0	0	13	6	4	0	2437	1342	425	1194	552	64
24107	Peer-to-peer	200901	36	11	5	4	18	8	5	2	2473	1356	436	1218	556	71
24107	Peer-to-peer	200902	36	10	0	0	21	7	6	0	2509	1374	446	1237	560	73
24107	Peer-to-peer	200903	35	9	0	0	25	13	8	0	2544	1395	455	1257	569	74
24107	Peer-to-peer	200904	35	11	0	0	23	13	6	0	2579	1412	466	1276	576	77
24107	Peer-to-peer	200905	26	11	3	2	17	7	8	2	2605	1427	477	1286	581	78
24107	Peer-to-peer	200906	38	6	0	0	21	15	5	0	2643	1443	483	1314	591	81
24107	Peer-to-peer	200907	86	12	4	2	27	19	8	3	2729	1463	495	1391	603	88
24107	Peer-to-peer	200908	78	8	1	0	17	15	5	1	2807	1474	503	1462	612	93
24107	Peer-to-peer	200909	23	8	0	0	13	8	5	0	2830	1485	511	1473	618	93
24107	Peer-to-peer	200910	20	4	0	0	16	10	4	0	2850	1497	515	1486	624	93
24107	Peer-to-peer	200911	28	11	0	0	22	13	10	0	2878	1513	526	1501	631	95
24107	Peer-to-peer	200912	14	5	0	0	11	4	3	0	2892	1521	531	1507	632	95
24107	Peer-to-peer	201001	14	4	0	0	10	5	2	0	2906	1529	535	1514	635	96
24107	Peer-to-peer	201002	6	1	0	0	4	1	1	0	2912	1533	536	1515	636	96
24107	Peer-to-peer	201003	17	5	0	0	16	10	5	0	2929	1547	541	1526	644	96
24107	Peer-to-peer	201004	11	4	0	0	10	5	4	0	2940	1552	545	1531	645	96
24107	Peer-to-peer	201005	10	2	0	0	8	5	2	0	2950	1557	547	1537	647	96
24107	Peer-to-peer	201006	18	4	0	0	14	8	3	0	2968	1567	551	1548	651	96
24107	Peer-to-peer	201007	14	2	0	0	8	4	2	0	2982	1574	553	1552	654	96
24107	Peer-to-peer	201008	10	2	0	0	9	4	2	0	2992	1581	555	1557	656	96
24107	Peer-to-peer	201009	14	3	0	0	11	6	3	0	3006	1590	558	1565	660	97
24107	Peer-to-peer	201010	25	7	0	0	17	10	6	0	3031	1602	565	1580	665	98
24107	Peer-to-peer	201011	14	5	0	0	12	8	4	0	3045	1610	570	1589	669	100
24107	Peer-to-peer	201012	12	3	0	0	7	3	1	0	3057	1616	573	1595	671	100
24107	Peer-to-peer	201101	2	1	0	0	2	1	1	0	3059	1618	574	1596	672	100
24107	Peer-to-peer	201102	19	4	0	0	13	8	4	0	3078	1628	578	1606	677	100
24107	Peer-to-peer	201103	7	2	0	0	6	4	2	0	3085	1632	580	1610	679	100
24107	Peer-to-peer	201104	26	5	0	0	19	10	5	0	3111	1647	585	1622	685	100
24107	Peer-to-peer	201105	5	2	0	0	5	2	2	0	3116	1650	587	1624	685	100
24107	Peer-to-peer	201106	10	4	1	0	7	4	3	1	3126	1656	591	1630	688	101
24107	Peer-to-peer	201107	17	2	0	0	11	7	2	0	3143	1663	593	1637	691	103
24107	Peer-to-peer	201108	6	0	0	0	5	2	0	0	3149	1667	593	1639	692	103
24107	Peer-to-peer	201109	9	2	0	0	9	7	2	0	3158	1673	595	1646	696	104
24107	Peer-to-peer	201110	2	0	0	0	2	2	0	0	3160	1675	595	1648	698	104
24107	Peer-to-peer	201111	7	2	0	0	7	3	2	0	3167	1679	597	1651	698	104
24107	Peer-to-peer	201112	13	2	0	0	7	5	2	0	3180	1685	599	1661	702	105
24107	Peer-to-peer	201201	3	1	0	0	3	2	1	0	3183	1687	600	1663	703	105
24107	Peer-to-peer	201202	6	2	0	0	6	4	2	0	3189	1690	602	1667	704	105
24107	Peer-to-peer	201203	22	2	0	0	12	7	1	0	3211	1699	604	1683	708	106
24107	Peer-to-peer	201204	14	2	0	0	7	3	2	0	3225	1705	606	1693	710	106
24107	Peer-to-peer	201205	21	1	0	0	15	9	1	0	3246	1717	607	1706	716	106
24107	Peer-to-peer	201206	15	4	0	0	9	4	3	0	3261	1725	611	1711	719	106
24107	Peer-to-peer	201207	6	0	0	0	5	4	0	0	3267	1728	611	1716	721	106
24107	Peer-to-peer	201208	2	0	0	0	1	1	0	0	3269	1729	611	1718	722	106
24107	Peer-to-peer	201209	12	0	0	0	2	2	0	0	3281	1730	611	1730	723	106
24107	Peer-to-peer	201210	13	6	0	0	11	6	4	0	3294	1736	617	1738	724	107
24107	Peer-to-peer	201211	3	2	0	0	3	2	2	0	3297	1737	619	1740	725	108
24107	Peer-to-peer	201212	10	3	0	0	9	5	3	0	3307	1743	622	1746	727	108
24107	Peer-to-peer	201301	7	2	0	0	6	4	2	0	3314	1746	624	1750	728	108
24107	Peer-to-peer	201302	10	2	0	0	9	2	2	0	3324	1753	626	1752	728	108
24107	Peer-to-peer	201303	23	6	0	0	19	14	5	0	3347	1769	632	1767	739	110
24107	Peer-to-peer	201304	26	10	0	0	12	7	5	0	3373	1780	642	1780	745	111
24107	Peer-to-peer	201305	25	4	0	0	12	10	4	0	3398	1785	646	1802	749	112
24107	Peer-to-peer	201306	9	3	0	0	6	2	2	0	3407	1790	649	1805	750	112
24107	Peer-to-peer	201307	15	1	0	0	7	2	1	0	3422	1795	650	1808	750	112
24107	Peer-to-peer	201308	86	3	0	0	11	5	2	0	3508	1804	653	1886	753	112
24107	Peer-to-peer	201309	8	0	0	0	3	3	0	0	3516	1806	653	1894	755	112
24107	Peer-to-peer	201310	10	2	0	0	7	4	2	0	3526	1811	655	1901	757	112
24107	Peer-to-peer	201311	51	3	0	0	21	16	3	0	3577	1826	658	1946	767	113
24107	Peer-to-peer	201312	9	2	0	0	8	4	2	0	3586	1832	660	1950	770	113
24107	Peer-to-peer	201401	14	4	0	0	12	8	4	0	3600	1843	664	1959	777	114
24107	Peer-to-peer	201402	6	1	0	0	6	4	1	0	3606	1847	665	1963	779	114
24107	Peer-to-peer	201403	13	7	2	1	11	7	6	2	3619	1855	672	1971	783	116
24107	Peer-to-peer	201404	8	3	0	0	8	6	3	0	3627	1861	675	1977	785	117
24107	Peer-to-peer	201405	10	3	0	0	7	4	2	0	3637	1867	678	1981	788	118
24107	Peer-to-peer	201406	8	1	0	0	7	4	1	0	3645	1873	679	1986	791	118
24107	Peer-to-peer	201407	2	1	0	0	2	1	1	0	3647	1874	680	1987	791	118
24107	Peer-to-peer	201408	6	0	0	0	3	3	0	0	3653	1875	680	1993	792	118
24107	Peer-to-peer	201409	13	2	0	0	10	7	2	0	3666	1883	682	2002	797	118
24107	Peer-to-peer	201410	14	3	0	0	10	5	3	0	3680	1890	685	2011	799	118
24107	Peer-to-peer	201411	6	2	0	0	5	3	2	0	3686	1894	687	2014	801	119
24107	Peer-to-peer	201412	18	9	1	0	7	5	6	1	3704	1898	696	2022	803	120
24107	Peer-to-peer	201501	12	1	0	0	9	5	1	0	3716	1905	697	2028	806	120
24107	Peer-to-peer	201502	5	0	0	0	4	2	0	0	3721	1909	697	2030	808	120
24107	Peer-to-peer	201503	5	0	0	0	3	3	0	0	3726	1910	697	2035	809	120
24107	Peer-to-peer	201504	3	1	0	0	3	2	1	0	3729	1913	698	2037	811	120
24107	Peer-to-peer	201505	1	0	0	0	1	1	0	0	3730	1914	698	2038	812	120
24107	Peer-to-peer	201506	2	0	0	0	2	2	0	0	3732	1916	698	2040	814	120
24107	Peer-to-peer	201507	3	1	0	0	3	2	1	0	3735	1918	699	2042	815	120
24107	Peer-to-peer	201508	6	2	0	0	4	2	2	0	3741	1920	701	2044	815	120
24107	Peer-to-peer	201509	6	2	0	0	4	1	1	0	3747	1923	703	2046	815	120
24107	Peer-to-peer	201510	1	0	0	0	1	1	0	0	3748	1923	703	2047	815	120
24107	Peer-to-peer	201512	7	1	0	0	5	2	1	0	3755	1926	704	2049	815	120
24107	Peer-to-peer	201601	5	2	0	0	5	2	2	0	3760	1930	706	2051	816	120
24107	Peer-to-peer	201602	2	1	0	0	2	1	1	0	3762	1931	707	2052	816	120
24107	Peer-to-peer	201603	3	1	0	0	3	2	1	0	3765	1933	708	2054	817	120
24107	Peer-to-peer	201604	3	0	0	0	3	3	0	0	3768	1936	708	2057	820	120
24107	Peer-to-peer	201605	1	0	0	0	1	1	0	0	3769	1937	708	2058	821	120
24107	Peer-to-peer	201607	1	0	0	0	1	1	0	0	3770	1938	708	2059	821	120
24107	Peer-to-peer	201608	14	4	0	0	6	3	2	0	3784	1942	712	2070	822	121
24107	Peer-to-peer	201609	6	1	0	0	4	2	1	0	3790	1946	713	2073	824	121
24107	Peer-to-peer	201610	8	3	0	0	6	3	3	0	3798	1952	716	2076	827	121
24107	Peer-to-peer	201611	4	2	0	0	4	2	2	0	3802	1955	718	2078	828	121
24107	Peer-to-peer	201612	17	7	0	0	12	9	5	0	3819	1965	725	2091	835	124
24107	Peer-to-peer	201701	4	0	0	0	3	2	0	0	3823	1966	725	2093	835	124
24107	Peer-to-peer	201702	1	0	0	0	1	1	0	0	3824	1967	725	2094	836	124
24107	Peer-to-peer	201703	10	3	0	0	7	5	2	0	3834	1972	728	2102	839	126
24107	Peer-to-peer	201704	1	0	0	0	1	1	0	0	3835	1973	728	2103	840	126
24107	Peer-to-peer	201705	2	0	0	0	2	2	0	0	3837	1975	728	2105	842	126
24107	Peer-to-peer	201706	1	0	0	0	1	1	0	0	3838	1976	728	2106	843	126
24107	Peer-to-peer	201707	5	2	0	0	5	3	2	0	3843	1980	730	2109	845	126
24107	Peer-to-peer	201708	8	3	0	0	7	5	3	0	3851	1986	733	2114	849	127
24107	Peer-to-peer	201709	7	2	0	0	6	4	2	0	3858	1990	735	2118	851	127
24107	Peer-to-peer	201710	6	1	0	0	6	6	1	0	3864	1995	736	2124	856	128
24107	Peer-to-peer	201711	4	0	0	0	4	3	0	0	3868	1999	736	2127	859	128
24107	Peer-to-peer	201712	8	2	0	0	4	3	1	0	3876	2002	738	2134	861	130
24107	Peer-to-peer	201801	18	7	0	0	11	8	5	0	3894	2010	745	2144	865	131
24107	Peer-to-peer	201802	5	1	0	0	5	4	1	0	3899	2013	746	2148	867	131
24107	Peer-to-peer	201803	1	0	0	0	1	1	0	0	3900	2014	746	2149	868	131
24107	Peer-to-peer	201804	22	7	1	0	9	7	5	1	3922	2021	753	2168	873	136
24107	Peer-to-peer	201805	4	1	0	0	4	3	1	0	3926	2024	754	2171	875	136
24107	Peer-to-peer	201806	9	2	0	0	6	5	2	0	3935	2029	756	2179	878	137
47012	Peering	200207	15	0	0	0	2	1	0	0	15	2	0	1	1	0
47012	Peering	200211	4	0	0	0	2	0	0	0	19	4	0	1	1	0
47012	Peering	200302	1	0	0	0	1	1	0	0	20	5	0	2	2	0
47012	Peering	200304	5	0	0	0	2	0	0	0	25	7	0	2	2	0
47012	Peering	200310	1	0	0	0	1	1	0	0	26	8	0	3	3	0
47012	Peering	200312	1	0	0	0	1	0	0	0	27	9	0	3	3	0
47012	Peering	200402	1	0	0	0	1	1	0	0	28	10	0	4	4	0
47012	Peering	200403	8	0	0	0	1	1	0	0	36	11	0	12	5	0
47012	Peering	200406	1	0	0	0	1	1	0	0	37	11	0	13	5	0
47012	Peering	200408	1	0	0	0	1	1	0	0	38	12	0	14	6	0
47012	Peering	200409	1	0	0	0	1	0	0	0	39	13	0	14	6	0
47012	Peering	200410	1	0	0	0	1	0	0	0	40	14	0	14	6	0
47012	Peering	200411	3	0	0	0	2	2	0	0	43	16	0	17	8	0
47012	Peering	200501	1	0	0	0	1	1	0	0	44	16	0	18	8	0
47012	Peering	200505	1	0	0	0	1	0	0	0	45	17	0	18	8	0
47012	Peering	200506	4	0	0	0	3	2	0	0	49	20	0	21	10	0
47012	Peering	200507	1	0	0	0	1	1	0	0	50	21	0	22	11	0
47012	Peering	200508	2	0	0	0	2	2	0	0	52	23	0	24	13	0
47012	Peering	200509	5	1	0	0	4	2	1	0	57	27	1	26	15	0
47012	Peering	200510	2	0	0	0	2	1	0	0	59	29	1	27	16	0
47012	Peering	200511	35	1	0	0	9	4	1	0	94	38	2	44	20	0
47012	Peering	200512	7	0	0	0	5	2	0	0	101	43	2	46	22	0
47012	Peering	200601	1	0	0	0	1	1	0	0	102	44	2	47	23	0
47012	Peering	200602	8	0	0	0	5	2	0	0	110	49	2	50	25	0
47012	Peering	200603	12	0	0	0	9	2	0	0	122	58	2	54	27	0
47012	Peering	200604	25	0	0	0	10	3	0	0	147	67	2	66	29	0
47012	Peering	200605	9	0	0	0	8	5	0	0	156	74	2	71	33	0
47012	Peering	200606	17	1	0	0	6	4	1	0	173	77	3	84	35	0
47012	Peering	200607	16	5	0	0	11	7	5	0	189	87	8	91	41	0
47012	Peering	200608	18	0	0	0	9	8	0	0	207	95	8	108	48	0
47012	Peering	200609	8	3	0	0	7	3	2	0	215	100	11	112	49	1
47012	Peering	200610	16	1	0	0	8	7	1	0	231	107	12	127	55	1
47012	Peering	200611	2	0	0	0	2	0	0	0	233	109	12	127	55	1
47012	Peering	200612	15	2	0	0	8	6	2	0	248	115	14	139	59	2
47012	Peering	200701	1	0	0	0	1	0	0	0	249	116	14	139	59	2
47012	Peering	200702	6	0	0	0	5	3	0	0	255	121	14	143	62	2
47012	Peering	200703	5	1	0	0	5	3	1	0	260	125	15	146	64	2
47012	Peering	200704	5	0	0	0	5	5	0	0	265	129	15	151	68	2
47012	Peering	200705	6	0	0	0	6	4	0	0	271	133	15	155	70	2
47012	Peering	200706	2	0	0	0	2	2	0	0	273	134	15	157	71	2
47012	Peering	200707	2	0	0	0	2	2	0	0	275	136	15	159	73	2
47012	Peering	200708	1	0	0	0	1	0	0	0	276	137	15	159	73	2
47012	Peering	200709	1	0	0	0	1	1	0	0	277	138	15	160	74	2
47012	Peering	200710	5	0	0	0	4	3	0	0	282	141	15	163	76	2
47012	Peering	200711	5	0	0	0	4	2	0	0	287	145	15	165	78	2
47012	Peering	200712	1	0	0	0	1	0	0	0	288	146	15	165	78	2
47012	Peering	200801	2	0	0	0	2	1	0	0	290	148	15	166	79	2
47012	Peering	200803	4	0	0	0	3	2	0	0	294	151	15	169	81	2
47012	Peering	200804	9	1	0	0	6	3	1	0	303	156	16	173	83	2
47012	Peering	200806	2	1	0	0	2	1	1	0	305	157	17	174	83	2
47012	Peering	200807	2	0	0	0	2	2	0	0	307	158	17	176	84	2
47012	Peering	200808	2	0	0	0	2	1	0	0	309	160	17	177	85	2
47012	Peering	200809	4	1	0	0	4	4	1	0	313	164	18	181	89	3
47012	Peering	200810	6	0	0	0	4	1	0	0	319	167	18	182	89	3
47012	Peering	200811	4	0	0	0	4	2	0	0	323	171	18	184	91	3
47012	Peering	200812	8	1	0	0	7	4	1	0	331	177	19	188	94	3
47012	Peering	200901	1	0	0	0	1	0	0	0	332	178	19	188	94	3
47012	Peering	200902	5	2	0	0	3	2	1	0	337	180	21	192	95	4
47012	Peering	200903	3	1	0	0	3	1	1	0	340	182	22	193	95	4
47012	Peering	200904	1	0	0	0	1	0	0	0	341	183	22	193	95	4
47012	Peering	200905	1	0	0	0	1	1	0	0	342	184	22	194	96	4
47012	Peering	200906	3	2	0	0	3	1	2	0	345	186	24	195	96	5
47012	Peering	200907	2	0	0	0	1	0	0	0	347	187	24	195	96	5
47012	Peering	200908	2	0	0	0	1	1	0	0	349	188	24	197	97	5
47012	Peering	200910	4	1	0	0	4	3	1	0	353	191	25	200	99	5
47012	Peering	200912	2	1	0	0	2	1	1	0	355	193	26	201	100	5
47012	Peering	201002	1	0	0	0	1	0	0	0	356	194	26	201	100	5
47012	Peering	201003	1	0	0	0	1	0	0	0	357	195	26	201	100	5
47012	Peering	201006	7	1	0	0	3	1	1	0	364	198	27	203	101	5
47012	Peering	201007	3	1	0	0	2	2	1	0	367	199	28	206	102	6
47012	Peering	201009	1	0	0	0	1	0	0	0	368	200	28	206	102	6
47012	Peering	201010	3	0	0	0	3	2	0	0	371	202	28	208	103	6
47012	Peering	201011	1	0	0	0	1	1	0	0	372	203	28	209	104	6
47012	Peering	201101	4	1	0	0	4	2	1	0	376	206	29	211	105	7
47012	Peering	201104	3	0	0	0	1	0	0	0	379	207	29	211	105	7
47012	Peering	201105	1	0	0	0	1	1	0	0	380	208	29	212	106	7
47012	Peering	201107	8	1	0	0	2	1	1	0	388	210	30	219	107	7
47012	Peering	201108	1	0	0	0	1	1	0	0	389	211	30	220	108	7
47012	Peering	201109	4	1	0	0	4	2	1	0	393	215	31	222	110	7
47012	Peering	201112	1	0	0	0	1	1	0	0	394	216	31	223	111	7
47012	Peering	201201	1	0	0	0	1	0	0	0	395	217	31	223	111	7
47012	Peering	201202	2	0	0	0	2	1	0	0	397	219	31	224	112	7
47012	Peering	201203	1	0	0	0	1	0	0	0	398	220	31	224	112	7
47012	Peering	201204	2	0	0	0	2	2	0	0	400	222	31	226	114	7
47012	Peering	201205	4	0	0	0	3	1	0	0	404	224	31	228	114	7
47012	Peering	201206	1	0	0	0	1	0	0	0	405	225	31	228	114	7
47012	Peering	201207	1	0	0	0	1	1	0	0	406	226	31	229	115	7
47012	Peering	201208	2	0	0	0	2	2	0	0	408	228	31	231	117	7
47012	Peering	201209	1	0	0	0	1	1	0	0	409	229	31	232	118	7
47012	Peering	201210	2	0	0	0	2	1	0	0	411	230	31	233	118	7
47012	Peering	201211	1	0	0	0	1	1	0	0	412	231	31	234	119	7
47012	Peering	201301	2	0	0	0	2	2	0	0	414	232	31	236	120	7
47012	Peering	201302	3	0	0	0	2	1	0	0	417	234	31	238	121	7
47012	Peering	201304	1	0	0	0	1	1	0	0	418	235	31	239	122	7
47012	Peering	201305	1	0	0	0	1	1	0	0	419	235	31	240	122	7
47012	Peering	201306	2	0	0	0	2	2	0	0	421	237	31	242	124	7
47012	Peering	201307	6	0	0	0	4	2	0	0	427	240	31	244	125	7
47012	Peering	201309	2	0	0	0	2	2	0	0	429	242	31	246	127	7
47012	Peering	201310	7	1	0	0	5	2	1	0	436	247	32	248	129	7
47012	Peering	201401	3	0	0	0	3	2	0	0	439	249	32	250	130	7
47012	Peering	201402	2	1	0	0	2	1	1	0	441	251	33	251	131	7
47012	Peering	201403	1	0	0	0	1	1	0	0	442	252	33	252	132	7
47012	Peering	201404	1	0	0	0	1	1	0	0	443	253	33	253	133	7
47012	Peering	201405	3	0	0	0	3	3	0	0	446	256	33	256	136	7
47012	Peering	201406	5	1	0	0	5	1	1	0	451	261	34	257	137	7
47012	Peering	201407	4	0	0	0	3	3	0	0	455	264	34	261	140	7
47012	Peering	201408	1	0	0	0	1	1	0	0	456	264	34	262	140	7
47012	Peering	201410	1	0	0	0	1	0	0	0	457	265	34	262	140	7
47012	Peering	201411	1	0	0	0	1	1	0	0	458	265	34	263	140	7
47012	Peering	201412	4	0	0	0	4	3	0	0	462	268	34	266	142	7
47012	Peering	201501	1	0	0	0	1	1	0	0	463	269	34	267	143	7
47012	Peering	201505	2	0	0	0	2	2	0	0	465	271	34	269	145	7
47012	Peering	201507	1	0	0	0	1	0	0	0	466	272	34	269	145	7
47012	Peering	201508	1	0	0	0	1	1	0	0	467	273	34	270	146	7
47012	Peering	201510	4	0	0	0	4	4	0	0	471	276	34	274	149	7
47012	Peering	201601	2	1	0	0	2	1	1	0	473	278	35	275	150	7
47012	Peering	201602	4	3	2	1	2	1	2	2	477	280	38	277	151	8
47012	Peering	201603	1	0	0	0	1	1	0	0	478	281	38	278	152	8
47012	Peering	201606	1	0	0	0	1	0	0	0	479	282	38	278	152	8
47012	Peering	201607	1	0	0	0	1	0	0	0	480	283	38	278	152	8
47012	Peering	201608	1	0	0	0	1	1	0	0	481	284	38	279	153	8
47012	Peering	201609	2	0	0	0	2	2	0	0	483	286	38	281	155	8
47012	Peering	201701	2	0	0	0	2	1	0	0	485	287	38	282	155	8
47012	Peering	201702	3	0	0	0	1	1	0	0	488	287	38	285	155	8
47012	Peering	201703	1	0	0	0	1	1	0	0	489	288	38	286	156	8
47012	Peering	201706	2	0	0	0	1	1	0	0	491	289	38	288	157	8
47012	Peering	201709	1	0	0	0	1	1	0	0	492	290	38	289	158	8
47012	Peering	201712	2	0	0	0	2	2	0	0	494	292	38	291	160	8
47012	Peering	201801	1	0	0	0	1	1	0	0	495	293	38	292	161	8
47012	Peering	201803	1	0	0	0	1	0	0	0	496	294	38	292	161	8
47012	Peering	201805	2	0	0	0	2	2	0	0	498	295	38	294	162	8
365935	Point-to-multipoint_communication	200505	2	0	0	0	2	2	0	0	2	2	0	2	2	0
365935	Point-to-multipoint_communication	200508	1	0	0	0	1	1	0	0	3	3	0	3	3	0
365935	Point-to-multipoint_communication	200511	1	0	0	0	1	1	0	0	4	4	0	4	4	0
365935	Point-to-multipoint_communication	200601	1	0	0	0	1	0	0	0	5	5	0	4	4	0
365935	Point-to-multipoint_communication	200607	1	0	0	0	1	1	0	0	6	6	0	5	5	0
365935	Point-to-multipoint_communication	200612	1	0	0	0	1	1	0	0	7	7	0	6	6	0
365935	Point-to-multipoint_communication	200701	12	0	0	0	3	3	0	0	19	10	0	18	9	0
365935	Point-to-multipoint_communication	200702	2	0	0	0	1	1	0	0	21	11	0	20	10	0
365935	Point-to-multipoint_communication	200704	1	0	0	0	1	1	0	0	22	12	0	21	11	0
365935	Point-to-multipoint_communication	200705	3	0	0	0	1	1	0	0	25	13	0	24	12	0
365935	Point-to-multipoint_communication	200707	1	0	0	0	1	1	0	0	26	14	0	25	13	0
365935	Point-to-multipoint_communication	200709	1	0	0	0	1	1	0	0	27	15	0	26	14	0
365935	Point-to-multipoint_communication	200710	1	0	0	0	1	1	0	0	28	16	0	27	15	0
365935	Point-to-multipoint_communication	200802	2	0	0	0	1	1	0	0	30	17	0	29	16	0
365935	Point-to-multipoint_communication	200809	3	0	0	0	3	3	0	0	33	20	0	32	19	0
365935	Point-to-multipoint_communication	200907	2	0	0	0	2	2	0	0	35	21	0	34	20	0
365935	Point-to-multipoint_communication	200910	1	0	0	0	1	1	0	0	36	22	0	35	21	0
365935	Point-to-multipoint_communication	200912	2	0	0	0	1	0	0	0	38	23	0	35	21	0
365935	Point-to-multipoint_communication	201101	4	2	0	0	3	1	2	0	42	25	2	36	21	0
365935	Point-to-multipoint_communication	201104	1	0	0	0	1	1	0	0	43	26	2	37	22	0
365935	Point-to-multipoint_communication	201105	1	0	0	0	1	1	0	0	44	27	2	38	23	0
365935	Point-to-multipoint_communication	201107	1	0	0	0	1	1	0	0	45	28	2	39	24	0
365935	Point-to-multipoint_communication	201205	3	0	0	0	3	2	0	0	48	30	2	41	25	0
365935	Point-to-multipoint_communication	201210	2	0	0	0	2	2	0	0	50	32	2	43	27	0
365935	Point-to-multipoint_communication	201211	2	0	0	0	1	1	0	0	52	33	2	45	28	0
365935	Point-to-multipoint_communication	201303	1	0	0	0	1	1	0	0	53	34	2	46	29	0
365935	Point-to-multipoint_communication	201407	1	0	0	0	1	1	0	0	54	35	2	47	30	0
365935	Point-to-multipoint_communication	201502	1	0	0	0	1	1	0	0	55	36	2	48	31	0
365935	Point-to-multipoint_communication	201508	2	0	0	0	2	2	0	0	57	38	2	50	33	0
365935	Point-to-multipoint_communication	201512	21	0	0	0	7	6	0	0	78	44	2	69	38	0
365935	Point-to-multipoint_communication	201602	1	0	0	0	1	1	0	0	79	45	2	70	39	0
365935	Point-to-multipoint_communication	201605	1	0	0	0	1	1	0	0	80	46	2	71	40	0
365935	Point-to-multipoint_communication	201609	1	0	0	0	1	1	0	0	81	47	2	72	41	0
365935	Point-to-multipoint_communication	201705	1	0	0	0	1	1	0	0	82	48	2	73	42	0
365935	Point-to-multipoint_communication	201712	3	0	0	0	3	2	0	0	85	51	2	75	44	0
365935	Point-to-multipoint_communication	201801	1	0	0	0	1	1	0	0	86	52	2	76	45	0
365935	Point-to-multipoint_communication	201802	1	0	0	0	1	1	0	0	87	52	2	77	45	0
365935	Point-to-multipoint_communication	201803	1	0	0	0	1	1	0	0	88	53	2	78	46	0
365935	Point-to-multipoint_communication	201805	1	0	0	0	1	1	0	0	89	53	2	79	46	0
365935	Point-to-multipoint_communication	201806	4	1	0	0	3	3	1	0	93	55	3	83	48	1
41797374	Port_Control_Protocol	201402	21	0	0	0	2	2	0	0	21	2	0	21	2	0
41797374	Port_Control_Protocol	201403	6	0	0	0	1	1	0	0	27	2	0	27	2	0
41797374	Port_Control_Protocol	201407	4	0	0	0	1	1	0	0	31	2	0	31	2	0
41797374	Port_Control_Protocol	201408	6	0	0	0	2	1	0	0	37	3	0	36	2	0
41797374	Port_Control_Protocol	201409	19	0	0	0	2	1	0	0	56	4	0	54	2	0
41797374	Port_Control_Protocol	201412	2	1	0	0	2	1	1	0	58	5	1	55	2	0
41797374	Port_Control_Protocol	201502	1	0	0	0	1	1	0	0	59	5	1	56	2	0
41797374	Port_Control_Protocol	201505	3	0	0	0	2	2	0	0	62	6	1	59	3	0
41797374	Port_Control_Protocol	201601	4	0	0	0	2	1	0	0	66	7	1	62	3	0
41797374	Port_Control_Protocol	201604	6	3	1	0	3	2	3	1	72	9	4	66	4	1
41797374	Port_Control_Protocol	201710	10	0	0	0	3	2	0	0	82	11	4	75	5	1
41797374	Port_Control_Protocol	201712	1	0	0	0	1	0	0	0	83	12	4	75	5	1
41797374	Port_Control_Protocol	201805	1	0	0	0	1	1	0	0	84	13	4	76	6	1
41797374	Port_Control_Protocol	201807	2	0	0	0	1	1	0	0	86	14	4	78	7	1
23862	Python_(programming_language)	200111	1	0	0	0	1	1	0	0	1	1	0	1	1	0
23862	Python_(programming_language)	200201	1	0	0	0	1	1	0	0	2	2	0	2	2	0
23862	Python_(programming_language)	200202	1	0	0	0	1	1	0	0	3	3	0	3	2	0
23862	Python_(programming_language)	200205	2	0	0	0	2	2	0	0	5	5	0	5	2	0
23862	Python_(programming_language)	200206	1	0	0	0	1	1	0	0	6	6	0	6	3	0
23862	Python_(programming_language)	200208	1	0	0	0	1	0	0	0	7	7	0	6	3	0
23862	Python_(programming_language)	200209	1	0	0	0	1	1	0	0	8	8	0	7	4	0
23862	Python_(programming_language)	200210	4	0	0	0	4	3	0	0	12	12	0	10	7	0
23862	Python_(programming_language)	200211	9	0	0	0	6	4	0	0	21	16	0	16	9	0
23862	Python_(programming_language)	200212	35	0	0	0	6	3	0	0	56	19	0	48	9	0
23862	Python_(programming_language)	200301	2	0	0	0	2	0	0	0	58	21	0	48	9	0
23862	Python_(programming_language)	200302	4	0	0	0	4	1	0	0	62	25	0	49	10	0
23862	Python_(programming_language)	200303	11	0	0	0	7	4	0	0	73	30	0	56	12	0
23862	Python_(programming_language)	200304	2	0	0	0	1	1	0	0	75	31	0	58	13	0
23862	Python_(programming_language)	200305	4	0	0	0	4	2	0	0	79	34	0	60	14	0
23862	Python_(programming_language)	200306	4	0	0	0	3	3	0	0	83	36	0	64	16	0
23862	Python_(programming_language)	200307	9	0	0	0	4	3	0	0	92	38	0	72	17	0
23862	Python_(programming_language)	200308	6	0	0	0	6	6	0	0	98	42	0	78	21	0
23862	Python_(programming_language)	200309	7	0	0	0	6	4	0	0	105	47	0	83	24	0
23862	Python_(programming_language)	200310	7	0	0	0	7	5	0	0	112	53	0	88	28	0
23862	Python_(programming_language)	200311	14	0	0	0	7	4	0	0	126	58	0	98	30	0
23862	Python_(programming_language)	200312	11	0	0	0	8	6	0	0	137	63	0	107	33	0
23862	Python_(programming_language)	200401	7	0	0	0	7	5	0	0	144	70	0	112	38	0
23862	Python_(programming_language)	200402	14	0	0	0	10	7	0	0	158	79	0	123	44	0
23862	Python_(programming_language)	200403	9	0	0	0	5	3	0	0	167	84	0	130	47	0
23862	Python_(programming_language)	200404	19	0	0	0	18	15	0	0	186	98	0	146	58	0
23862	Python_(programming_language)	200405	6	0	0	0	4	3	0	0	192	101	0	151	60	0
23862	Python_(programming_language)	200406	14	0	0	0	11	3	0	0	206	111	0	155	62	0
23862	Python_(programming_language)	200407	17	0	0	0	13	7	0	0	223	122	0	162	67	0
23862	Python_(programming_language)	200408	20	0	0	0	15	8	0	0	243	137	0	173	75	0
23862	Python_(programming_language)	200409	23	1	0	0	15	12	1	0	266	149	1	193	84	0
23862	Python_(programming_language)	200410	27	4	0	0	20	14	4	0	293	164	5	213	93	2
23862	Python_(programming_language)	200411	20	1	0	0	16	11	1	0	313	177	6	226	101	2
23862	Python_(programming_language)	200412	13	1	0	0	11	6	1	0	326	185	7	233	104	2
23862	Python_(programming_language)	200501	22	0	0	0	13	7	0	0	348	195	7	243	108	2
23862	Python_(programming_language)	200502	18	3	1	0	12	10	3	1	366	205	10	257	116	3
23862	Python_(programming_language)	200503	13	0	0	0	13	4	0	0	379	217	10	261	120	3
23862	Python_(programming_language)	200504	25	2	0	0	20	9	2	0	404	232	12	275	124	3
23862	Python_(programming_language)	200505	47	2	0	0	23	10	2	0	451	253	14	307	132	3
23862	Python_(programming_language)	200506	36	2	0	0	22	12	2	0	487	269	16	332	138	3
23862	Python_(programming_language)	200507	53	3	0	0	26	11	3	0	540	291	19	364	146	4
23862	Python_(programming_language)	200508	22	2	0	0	16	10	2	0	562	303	21	379	152	5
23862	Python_(programming_language)	200509	44	4	0	0	36	19	4	0	606	336	25	403	168	7
23862	Python_(programming_language)	200510	40	3	0	0	25	17	3	0	646	353	28	432	177	8
23862	Python_(programming_language)	200511	49	4	0	0	33	19	4	0	695	379	32	455	189	9
23862	Python_(programming_language)	200512	37	5	0	0	29	16	3	0	732	400	37	477	197	10
23862	Python_(programming_language)	200601	69	3	0	0	45	21	3	0	801	436	40	512	209	10
23862	Python_(programming_language)	200602	74	7	0	0	37	24	4	0	875	465	47	567	225	10
23862	Python_(programming_language)	200603	39	5	0	0	20	13	4	0	914	480	52	595	233	10
23862	Python_(programming_language)	200604	46	7	0	0	35	20	6	0	960	506	59	624	244	12
23862	Python_(programming_language)	200605	71	7	0	0	31	17	1	0	1031	528	66	676	252	13
23862	Python_(programming_language)	200606	59	9	0	0	37	27	9	0	1090	556	75	721	270	15
23862	Python_(programming_language)	200607	25	6	0	0	21	10	5	0	1115	573	81	734	276	15
23862	Python_(programming_language)	200608	45	5	0	0	29	16	4	0	1160	598	86	763	288	17
23862	Python_(programming_language)	200609	96	9	0	0	45	25	5	0	1256	636	95	834	306	20
23862	Python_(programming_language)	200610	52	4	0	0	22	13	4	0	1308	654	99	873	315	21
23862	Python_(programming_language)	200611	40	3	0	0	22	12	3	0	1348	671	102	891	322	22
23862	Python_(programming_language)	200612	44	7	0	0	27	11	4	0	1392	693	109	913	329	23
23862	Python_(programming_language)	200701	49	5	0	0	29	14	4	0	1441	717	114	937	338	23
23862	Python_(programming_language)	200702	64	6	0	0	33	21	4	0	1505	741	120	975	350	25
23862	Python_(programming_language)	200703	43	3	0	0	33	15	3	0	1548	769	123	991	361	27
23862	Python_(programming_language)	200704	48	3	0	0	31	16	2	0	1596	794	126	1019	371	28
23862	Python_(programming_language)	200705	41	4	0	0	29	20	4	0	1637	818	130	1049	386	28
23862	Python_(programming_language)	200706	53	2	0	0	33	19	2	0	1690	845	132	1083	399	29
23862	Python_(programming_language)	200707	52	9	1	0	35	19	7	1	1742	869	141	1114	407	35
23862	Python_(programming_language)	200708	38	2	0	0	26	13	2	0	1780	886	143	1136	411	35
23862	Python_(programming_language)	200709	36	3	0	0	19	16	2	0	1816	897	146	1169	419	38
23862	Python_(programming_language)	200710	51	8	0	0	25	15	6	0	1867	917	154	1207	429	41
23862	Python_(programming_language)	200711	64	18	0	0	41	27	12	0	1931	948	172	1245	447	46
23862	Python_(programming_language)	200712	55	9	0	0	29	13	4	0	1986	974	181	1278	457	50
23862	Python_(programming_language)	200801	43	7	0	0	26	15	5	0	2029	995	188	1304	467	53
23862	Python_(programming_language)	200802	24	3	0	0	18	12	3	0	2053	1010	191	1322	476	53
23862	Python_(programming_language)	200803	28	4	0	0	19	13	3	0	2081	1026	195	1342	486	54
23862	Python_(programming_language)	200804	62	7	1	0	35	23	5	1	2143	1054	202	1381	502	58
23862	Python_(programming_language)	200805	58	9	3	1	38	23	8	3	2201	1086	211	1418	519	64
23862	Python_(programming_language)	200806	30	5	0	0	21	12	5	0	2231	1102	216	1435	527	65
23862	Python_(programming_language)	200807	30	5	0	0	25	13	3	0	2261	1122	221	1451	535	67
23862	Python_(programming_language)	200808	42	5	0	0	28	17	4	0	2303	1145	226	1480	547	70
23862	Python_(programming_language)	200809	52	5	0	0	31	19	5	0	2355	1169	231	1512	559	73
23862	Python_(programming_language)	200810	45	11	1	0	33	19	10	1	2400	1195	242	1540	572	77
23862	Python_(programming_language)	200811	62	10	1	0	37	23	6	1	2462	1222	252	1585	586	80
23862	Python_(programming_language)	200812	31	4	0	0	20	13	4	0	2493	1236	256	1608	593	81
23862	Python_(programming_language)	200901	63	2	0	0	35	16	2	0	2556	1262	258	1642	600	82
23862	Python_(programming_language)	200902	61	13	0	0	41	22	7	0	2617	1293	271	1683	612	86
23862	Python_(programming_language)	200903	80	13	1	0	31	20	10	1	2697	1316	284	1750	625	94
23862	Python_(programming_language)	200904	49	5	0	0	28	17	4	0	2746	1337	289	1786	635	96
23862	Python_(programming_language)	200905	33	8	0	0	28	18	8	0	2779	1358	297	1808	646	100
23862	Python_(programming_language)	200906	38	6	0	0	23	13	6	0	2817	1375	303	1830	654	100
23862	Python_(programming_language)	200907	34	3	0	0	14	4	2	0	2851	1387	306	1852	656	100
23862	Python_(programming_language)	200908	24	0	0	0	18	11	0	0	2875	1400	306	1868	662	100
23862	Python_(programming_language)	200909	41	22	11	8	22	11	9	3	2916	1416	328	1888	667	108
23862	Python_(programming_language)	200910	22	2	0	0	15	8	2	0	2938	1426	330	1898	670	108
23862	Python_(programming_language)	200911	14	3	0	0	14	8	3	0	2952	1438	333	1906	676	108
23862	Python_(programming_language)	200912	20	3	0	0	15	11	3	0	2972	1449	336	1921	683	109
23862	Python_(programming_language)	201001	34	7	0	0	23	12	5	0	3006	1468	343	1943	691	111
23862	Python_(programming_language)	201002	36	8	0	0	19	9	6	0	3042	1480	351	1962	694	113
23862	Python_(programming_language)	201003	24	4	0	0	22	10	4	0	3066	1495	355	1973	697	113
23862	Python_(programming_language)	201004	60	13	1	0	20	10	6	1	3126	1511	368	2018	703	120
23862	Python_(programming_language)	201005	34	6	0	0	23	13	5	0	3160	1528	374	2035	710	121
23862	Python_(programming_language)	201006	23	4	0	0	18	9	4	0	3183	1541	378	2048	714	121
23862	Python_(programming_language)	201007	26	4	0	0	19	14	3	0	3209	1554	382	2067	722	123
23862	Python_(programming_language)	201008	24	3	0	0	18	11	2	0	3233	1566	385	2084	727	124
23862	Python_(programming_language)	201009	43	8	0	0	25	18	7	0	3276	1586	393	2120	740	126
23862	Python_(programming_language)	201010	16	2	0	0	15	9	2	0	3292	1598	395	2130	746	126
23862	Python_(programming_language)	201011	24	2	0	0	21	10	2	0	3316	1614	397	2142	751	126
23862	Python_(programming_language)	201012	24	5	0	0	20	13	5	0	3340	1629	402	2158	759	127
23862	Python_(programming_language)	201101	23	8	0	0	20	11	6	0	3363	1643	410	2171	764	129
23862	Python_(programming_language)	201102	44	4	0	0	24	13	2	0	3407	1662	414	2201	772	131
23862	Python_(programming_language)	201103	32	6	0	0	21	11	4	0	3439	1678	420	2222	778	132
23862	Python_(programming_language)	201104	19	5	0	0	17	12	5	0	3458	1689	425	2236	786	134
23862	Python_(programming_language)	201105	38	7	0	0	23	12	3	0	3496	1706	432	2260	793	135
23862	Python_(programming_language)	201106	27	4	0	0	19	12	4	0	3523	1720	436	2280	800	135
23862	Python_(programming_language)	201107	26	2	0	0	18	13	2	0	3549	1733	438	2300	808	137
23862	Python_(programming_language)	201108	21	4	0	0	16	10	4	0	3570	1744	442	2315	813	138
23862	Python_(programming_language)	201109	29	4	0	0	20	12	4	0	3599	1758	446	2336	819	140
23862	Python_(programming_language)	201110	38	6	0	0	31	19	6	0	3637	1781	452	2359	830	140
23862	Python_(programming_language)	201111	11	1	0	0	9	6	1	0	3648	1786	453	2366	832	141
23862	Python_(programming_language)	201112	18	4	0	0	17	13	4	0	3666	1798	457	2380	840	142
23862	Python_(programming_language)	201201	15	1	0	0	11	7	1	0	3681	1804	458	2390	842	142
23862	Python_(programming_language)	201202	36	6	0	0	25	17	4	0	3717	1819	464	2416	849	145
23862	Python_(programming_language)	201203	57	7	0	0	21	16	4	0	3774	1831	471	2465	856	150
23862	Python_(programming_language)	201204	25	6	0	0	18	11	3	0	3799	1842	477	2482	860	151
23862	Python_(programming_language)	201205	34	6	0	0	23	10	5	0	3833	1858	483	2497	863	151
23862	Python_(programming_language)	201206	37	6	0	0	22	16	5	0	3870	1871	489	2526	871	154
23862	Python_(programming_language)	201207	17	3	1	0	11	10	3	1	3887	1876	492	2542	875	156
23862	Python_(programming_language)	201208	27	8	1	0	20	12	8	1	3914	1893	500	2558	883	158
23862	Python_(programming_language)	201209	31	3	0	0	23	16	2	0	3945	1909	503	2578	891	158
23862	Python_(programming_language)	201210	46	12	2	1	31	16	9	2	3991	1931	515	2604	898	162
23862	Python_(programming_language)	201211	20	3	0	0	14	10	3	0	4011	1938	518	2620	901	163
23862	Python_(programming_language)	201212	41	1	0	0	18	14	1	0	4052	1950	519	2657	909	163
23862	Python_(programming_language)	201301	74	7	0	0	28	22	5	0	4126	1964	526	2725	917	167
23862	Python_(programming_language)	201302	33	7	0	0	24	11	7	0	4159	1981	533	2740	921	168
23862	Python_(programming_language)	201303	30	4	0	0	22	13	4	0	4189	2000	537	2761	931	170
23862	Python_(programming_language)	201304	76	11	0	0	30	19	10	0	4265	2020	548	2813	940	173
23862	Python_(programming_language)	201305	37	11	1	0	27	13	8	1	4302	2044	559	2832	950	175
23862	Python_(programming_language)	201306	23	7	0	0	18	10	7	0	4325	2057	566	2845	955	178
23862	Python_(programming_language)	201307	27	3	0	0	16	10	3	0	4352	2067	569	2860	959	178
23862	Python_(programming_language)	201308	33	6	0	0	18	11	4	0	4385	2082	575	2882	967	180
23862	Python_(programming_language)	201309	30	3	0	0	21	16	2	0	4415	2099	578	2907	979	182
23862	Python_(programming_language)	201310	31	8	0	0	15	8	7	0	4446	2110	586	2917	983	183
23862	Python_(programming_language)	201311	19	4	0	0	14	9	4	0	4465	2120	590	2929	988	184
23862	Python_(programming_language)	201312	34	10	0	0	25	11	9	0	4499	2139	600	2945	994	185
23862	Python_(programming_language)	201401	19	8	0	0	17	8	7	0	4518	2154	608	2955	1000	186
23862	Python_(programming_language)	201402	26	4	0	0	22	13	3	0	4544	2168	612	2971	1006	188
23862	Python_(programming_language)	201403	29	4	0	0	22	14	3	0	4573	2185	616	2989	1014	189
23862	Python_(programming_language)	201404	19	6	0	0	16	10	6	0	4592	2196	622	3002	1018	190
23862	Python_(programming_language)	201405	15	4	0	0	11	6	4	0	4607	2203	626	3008	1020	190
23862	Python_(programming_language)	201406	18	4	0	0	15	8	4	0	4625	2215	630	3017	1025	190
23862	Python_(programming_language)	201407	40	7	0	0	26	19	7	0	4665	2232	637	3049	1035	191
23862	Python_(programming_language)	201408	24	4	1	0	18	12	3	1	4689	2245	641	3066	1042	192
23862	Python_(programming_language)	201409	26	7	1	0	19	14	6	1	4715	2261	648	3086	1053	195
23862	Python_(programming_language)	201410	23	4	0	0	18	8	4	0	4738	2274	652	3098	1056	195
23862	Python_(programming_language)	201411	17	3	0	0	16	12	3	0	4755	2286	655	3111	1064	196
23862	Python_(programming_language)	201412	22	9	1	0	12	7	7	1	4777	2292	664	3123	1065	199
23862	Python_(programming_language)	201501	14	2	0	0	11	7	2	0	4791	2299	666	3130	1068	200
23862	Python_(programming_language)	201502	29	10	1	0	23	11	9	1	4820	2315	676	3144	1072	202
23862	Python_(programming_language)	201503	15	4	0	0	14	11	4	0	4835	2323	680	3155	1077	203
23862	Python_(programming_language)	201504	14	4	0	0	12	11	4	0	4849	2330	684	3168	1083	206
23862	Python_(programming_language)	201505	24	8	0	0	20	13	7	0	4873	2345	692	3184	1091	209
23862	Python_(programming_language)	201506	25	2	0	0	20	14	2	0	4898	2356	694	3202	1096	210
23862	Python_(programming_language)	201507	20	4	0	0	16	9	4	0	4918	2366	698	3211	1099	211
23862	Python_(programming_language)	201508	33	7	0	0	21	12	5	0	4951	2383	705	3226	1107	212
23862	Python_(programming_language)	201509	43	10	0	0	24	20	8	0	4994	2398	715	3261	1119	215
23862	Python_(programming_language)	201510	37	8	0	0	26	20	7	0	5031	2416	723	3291	1131	217
23862	Python_(programming_language)	201511	18	5	0	0	11	8	4	0	5049	2420	728	3302	1133	219
23862	Python_(programming_language)	201512	24	7	0	0	18	11	7	0	5073	2431	735	3315	1137	220
23862	Python_(programming_language)	201601	19	5	0	0	15	10	4	0	5092	2438	740	3328	1139	222
23862	Python_(programming_language)	201602	35	7	0	0	23	19	6	0	5127	2452	747	3358	1149	227
23862	Python_(programming_language)	201603	26	4	0	0	15	10	2	0	5153	2464	751	3379	1155	229
23862	Python_(programming_language)	201604	35	11	0	0	23	15	9	0	5188	2481	762	3399	1164	233
23862	Python_(programming_language)	201605	12	3	0	0	10	8	3	0	5200	2483	765	3409	1165	235
23862	Python_(programming_language)	201606	33	8	0	0	20	13	8	0	5233	2495	773	3424	1170	238
23862	Python_(programming_language)	201607	23	5	0	0	17	10	3	0	5256	2509	778	3438	1175	240
23862	Python_(programming_language)	201608	19	4	0	0	18	13	4	0	5275	2520	782	3452	1181	243
23862	Python_(programming_language)	201609	30	9	1	0	18	11	6	1	5305	2530	791	3469	1185	247
23862	Python_(programming_language)	201610	81	26	0	0	43	33	18	0	5386	2562	817	3525	1205	259
23862	Python_(programming_language)	201611	46	12	0	0	30	25	10	0	5432	2586	829	3560	1223	267
23862	Python_(programming_language)	201612	25	7	0	0	18	15	7	0	5457	2597	836	3582	1231	273
23862	Python_(programming_language)	201701	22	5	0	0	19	13	4	0	5479	2611	841	3597	1237	277
23862	Python_(programming_language)	201702	88	14	0	0	31	23	10	0	5567	2631	855	3670	1248	282
23862	Python_(programming_language)	201703	23	6	0	0	17	13	5	0	5590	2642	861	3686	1255	284
23862	Python_(programming_language)	201704	33	6	0	0	22	15	6	0	5623	2656	867	3709	1261	285
23862	Python_(programming_language)	201705	27	7	0	0	20	15	5	0	5650	2671	874	3731	1271	288
23862	Python_(programming_language)	201706	31	9	0	0	18	12	7	0	5681	2682	883	3746	1275	292
23862	Python_(programming_language)	201707	25	7	0	0	20	14	5	0	5706	2698	890	3765	1285	297
23862	Python_(programming_language)	201708	30	5	0	0	17	10	4	0	5736	2709	895	3786	1290	299
23862	Python_(programming_language)	201709	18	5	0	0	16	13	5	0	5754	2718	900	3801	1295	302
23862	Python_(programming_language)	201710	88	22	0	0	42	32	13	0	5842	2748	922	3862	1314	314
23862	Python_(programming_language)	201711	19	5	0	0	18	14	5	0	5861	2759	927	3876	1322	316
23862	Python_(programming_language)	201712	80	18	0	0	39	31	13	0	5941	2787	945	3941	1342	323
23862	Python_(programming_language)	201801	36	7	0	0	21	13	5	0	5977	2802	952	3957	1348	323
23862	Python_(programming_language)	201802	32	8	0	0	23	14	4	0	6009	2819	960	3980	1354	326
23862	Python_(programming_language)	201803	41	12	1	0	24	14	10	1	6050	2836	972	4004	1360	329
23862	Python_(programming_language)	201804	37	4	0	0	23	16	4	0	6087	2849	976	4031	1365	329
23862	Python_(programming_language)	201805	44	14	1	0	26	16	8	1	6131	2866	990	4060	1370	334
23862	Python_(programming_language)	201806	25	4	0	0	18	13	4	0	6156	2877	994	4080	1375	336
23862	Python_(programming_language)	201807	32	8	0	0	25	17	6	0	6188	2895	1002	4102	1386	339
38612235	QUIC	201303	10	0	0	0	5	3	0	0	10	5	0	7	3	0
38612235	QUIC	201304	10	0	0	0	4	3	0	0	20	9	0	12	6	0
38612235	QUIC	201305	1	0	0	0	1	1	0	0	21	10	0	13	7	0
38612235	QUIC	201306	4	0	0	0	4	4	0	0	25	14	0	17	11	0
38612235	QUIC	201307	11	0	0	0	6	4	0	0	36	18	0	26	13	0
38612235	QUIC	201308	19	0	0	0	7	6	0	0	55	23	0	42	17	0
38612235	QUIC	201309	3	0	0	0	2	2	0	0	58	25	0	45	19	0
38612235	QUIC	201310	1	0	0	0	1	1	0	0	59	25	0	46	19	0
38612235	QUIC	201311	1	0	0	0	1	1	0	0	60	25	0	47	19	0
38612235	QUIC	201312	3	0	0	0	3	1	0	0	63	28	0	48	20	0
38612235	QUIC	201401	1	0	0	0	1	1	0	0	64	29	0	49	21	0
38612235	QUIC	201402	1	0	0	0	1	1	0	0	65	30	0	50	22	0
38612235	QUIC	201403	5	0	0	0	3	1	0	0	70	33	0	51	23	0
38612235	QUIC	201404	1	0	0	0	1	1	0	0	71	33	0	52	23	0
38612235	QUIC	201405	2	0	0	0	2	0	0	0	73	35	0	52	23	0
38612235	QUIC	201406	1	0	0	0	1	0	0	0	74	36	0	52	23	0
38612235	QUIC	201407	2	0	0	0	2	1	0	0	76	38	0	53	24	0
38612235	QUIC	201408	1	0	0	0	1	0	0	0	77	39	0	53	24	0
38612235	QUIC	201409	3	0	0	0	2	1	0	0	80	41	0	55	25	0
38612235	QUIC	201501	1	0	0	0	1	1	0	0	81	42	0	56	26	0
38612235	QUIC	201503	1	0	0	0	1	0	0	0	82	43	0	56	26	0
38612235	QUIC	201504	2	0	0	0	1	1	0	0	84	44	0	58	27	0
38612235	QUIC	201505	4	1	0	0	3	0	1	0	88	47	1	58	27	0
38612235	QUIC	201506	3	1	0	0	3	1	1	0	91	49	2	59	27	0
38612235	QUIC	201508	16	0	0	0	7	3	0	0	107	55	2	62	29	0
38612235	QUIC	201509	3	0	0	0	1	1	0	0	110	56	2	65	30	0
38612235	QUIC	201512	2	0	0	0	1	1	0	0	112	57	2	67	31	0
38612235	QUIC	201601	1	0	0	0	1	0	0	0	113	58	2	67	31	0
38612235	QUIC	201602	2	0	0	0	1	1	0	0	115	58	2	69	31	0
38612235	QUIC	201604	3	1	0	0	3	1	1	0	118	61	3	70	32	0
38612235	QUIC	201605	3	0	0	0	3	2	0	0	121	63	3	72	33	0
38612235	QUIC	201606	2	1	0	0	2	2	1	0	123	65	4	74	35	1
38612235	QUIC	201607	2	0	0	0	1	0	0	0	125	66	4	74	35	1
38612235	QUIC	201608	5	0	0	0	4	3	0	0	130	69	4	77	37	1
38612235	QUIC	201610	2	0	0	0	2	2	0	0	132	70	4	79	37	1
38612235	QUIC	201611	5	0	0	0	3	3	0	0	137	72	4	84	39	1
38612235	QUIC	201612	1	0	0	0	1	1	0	0	138	73	4	85	40	1
38612235	QUIC	201701	2	1	0	0	2	2	1	0	140	75	5	87	42	2
38612235	QUIC	201702	1	0	0	0	1	0	0	0	141	76	5	87	42	2
38612235	QUIC	201705	4	1	0	0	4	2	1	0	145	78	6	89	43	2
38612235	QUIC	201706	2	0	0	0	2	2	0	0	147	80	6	91	45	2
38612235	QUIC	201707	1	0	0	0	1	1	0	0	148	81	6	92	46	2
38612235	QUIC	201708	4	0	0	0	1	1	0	0	152	82	6	96	47	2
38612235	QUIC	201709	1	0	0	0	1	1	0	0	153	83	6	97	48	2
38612235	QUIC	201710	2	0	0	0	2	2	0	0	155	84	6	99	49	2
38612235	QUIC	201711	4	0	0	0	3	3	0	0	159	87	6	103	52	2
38612235	QUIC	201712	4	0	0	0	3	2	0	0	163	90	6	106	54	2
38612235	QUIC	201801	6	0	0	0	6	3	0	0	169	95	6	109	56	2
38612235	QUIC	201802	5	1	0	0	4	4	1	0	174	98	7	114	59	3
38612235	QUIC	201803	2	0	0	0	2	1	0	0	176	99	7	115	59	3
38612235	QUIC	201804	4	0	0	0	4	3	0	0	180	102	7	118	61	3
38612235	QUIC	201805	1	0	0	0	1	1	0	0	181	103	7	119	62	3
38612235	QUIC	201806	5	0	0	0	3	2	0	0	186	106	7	122	64	3
38612235	QUIC	201807	2	0	0	0	2	2	0	0	188	107	7	124	65	3
5664561	Quagga_(software)	200607	3	0	0	0	2	2	0	0	3	2	0	3	2	0
5664561	Quagga_(software)	200608	1	0	0	0	1	0	0	0	4	3	0	3	2	0
5664561	Quagga_(software)	200609	1	0	0	0	1	1	0	0	5	4	0	4	3	0
5664561	Quagga_(software)	200611	1	0	0	0	1	1	0	0	6	5	0	5	4	0
5664561	Quagga_(software)	200612	2	0	0	0	2	0	0	0	8	7	0	5	4	0
5664561	Quagga_(software)	200701	3	0	0	0	3	1	0	0	11	10	0	6	5	0
5664561	Quagga_(software)	200702	2	0	0	0	2	1	0	0	13	12	0	7	6	0
5664561	Quagga_(software)	200704	1	0	0	0	1	0	0	0	14	13	0	7	6	0
5664561	Quagga_(software)	200705	7	2	0	0	4	3	2	0	21	16	2	13	8	1
5664561	Quagga_(software)	200708	2	0	0	0	2	1	0	0	23	18	2	14	9	1
5664561	Quagga_(software)	200709	2	0	0	0	1	0	0	0	25	19	2	14	9	1
5664561	Quagga_(software)	200712	4	0	0	0	3	1	0	0	29	22	2	15	10	1
5664561	Quagga_(software)	200801	1	0	0	0	1	1	0	0	30	23	2	16	11	1
5664561	Quagga_(software)	200802	1	0	0	0	1	1	0	0	31	24	2	17	12	1
5664561	Quagga_(software)	200803	1	0	0	0	1	1	0	0	32	25	2	18	13	1
5664561	Quagga_(software)	200806	1	0	0	0	1	1	0	0	33	26	2	19	14	1
5664561	Quagga_(software)	200808	1	0	0	0	1	1	0	0	34	27	2	20	15	1
5664561	Quagga_(software)	200809	1	0	0	0	1	1	0	0	35	28	2	21	16	1
5664561	Quagga_(software)	200810	1	0	0	0	1	1	0	0	36	29	2	22	17	1
5664561	Quagga_(software)	200811	1	0	0	0	1	1	0	0	37	30	2	23	18	1
5664561	Quagga_(software)	200812	2	0	0	0	2	1	0	0	39	32	2	24	19	1
5664561	Quagga_(software)	200902	3	0	0	0	2	1	0	0	42	34	2	25	20	1
5664561	Quagga_(software)	200905	1	0	0	0	1	0	0	0	43	35	2	25	20	1
5664561	Quagga_(software)	200906	3	0	0	0	3	1	0	0	46	38	2	26	21	1
5664561	Quagga_(software)	200910	1	0	0	0	1	0	0	0	47	39	2	26	21	1
5664561	Quagga_(software)	201002	1	0	0	0	1	1	0	0	48	40	2	27	22	1
5664561	Quagga_(software)	201003	1	0	0	0	1	1	0	0	49	41	2	28	23	1
5664561	Quagga_(software)	201004	2	0	0	0	2	2	0	0	51	42	2	30	24	1
5664561	Quagga_(software)	201006	1	0	0	0	1	1	0	0	52	43	2	31	25	1
5664561	Quagga_(software)	201007	2	0	0	0	2	2	0	0	54	45	2	33	27	1
5664561	Quagga_(software)	201009	3	0	0	0	1	0	0	0	57	46	2	33	27	1
5664561	Quagga_(software)	201010	3	0	0	0	2	1	0	0	60	48	2	35	28	1
5664561	Quagga_(software)	201012	4	0	0	0	4	1	0	0	64	52	2	36	29	1
5664561	Quagga_(software)	201102	1	0	0	0	1	1	0	0	65	53	2	37	30	1
5664561	Quagga_(software)	201104	1	0	0	0	1	1	0	0	66	54	2	38	31	1
5664561	Quagga_(software)	201106	2	0	0	0	1	0	0	0	68	55	2	38	31	1
5664561	Quagga_(software)	201107	1	0	0	0	1	1	0	0	69	56	2	39	32	1
5664561	Quagga_(software)	201202	1	0	0	0	1	1	0	0	70	57	2	40	33	1
5664561	Quagga_(software)	201204	2	0	0	0	2	2	0	0	72	59	2	42	35	1
5664561	Quagga_(software)	201205	3	0	0	0	3	2	0	0	75	62	2	44	37	1
5664561	Quagga_(software)	201207	2	0	0	0	2	2	0	0	77	63	2	46	38	1
5664561	Quagga_(software)	201208	1	0	0	0	1	1	0	0	78	64	2	47	39	1
5664561	Quagga_(software)	201209	1	0	0	0	1	1	0	0	79	65	2	48	40	1
5664561	Quagga_(software)	201210	3	0	0	0	2	2	0	0	82	67	2	51	42	1
5664561	Quagga_(software)	201211	1	0	0	0	1	0	0	0	83	68	2	51	42	1
5664561	Quagga_(software)	201301	1	0	0	0	1	1	0	0	84	69	2	52	43	1
5664561	Quagga_(software)	201302	1	0	0	0	1	1	0	0	85	70	2	53	43	1
5664561	Quagga_(software)	201307	2	0	0	0	2	2	0	0	87	72	2	55	45	1
5664561	Quagga_(software)	201408	2	0	0	0	2	2	0	0	89	74	2	57	47	1
5664561	Quagga_(software)	201409	1	0	0	0	1	0	0	0	90	75	2	57	47	1
5664561	Quagga_(software)	201501	1	0	0	0	1	0	0	0	91	75	2	57	47	1
5664561	Quagga_(software)	201502	1	0	0	0	1	1	0	0	92	76	2	58	48	1
5664561	Quagga_(software)	201503	2	0	0	0	1	0	0	0	94	77	2	58	48	1
5664561	Quagga_(software)	201504	1	0	0	0	1	1	0	0	95	78	2	59	49	1
5664561	Quagga_(software)	201505	1	0	0	0	1	0	0	0	96	79	2	59	49	1
5664561	Quagga_(software)	201506	1	0	0	0	1	1	0	0	97	80	2	60	49	1
5664561	Quagga_(software)	201511	3	0	0	0	3	2	0	0	100	83	2	62	51	1
5664561	Quagga_(software)	201605	1	0	0	0	1	0	0	0	101	84	2	62	51	1
5664561	Quagga_(software)	201610	1	0	0	0	1	0	0	0	102	85	2	62	51	1
5664561	Quagga_(software)	201708	1	0	0	0	1	1	0	0	103	86	2	63	52	1
5664561	Quagga_(software)	201806	3	0	0	0	2	2	0	0	106	88	2	66	54	1
25220	Quantum_computing	200111	1	0	0	0	1	1	0	0	1	1	0	1	1	0
25220	Quantum_computing	200112	1	0	0	0	1	1	0	0	2	2	0	2	2	0
25220	Quantum_computing	200201	9	0	0	0	4	4	0	0	11	6	0	11	6	0
25220	Quantum_computing	200202	9	0	0	0	1	1	0	0	20	6	0	20	6	0
25220	Quantum_computing	200205	2	0	0	0	2	2	0	0	22	6	0	22	6	0
25220	Quantum_computing	200206	1	0	0	0	1	0	0	0	23	7	0	22	6	0
25220	Quantum_computing	200210	4	0	0	0	2	2	0	0	27	7	0	26	6	0
25220	Quantum_computing	200212	2	0	0	0	2	1	0	0	29	8	0	27	6	0
25220	Quantum_computing	200303	5	0	0	0	5	1	0	0	34	12	0	28	6	0
25220	Quantum_computing	200304	7	0	0	0	6	3	0	0	41	18	0	31	9	0
25220	Quantum_computing	200305	3	0	0	0	3	3	0	0	44	21	0	34	12	0
25220	Quantum_computing	200306	1	0	0	0	1	0	0	0	45	22	0	34	12	0
25220	Quantum_computing	200307	5	0	0	0	4	4	0	0	50	26	0	39	16	0
25220	Quantum_computing	200308	1	0	0	0	1	0	0	0	51	27	0	39	16	0
25220	Quantum_computing	200309	1	0	0	0	1	0	0	0	52	28	0	39	16	0
25220	Quantum_computing	200310	1	0	0	0	1	0	0	0	53	29	0	39	16	0
25220	Quantum_computing	200311	5	0	0	0	4	2	0	0	58	33	0	42	18	0
25220	Quantum_computing	200312	2	0	0	0	2	1	0	0	60	35	0	43	19	0
25220	Quantum_computing	200401	6	0	0	0	6	3	0	0	66	41	0	46	22	0
25220	Quantum_computing	200402	7	0	0	0	7	3	0	0	73	47	0	49	25	0
25220	Quantum_computing	200403	8	0	0	0	5	3	0	0	81	52	0	52	28	0
25220	Quantum_computing	200404	18	2	0	0	10	9	2	0	99	60	2	65	35	0
25220	Quantum_computing	200405	7	0	0	0	5	1	0	0	106	65	2	66	36	0
25220	Quantum_computing	200406	8	0	0	0	3	3	0	0	114	68	2	74	39	0
25220	Quantum_computing	200407	64	0	0	0	13	8	0	0	178	79	2	132	45	0
25220	Quantum_computing	200408	23	0	0	0	12	8	0	0	201	89	2	148	51	0
25220	Quantum_computing	200409	12	1	0	0	10	8	1	0	213	98	3	158	58	0
25220	Quantum_computing	200410	18	0	0	0	8	5	0	0	231	104	3	172	61	0
25220	Quantum_computing	200411	9	0	0	0	6	4	0	0	240	110	3	179	65	0
25220	Quantum_computing	200412	12	0	0	0	10	4	0	0	252	119	3	184	68	0
25220	Quantum_computing	200501	8	0	0	0	7	6	0	0	260	123	3	191	71	0
25220	Quantum_computing	200502	6	0	0	0	5	4	0	0	266	127	3	196	74	0
25220	Quantum_computing	200503	8	0	0	0	7	4	0	0	274	134	3	201	78	0
25220	Quantum_computing	200504	9	1	0	0	3	2	1	0	283	136	4	203	79	0
25220	Quantum_computing	200505	7	0	0	0	5	2	0	0	290	141	4	205	81	0
25220	Quantum_computing	200506	10	1	0	0	7	5	1	0	300	147	5	211	85	0
25220	Quantum_computing	200507	10	0	0	0	7	4	0	0	310	154	5	215	89	0
25220	Quantum_computing	200508	12	1	0	0	9	6	1	0	322	162	6	224	94	1
25220	Quantum_computing	200509	21	3	0	0	15	7	3	0	343	175	9	237	99	1
25220	Quantum_computing	200510	14	1	0	0	12	6	1	0	357	184	10	245	102	1
25220	Quantum_computing	200511	23	6	0	0	17	4	4	0	380	198	16	251	103	1
25220	Quantum_computing	200512	14	3	0	0	12	7	2	0	394	209	19	259	109	1
25220	Quantum_computing	200601	18	2	0	0	17	9	2	0	412	222	21	269	115	1
25220	Quantum_computing	200602	18	1	0	0	15	11	1	0	430	235	22	281	124	2
25220	Quantum_computing	200603	15	4	0	0	13	7	3	0	445	246	26	290	129	2
25220	Quantum_computing	200604	8	0	0	0	8	5	0	0	453	254	26	295	134	2
25220	Quantum_computing	200605	38	3	0	0	23	16	3	0	491	275	29	323	148	2
25220	Quantum_computing	200606	30	2	0	0	9	4	2	0	521	282	31	347	150	2
25220	Quantum_computing	200607	13	1	0	0	11	7	1	0	534	290	32	355	154	3
25220	Quantum_computing	200608	24	1	0	0	17	10	1	0	558	306	33	368	163	3
25220	Quantum_computing	200609	9	0	0	0	7	4	0	0	567	312	33	372	166	3
25220	Quantum_computing	200610	19	2	0	0	15	7	2	0	586	326	35	379	172	4
25220	Quantum_computing	200611	23	2	0	0	21	12	2	0	609	344	37	393	181	4
25220	Quantum_computing	200612	14	2	0	0	14	7	2	0	623	355	39	400	185	4
25220	Quantum_computing	200701	26	5	0	0	18	11	5	0	649	372	44	415	195	8
25220	Quantum_computing	200702	17	3	0	0	16	10	3	0	666	387	47	425	204	9
25220	Quantum_computing	200703	77	15	0	0	50	29	11	0	743	434	62	470	230	11
25220	Quantum_computing	200704	30	4	0	0	23	10	4	0	773	453	66	483	236	11
25220	Quantum_computing	200705	57	5	0	0	31	15	4	0	830	477	71	515	245	11
25220	Quantum_computing	200706	31	2	0	0	21	8	2	0	861	494	73	527	250	11
25220	Quantum_computing	200707	16	1	0	0	14	8	1	0	877	506	74	536	256	11
25220	Quantum_computing	200708	27	4	0	0	16	7	3	0	904	522	78	550	263	11
25220	Quantum_computing	200709	10	1	0	0	10	3	1	0	914	531	79	553	266	12
25220	Quantum_computing	200710	20	2	0	0	17	8	2	0	934	547	81	563	273	13
25220	Quantum_computing	200711	14	0	0	0	10	4	0	0	948	556	81	569	276	13
25220	Quantum_computing	200712	31	3	0	0	25	8	3	0	979	581	84	578	284	13
25220	Quantum_computing	200801	25	6	0	0	18	6	4	0	1004	597	90	587	289	13
25220	Quantum_computing	200802	16	5	0	0	13	5	4	0	1020	609	95	593	293	13
25220	Quantum_computing	200803	20	5	0	0	18	10	5	0	1040	626	100	604	302	14
25220	Quantum_computing	200804	48	7	0	0	30	17	5	0	1088	653	107	630	316	14
25220	Quantum_computing	200805	25	6	0	0	16	10	6	0	1113	664	113	645	322	16
25220	Quantum_computing	200806	35	4	0	0	19	12	4	0	1148	678	117	671	329	17
25220	Quantum_computing	200807	29	4	0	0	20	9	4	0	1177	694	121	687	334	19
25220	Quantum_computing	200808	30	4	0	0	14	6	2	0	1207	707	125	701	339	20
25220	Quantum_computing	200809	12	4	0	0	9	3	3	0	1219	715	129	705	341	20
25220	Quantum_computing	200810	13	4	0	0	11	6	3	0	1232	725	133	712	346	20
25220	Quantum_computing	200811	24	2	0	0	13	9	1	0	1256	736	135	729	353	20
25220	Quantum_computing	200812	19	4	0	0	15	7	3	0	1275	751	139	738	360	21
25220	Quantum_computing	200901	14	0	0	0	12	8	0	0	1289	761	139	747	366	21
25220	Quantum_computing	200902	25	4	0	0	13	10	4	0	1314	769	143	769	371	23
25220	Quantum_computing	200903	13	5	2	1	10	4	4	2	1327	777	148	774	373	24
25220	Quantum_computing	200904	10	1	0	0	8	4	1	0	1337	782	149	779	374	24
25220	Quantum_computing	200905	24	1	0	0	10	6	1	0	1361	789	150	796	377	24
25220	Quantum_computing	200906	7	1	0	0	4	3	1	0	1368	792	151	799	379	24
25220	Quantum_computing	200907	8	2	0	0	6	3	2	0	1376	796	153	804	380	24
25220	Quantum_computing	200908	25	1	0	0	12	7	1	0	1401	805	154	823	384	24
25220	Quantum_computing	200909	18	1	0	0	11	6	1	0	1419	814	155	835	388	25
25220	Quantum_computing	200910	31	6	0	0	18	10	4	0	1450	827	161	857	393	25
25220	Quantum_computing	200911	13	3	0	0	10	7	2	0	1463	834	164	865	397	25
25220	Quantum_computing	200912	16	2	0	0	12	7	2	0	1479	843	166	875	401	25
25220	Quantum_computing	201001	8	2	0	0	8	4	2	0	1487	850	168	879	404	25
25220	Quantum_computing	201002	13	5	0	0	12	8	5	0	1500	860	173	888	410	27
25220	Quantum_computing	201003	9	2	0	0	9	4	2	0	1509	867	175	892	412	27
25220	Quantum_computing	201004	24	1	0	0	15	10	1	0	1533	878	176	904	418	27
25220	Quantum_computing	201005	10	2	0	0	6	4	2	0	1543	883	178	911	421	29
25220	Quantum_computing	201006	12	4	0	0	11	5	3	0	1555	893	182	917	425	30
25220	Quantum_computing	201007	7	1	0	0	7	3	1	0	1562	898	183	920	426	30
25220	Quantum_computing	201008	6	2	0	0	6	5	2	0	1568	903	185	925	430	31
25220	Quantum_computing	201009	4	1	0	0	4	2	1	0	1572	906	186	927	431	31
25220	Quantum_computing	201010	8	2	0	0	8	5	2	0	1580	909	188	932	431	31
25220	Quantum_computing	201011	11	2	0	0	8	5	2	0	1591	916	190	939	435	32
25220	Quantum_computing	201012	4	1	0	0	4	2	1	0	1595	919	191	941	436	32
25220	Quantum_computing	201101	10	0	0	0	3	3	0	0	1605	921	191	951	438	32
25220	Quantum_computing	201102	19	2	0	0	13	9	2	0	1624	929	193	964	442	33
25220	Quantum_computing	201103	8	2	0	0	7	5	1	0	1632	935	195	970	446	33
25220	Quantum_computing	201104	23	3	0	0	14	10	2	0	1655	944	198	988	451	34
25220	Quantum_computing	201105	22	2	0	0	16	10	2	0	1677	956	200	1002	457	35
25220	Quantum_computing	201106	29	2	0	0	17	13	2	0	1706	968	202	1025	466	36
25220	Quantum_computing	201107	10	3	0	0	6	3	3	0	1716	973	205	1030	468	37
25220	Quantum_computing	201108	3	1	0	0	3	1	1	0	1719	975	206	1031	468	37
25220	Quantum_computing	201109	12	3	0	0	10	5	3	0	1731	984	209	1036	472	38
25220	Quantum_computing	201110	9	1	0	0	7	4	1	0	1740	988	210	1042	473	38
25220	Quantum_computing	201111	13	1	0	0	6	4	1	0	1753	993	211	1053	476	38
25220	Quantum_computing	201112	17	1	0	0	11	6	1	0	1770	1004	212	1059	482	38
25220	Quantum_computing	201201	6	0	0	0	5	2	0	0	1776	1009	212	1062	484	38
25220	Quantum_computing	201202	12	2	0	0	12	7	2	0	1788	1020	214	1069	490	38
25220	Quantum_computing	201203	12	0	0	0	9	6	0	0	1800	1026	214	1077	493	38
25220	Quantum_computing	201204	9	2	0	0	8	5	2	0	1809	1032	216	1083	497	38
25220	Quantum_computing	201205	16	4	0	0	11	7	2	0	1825	1041	220	1095	502	39
25220	Quantum_computing	201206	5	0	0	0	5	5	0	0	1830	1045	220	1100	506	39
25220	Quantum_computing	201207	4	0	0	0	3	1	0	0	1834	1047	220	1101	507	39
25220	Quantum_computing	201208	18	2	0	0	12	11	2	0	1852	1055	222	1117	514	40
25220	Quantum_computing	201209	12	2	0	0	10	6	2	0	1864	1063	224	1124	518	40
25220	Quantum_computing	201210	10	3	0	0	8	5	3	0	1874	1069	227	1129	521	40
25220	Quantum_computing	201211	10	0	0	0	6	5	0	0	1884	1075	227	1137	526	40
25220	Quantum_computing	201212	9	2	0	0	4	2	2	0	1893	1077	229	1143	526	40
25220	Quantum_computing	201301	9	2	0	0	7	4	1	0	1902	1083	231	1148	529	40
25220	Quantum_computing	201302	17	2	0	0	14	8	2	0	1919	1094	233	1157	534	40
25220	Quantum_computing	201303	7	1	0	0	7	7	1	0	1926	1101	234	1164	541	41
25220	Quantum_computing	201304	11	4	1	0	8	5	3	1	1937	1108	238	1171	544	42
25220	Quantum_computing	201305	13	4	0	0	13	7	4	0	1950	1119	242	1178	549	42
25220	Quantum_computing	201306	25	2	0	0	17	9	2	0	1975	1133	244	1191	555	42
25220	Quantum_computing	201307	12	4	0	0	11	9	3	0	1987	1140	248	1201	559	44
25220	Quantum_computing	201308	10	3	0	0	8	4	2	0	1997	1147	251	1206	562	44
25220	Quantum_computing	201309	20	5	0	0	13	6	5	0	2017	1158	256	1218	566	45
25220	Quantum_computing	201310	9	4	0	0	7	4	3	0	2026	1164	260	1223	569	46
25220	Quantum_computing	201311	15	4	0	0	12	6	4	0	2041	1171	264	1229	571	46
25220	Quantum_computing	201312	5	1	0	0	5	2	1	0	2046	1175	265	1231	572	46
25220	Quantum_computing	201401	5	0	0	0	1	1	0	0	2051	1176	265	1236	573	46
25220	Quantum_computing	201402	20	2	0	0	11	7	2	0	2071	1186	267	1252	579	47
25220	Quantum_computing	201403	8	1	0	0	3	2	1	0	2079	1188	268	1259	580	47
25220	Quantum_computing	201404	11	2	0	0	9	5	2	0	2090	1195	270	1265	583	47
25220	Quantum_computing	201405	13	1	0	0	8	6	1	0	2103	1200	271	1273	586	47
25220	Quantum_computing	201406	11	7	4	2	6	3	4	3	2114	1205	278	1279	588	49
25220	Quantum_computing	201407	8	0	0	0	8	5	0	0	2122	1213	278	1284	593	49
25220	Quantum_computing	201408	4	0	0	0	3	1	0	0	2126	1215	278	1285	593	49
25220	Quantum_computing	201409	2	0	0	0	2	2	0	0	2128	1217	278	1287	595	49
25220	Quantum_computing	201410	13	4	0	0	11	7	3	0	2141	1226	282	1295	600	50
25220	Quantum_computing	201411	27	3	0	0	16	12	3	0	2168	1238	285	1314	608	50
25220	Quantum_computing	201412	15	3	0	0	13	7	3	0	2183	1247	288	1322	612	50
25220	Quantum_computing	201501	34	6	2	1	16	11	5	2	2217	1256	294	1348	615	55
25220	Quantum_computing	201502	11	4	0	0	10	5	3	0	2228	1264	298	1354	618	56
25220	Quantum_computing	201503	18	0	0	0	7	5	0	0	2246	1268	298	1370	620	56
25220	Quantum_computing	201504	13	3	0	0	12	7	3	0	2259	1276	301	1377	623	56
25220	Quantum_computing	201505	7	0	0	0	7	5	0	0	2266	1281	301	1382	626	56
25220	Quantum_computing	201506	9	0	0	0	7	4	0	0	2275	1286	301	1386	628	56
25220	Quantum_computing	201507	12	0	0	0	7	6	0	0	2287	1290	301	1395	631	56
25220	Quantum_computing	201508	21	4	0	0	13	8	2	0	2308	1300	305	1410	636	56
25220	Quantum_computing	201509	3	0	0	0	3	2	0	0	2311	1302	305	1412	637	56
25220	Quantum_computing	201510	9	1	0	0	6	6	1	0	2320	1307	306	1421	641	57
25220	Quantum_computing	201511	16	4	0	0	12	8	3	0	2336	1316	310	1431	644	59
25220	Quantum_computing	201512	23	2	0	0	13	8	2	0	2359	1325	312	1440	648	59
25220	Quantum_computing	201601	21	1	0	0	16	12	1	0	2380	1336	313	1456	655	60
25220	Quantum_computing	201602	19	2	0	0	14	10	2	0	2399	1347	315	1470	662	60
25220	Quantum_computing	201603	4	0	0	0	3	2	0	0	2403	1350	315	1472	664	60
25220	Quantum_computing	201604	5	0	0	0	5	4	0	0	2408	1354	315	1476	667	60
25220	Quantum_computing	201605	9	2	0	0	7	5	2	0	2417	1359	317	1483	669	61
25220	Quantum_computing	201606	10	0	0	0	9	6	0	0	2427	1366	317	1490	672	61
25220	Quantum_computing	201607	5	0	0	0	4	3	0	0	2432	1369	317	1494	674	61
25220	Quantum_computing	201608	20	3	0	0	13	10	2	0	2452	1377	320	1509	679	61
25220	Quantum_computing	201609	7	1	0	0	5	4	1	0	2459	1381	321	1515	682	61
25220	Quantum_computing	201610	4	0	0	0	4	3	0	0	2463	1385	321	1518	685	61
25220	Quantum_computing	201611	14	2	0	0	10	6	2	0	2477	1394	323	1528	690	62
25220	Quantum_computing	201612	17	0	0	0	12	10	0	0	2494	1403	323	1543	697	62
25220	Quantum_computing	201701	4	0	0	0	4	2	0	0	2498	1405	323	1545	697	62
25220	Quantum_computing	201702	8	0	0	0	5	5	0	0	2506	1409	323	1553	701	62
25220	Quantum_computing	201703	6	1	0	0	6	5	1	0	2512	1413	324	1558	704	62
25220	Quantum_computing	201704	8	1	0	0	5	4	1	0	2520	1417	325	1564	707	62
25220	Quantum_computing	201705	12	3	0	0	8	6	2	0	2532	1423	328	1571	711	62
25220	Quantum_computing	201706	11	1	0	0	8	5	1	0	2543	1429	329	1577	713	62
25220	Quantum_computing	201707	24	5	0	0	17	11	4	0	2567	1442	334	1594	720	62
25220	Quantum_computing	201708	15	1	0	0	9	7	1	0	2582	1447	335	1607	723	62
25220	Quantum_computing	201709	22	1	0	0	12	11	1	0	2604	1456	336	1625	731	63
25220	Quantum_computing	201710	38	1	0	0	15	13	1	0	2642	1466	337	1661	738	63
25220	Quantum_computing	201711	12	0	0	0	10	9	0	0	2654	1476	337	1672	746	63
25220	Quantum_computing	201712	11	0	0	0	9	7	0	0	2665	1483	337	1681	750	63
25220	Quantum_computing	201801	16	2	1	0	13	7	2	1	2681	1495	339	1690	756	65
25220	Quantum_computing	201802	13	3	0	0	10	5	2	0	2694	1502	342	1696	758	65
25220	Quantum_computing	201803	17	0	0	0	11	9	0	0	2711	1510	342	1711	763	65
25220	Quantum_computing	201804	23	4	0	0	20	11	4	0	2734	1527	346	1723	769	65
25220	Quantum_computing	201805	19	4	0	0	16	12	4	0	2753	1539	350	1736	777	66
25220	Quantum_computing	201806	20	2	0	0	15	13	2	0	2773	1550	352	1754	785	66
25220	Quantum_computing	201807	11	0	0	0	10	8	0	0	2784	1557	352	1763	790	66
2325953	Quantum_network	200510	3	0	0	0	1	1	0	0	3	1	0	3	1	0
2325953	Quantum_network	200512	3	0	0	0	3	2	0	0	6	4	0	5	3	0
2325953	Quantum_network	200603	1	0	0	0	1	0	0	0	7	5	0	5	3	0
2325953	Quantum_network	200609	2	0	0	0	2	2	0	0	9	7	0	7	5	0
2325953	Quantum_network	200610	2	0	0	0	2	2	0	0	11	9	0	9	7	0
2325953	Quantum_network	200701	1	0	0	0	1	0	0	0	12	10	0	9	7	0
2325953	Quantum_network	200711	1	0	0	0	1	0	0	0	13	11	0	9	7	0
2325953	Quantum_network	200802	1	0	0	0	1	1	0	0	14	12	0	10	8	0
2325953	Quantum_network	200803	1	0	0	0	1	0	0	0	15	13	0	10	8	0
2325953	Quantum_network	200804	1	0	0	0	1	1	0	0	16	14	0	11	9	0
2325953	Quantum_network	200806	3	0	0	0	1	1	0	0	19	15	0	14	10	0
2325953	Quantum_network	200809	1	0	0	0	1	1	0	0	20	16	0	15	11	0
2325953	Quantum_network	200911	2	0	0	0	2	2	0	0	22	18	0	17	13	0
2325953	Quantum_network	201003	1	0	0	0	1	1	0	0	23	19	0	18	14	0
2325953	Quantum_network	201007	1	0	0	0	1	1	0	0	24	20	0	19	15	0
2325953	Quantum_network	201009	1	0	0	0	1	1	0	0	25	21	0	20	16	0
2325953	Quantum_network	201106	1	0	0	0	1	1	0	0	26	22	0	21	17	0
2325953	Quantum_network	201202	1	0	0	0	1	1	0	0	27	23	0	22	18	0
2325953	Quantum_network	201301	3	0	0	0	2	2	0	0	30	25	0	25	20	0
2325953	Quantum_network	201302	1	0	0	0	1	1	0	0	31	26	0	26	21	0
2325953	Quantum_network	201305	1	0	0	0	1	1	0	0	32	26	0	27	21	0
2325953	Quantum_network	201310	3	0	0	0	2	2	0	0	35	28	0	30	23	0
2325953	Quantum_network	201411	3	1	0	0	3	2	1	0	38	31	1	32	25	0
2325953	Quantum_network	201412	3	1	0	0	2	0	1	0	41	33	2	32	25	0
2325953	Quantum_network	201501	3	0	0	0	2	2	0	0	44	35	2	35	27	0
2325953	Quantum_network	201502	1	0	0	0	1	1	0	0	45	36	2	36	28	0
2325953	Quantum_network	201503	1	0	0	0	1	1	0	0	46	37	2	37	29	0
2325953	Quantum_network	201505	1	0	0	0	1	1	0	0	47	38	2	38	30	0
2325953	Quantum_network	201506	3	0	0	0	2	1	0	0	50	39	2	40	30	0
2325953	Quantum_network	201507	3	0	0	0	2	1	0	0	53	40	2	42	30	0
2325953	Quantum_network	201509	2	0	0	0	2	1	0	0	55	42	2	43	31	0
2325953	Quantum_network	201602	2	0	0	0	1	1	0	0	57	42	2	45	31	0
2325953	Quantum_network	201603	1	0	0	0	1	1	0	0	58	42	2	46	31	0
2325953	Quantum_network	201604	2	0	0	0	1	0	0	0	60	43	2	46	31	0
2325953	Quantum_network	201607	1	0	0	0	1	0	0	0	61	44	2	46	31	0
2325953	Quantum_network	201608	1	0	0	0	1	0	0	0	62	45	2	46	31	0
2325953	Quantum_network	201610	1	0	0	0	1	1	0	0	63	46	2	47	32	0
2325953	Quantum_network	201612	1	0	0	0	1	0	0	0	64	47	2	47	32	0
2325953	Quantum_network	201701	3	0	0	0	2	2	0	0	67	49	2	50	34	0
2325953	Quantum_network	201702	3	0	0	0	2	2	0	0	70	50	2	53	35	0
2325953	Quantum_network	201704	1	0	0	0	1	0	0	0	71	51	2	53	35	0
2325953	Quantum_network	201708	2	0	0	0	2	1	0	0	73	52	2	54	35	0
2325953	Quantum_network	201710	1	0	0	0	1	1	0	0	74	53	2	55	36	0
2325953	Quantum_network	201711	13	0	0	0	4	4	0	0	87	57	2	68	39	0
2325953	Quantum_network	201801	9	0	0	0	6	3	0	0	96	62	2	74	41	0
2325953	Quantum_network	201802	2	0	0	0	2	1	0	0	98	64	2	75	42	0
2325953	Quantum_network	201803	8	0	0	0	6	5	0	0	106	68	2	82	45	0
2325953	Quantum_network	201804	5	0	0	0	2	1	0	0	111	70	2	86	46	0
2325953	Quantum_network	201805	2	0	0	0	2	2	0	0	113	71	2	88	47	0
2325953	Quantum_network	201806	4	0	0	0	2	2	0	0	117	73	2	92	49	0
15426942	Quantum_technology	200811	5	0	0	0	1	1	0	0	5	1	0	5	1	0
15426942	Quantum_technology	200902	1	0	0	0	1	1	0	0	6	2	0	6	2	0
15426942	Quantum_technology	201003	7	0	0	0	4	3	0	0	13	5	0	11	4	0
15426942	Quantum_technology	201007	2	1	0	0	2	1	1	0	15	7	1	12	5	0
15426942	Quantum_technology	201103	1	0	0	0	1	1	0	0	16	8	1	13	6	0
15426942	Quantum_technology	201112	1	0	0	0	1	0	0	0	17	9	1	13	6	0
15426942	Quantum_technology	201203	1	0	0	0	1	0	0	0	18	10	1	13	6	0
15426942	Quantum_technology	201205	1	0	0	0	1	0	0	0	19	11	1	13	6	0
15426942	Quantum_technology	201208	1	0	0	0	1	1	0	0	20	12	1	14	7	0
15426942	Quantum_technology	201209	1	0	0	0	1	1	0	0	21	13	1	15	8	0
15426942	Quantum_technology	201211	2	1	0	0	2	1	1	0	23	15	2	16	9	0
15426942	Quantum_technology	201301	2	0	0	0	1	1	0	0	25	16	2	18	10	0
15426942	Quantum_technology	201303	4	0	0	0	1	1	0	0	29	17	2	22	11	0
15426942	Quantum_technology	201404	1	0	0	0	1	1	0	0	30	18	2	23	12	0
15426942	Quantum_technology	201410	1	0	0	0	1	0	0	0	31	19	2	23	12	0
15426942	Quantum_technology	201503	1	0	0	0	1	1	0	0	32	20	2	24	13	0
15426942	Quantum_technology	201508	1	0	0	0	1	1	0	0	33	21	2	25	14	0
15426942	Quantum_technology	201509	2	0	0	0	2	2	0	0	35	23	2	27	16	0
15426942	Quantum_technology	201512	4	0	0	0	3	3	0	0	39	26	2	31	19	0
15426942	Quantum_technology	201601	1	0	0	0	1	1	0	0	40	27	2	32	20	0
15426942	Quantum_technology	201602	1	0	0	0	1	1	0	0	41	28	2	33	21	0
15426942	Quantum_technology	201603	3	0	0	0	2	0	0	0	44	30	2	33	21	0
15426942	Quantum_technology	201605	1	0	0	0	1	0	0	0	45	31	2	33	21	0
15426942	Quantum_technology	201607	4	0	0	0	2	2	0	0	49	33	2	37	23	0
15426942	Quantum_technology	201609	2	0	0	0	1	1	0	0	51	34	2	39	24	0
15426942	Quantum_technology	201611	1	0	0	0	1	1	0	0	52	35	2	40	25	0
15426942	Quantum_technology	201703	1	0	0	0	1	1	0	0	53	35	2	41	25	0
15426942	Quantum_technology	201704	6	1	0	0	6	4	1	0	59	41	3	45	29	0
15426942	Quantum_technology	201705	1	0	0	0	1	1	0	0	60	41	3	46	29	0
15426942	Quantum_technology	201709	2	0	0	0	2	0	0	0	62	43	3	46	29	0
15426942	Quantum_technology	201710	1	0	0	0	1	1	0	0	63	44	3	47	30	0
15426942	Quantum_technology	201711	2	0	0	0	1	0	0	0	65	45	3	47	30	0
15426942	Quantum_technology	201801	4	0	0	0	2	2	0	0	69	47	3	51	32	0
15426942	Quantum_technology	201802	3	0	0	0	3	3	0	0	72	49	3	54	34	0
15426942	Quantum_technology	201803	1	0	0	0	1	0	0	0	73	50	3	54	34	0
15426942	Quantum_technology	201804	1	0	0	0	1	1	0	0	74	51	3	55	35	0
15426942	Quantum_technology	201805	1	0	0	0	1	0	0	0	75	52	3	55	35	0
15426942	Quantum_technology	201806	2	0	0	0	2	2	0	0	77	53	3	57	36	0
191866	RADIUS	200306	5	0	0	0	1	0	0	0	5	1	0	0	0	0
191866	RADIUS	200307	1	0	0	0	1	1	0	0	6	2	0	1	1	0
191866	RADIUS	200310	1	0	0	0	1	0	0	0	7	3	0	1	1	0
191866	RADIUS	200311	1	0	0	0	1	0	0	0	8	4	0	1	1	0
191866	RADIUS	200403	3	0	0	0	2	1	0	0	11	6	0	3	2	0
191866	RADIUS	200405	2	0	0	0	2	1	0	0	13	8	0	4	3	0
191866	RADIUS	200406	4	0	0	0	3	0	0	0	17	11	0	4	3	0
191866	RADIUS	200408	2	0	0	0	2	1	0	0	19	13	0	5	4	0
191866	RADIUS	200409	4	0	0	0	4	2	0	0	23	17	0	7	6	0
191866	RADIUS	200410	2	0	0	0	2	1	0	0	25	19	0	8	7	0
191866	RADIUS	200411	9	0	0	0	6	3	0	0	34	25	0	11	10	0
191866	RADIUS	200412	26	0	0	0	12	3	0	0	60	36	0	15	13	0
191866	RADIUS	200501	2	0	0	0	2	1	0	0	62	38	0	16	14	0
191866	RADIUS	200502	4	1	0	0	3	2	1	0	66	41	1	18	16	0
191866	RADIUS	200503	1	0	0	0	1	0	0	0	67	42	1	18	16	0
191866	RADIUS	200504	3	0	0	0	3	2	0	0	70	45	1	20	18	0
191866	RADIUS	200505	56	33	15	6	18	8	12	7	126	60	34	47	25	15
191866	RADIUS	200506	11	4	0	0	9	5	3	0	137	65	38	54	27	17
191866	RADIUS	200507	10	2	0	0	7	4	1	0	147	67	40	61	28	18
191866	RADIUS	200508	6	1	0	0	4	2	1	0	153	69	41	65	29	18
191866	RADIUS	200509	3	0	0	0	2	0	0	0	156	70	41	65	29	18
191866	RADIUS	200510	7	1	0	0	5	2	1	0	163	75	42	67	31	18
191866	RADIUS	200511	2	0	0	0	2	1	0	0	165	77	42	68	32	18
191866	RADIUS	200512	3	1	0	0	3	1	1	0	168	78	43	69	32	18
191866	RADIUS	200601	3	0	0	0	2	1	0	0	171	80	43	71	33	18
191866	RADIUS	200602	3	0	0	0	3	1	0	0	174	83	43	72	34	18
191866	RADIUS	200603	2	1	0	0	2	2	1	0	176	85	44	74	36	19
191866	RADIUS	200604	5	0	0	0	3	3	0	0	181	88	44	79	39	19
191866	RADIUS	200605	10	1	0	0	7	2	1	0	191	94	45	82	40	19
191866	RADIUS	200606	10	0	0	0	3	2	0	0	201	97	45	85	42	19
191866	RADIUS	200607	7	0	0	0	6	2	0	0	208	103	45	88	44	19
191866	RADIUS	200608	11	4	0	0	8	5	4	0	219	110	49	93	48	20
191866	RADIUS	200609	6	0	0	0	5	3	0	0	225	114	49	96	50	20
191866	RADIUS	200610	6	1	0	0	6	3	1	0	231	120	50	99	53	21
191866	RADIUS	200611	2	0	0	0	2	0	0	0	233	122	50	99	53	21
191866	RADIUS	200612	7	2	0	0	7	3	2	0	240	129	52	102	56	21
191866	RADIUS	200701	12	4	0	0	10	4	4	0	252	138	56	107	59	21
191866	RADIUS	200702	9	2	0	0	8	2	2	0	261	144	58	109	60	21
191866	RADIUS	200703	8	2	0	0	7	2	2	0	269	149	60	111	61	21
191866	RADIUS	200704	1	0	0	0	1	1	0	0	270	150	60	112	62	21
191866	RADIUS	200705	18	5	0	0	14	7	4	0	288	161	65	122	66	22
191866	RADIUS	200706	10	0	0	0	5	2	0	0	298	166	65	129	68	22
191866	RADIUS	200707	5	0	0	0	4	4	0	0	303	168	65	134	70	22
191866	RADIUS	200708	7	1	0	0	7	2	1	0	310	174	66	136	71	22
191866	RADIUS	200709	3	1	0	0	3	1	1	0	313	176	67	137	72	22
191866	RADIUS	200710	1	0	0	0	1	1	0	0	314	177	67	138	73	22
191866	RADIUS	200711	3	1	0	0	3	2	1	0	317	179	68	140	74	22
191866	RADIUS	200712	9	2	0	0	7	4	1	0	326	185	70	145	77	22
191866	RADIUS	200801	10	0	0	0	8	5	0	0	336	192	70	151	81	22
191866	RADIUS	200802	10	1	0	0	7	2	1	0	346	198	71	153	82	22
191866	RADIUS	200803	9	2	0	0	9	5	2	0	355	207	73	158	87	22
191866	RADIUS	200804	8	2	0	0	6	2	2	0	363	212	75	160	88	23
191866	RADIUS	200805	5	0	0	0	5	3	0	0	368	216	75	163	90	23
191866	RADIUS	200806	11	0	0	0	7	3	0	0	379	223	75	169	93	23
191866	RADIUS	200807	7	1	0	0	6	3	1	0	386	228	76	172	96	23
191866	RADIUS	200808	5	2	0	0	4	3	2	0	391	231	78	176	98	24
191866	RADIUS	200809	5	0	0	0	3	1	0	0	396	234	78	179	99	24
191866	RADIUS	200810	5	1	0	0	4	0	1	0	401	238	79	179	99	24
191866	RADIUS	200811	13	1	0	0	10	4	1	0	414	247	80	184	102	24
191866	RADIUS	200812	12	2	0	0	11	6	2	0	426	256	82	190	106	25
191866	RADIUS	200901	9	2	0	0	9	3	2	0	435	264	84	193	108	25
191866	RADIUS	200902	8	2	0	0	8	4	2	0	443	272	86	197	112	25
191866	RADIUS	200903	2	0	0	0	1	0	0	0	445	273	86	197	112	25
191866	RADIUS	200904	8	2	0	0	7	2	2	0	453	280	88	199	114	25
191866	RADIUS	200905	96	0	0	0	9	6	0	0	549	287	88	278	118	25
191866	RADIUS	200906	10	1	0	0	9	6	1	0	559	294	89	284	122	25
191866	RADIUS	200907	2	0	0	0	2	1	0	0	561	296	89	285	123	25
191866	RADIUS	200908	7	1	0	0	7	4	1	0	568	302	90	289	126	25
191866	RADIUS	200909	34	7	0	0	14	7	5	0	602	315	97	310	132	27
191866	RADIUS	200910	2	0	0	0	2	1	0	0	604	317	97	311	133	27
191866	RADIUS	200911	5	2	0	0	5	1	2	0	609	321	99	312	133	27
191866	RADIUS	200912	6	1	0	0	5	3	1	0	615	326	100	316	136	27
191866	RADIUS	201001	5	2	0	0	5	3	2	0	620	330	102	319	138	28
191866	RADIUS	201002	11	1	0	0	4	2	1	0	631	334	103	324	140	28
191866	RADIUS	201003	3	0	0	0	3	2	0	0	634	336	103	326	141	28
191866	RADIUS	201004	7	2	0	0	5	2	2	0	641	340	105	329	142	28
191866	RADIUS	201005	1	0	0	0	1	1	0	0	642	340	105	330	142	28
191866	RADIUS	201006	12	0	0	0	7	1	0	0	654	347	105	331	143	28
191866	RADIUS	201007	6	1	0	0	5	4	1	0	660	352	106	335	147	28
191866	RADIUS	201008	6	2	0	0	6	2	2	0	666	357	108	337	148	28
191866	RADIUS	201009	9	1	0	0	6	2	1	0	675	363	109	339	150	28
191866	RADIUS	201010	3	0	0	0	2	1	0	0	678	365	109	341	151	28
191866	RADIUS	201011	2	0	0	0	2	1	0	0	680	367	109	342	152	28
191866	RADIUS	201012	2	0	0	0	1	0	0	0	682	368	109	342	152	28
191866	RADIUS	201101	4	1	0	0	2	1	1	0	686	370	110	343	153	28
191866	RADIUS	201102	3	1	0	0	3	1	1	0	689	373	111	344	154	28
191866	RADIUS	201104	3	0	0	0	1	1	0	0	692	374	111	347	155	28
191866	RADIUS	201105	3	0	0	0	3	2	0	0	695	376	111	349	156	28
191866	RADIUS	201106	7	1	0	0	5	1	1	0	702	381	112	350	157	28
191866	RADIUS	201107	4	2	0	0	3	2	2	0	706	384	114	352	159	29
191866	RADIUS	201108	6	1	0	0	3	2	1	0	712	387	115	357	161	29
191866	RADIUS	201109	5	0	0	0	4	2	0	0	717	391	115	359	163	29
191866	RADIUS	201110	3	0	0	0	2	0	0	0	720	393	115	359	163	29
191866	RADIUS	201111	1	0	0	0	1	1	0	0	721	394	115	360	164	29
191866	RADIUS	201112	3	0	0	0	1	0	0	0	724	395	115	360	164	29
191866	RADIUS	201203	4	2	0	0	3	1	1	0	728	398	117	362	165	29
191866	RADIUS	201204	4	1	0	0	4	3	1	0	732	400	118	365	166	29
191866	RADIUS	201205	1	0	0	0	1	1	0	0	733	401	118	366	167	29
191866	RADIUS	201207	9	2	0	0	7	4	2	0	742	408	120	372	171	29
191866	RADIUS	201208	2	0	0	0	1	0	0	0	744	409	120	372	171	29
191866	RADIUS	201209	4	0	0	0	2	1	0	0	748	411	120	373	172	29
191866	RADIUS	201210	4	1	0	0	2	1	1	0	752	413	121	374	173	30
191866	RADIUS	201211	2	0	0	0	2	1	0	0	754	414	121	375	173	30
191866	RADIUS	201301	3	0	0	0	2	1	0	0	757	416	121	376	174	30
191866	RADIUS	201302	6	1	0	0	4	1	1	0	763	419	122	377	174	30
191866	RADIUS	201303	5	1	0	0	5	4	1	0	768	421	123	381	175	30
191866	RADIUS	201304	8	0	0	0	3	1	0	0	776	424	123	382	176	30
191866	RADIUS	201306	2	0	0	0	2	1	0	0	778	425	123	383	176	30
191866	RADIUS	201307	6	0	0	0	5	0	0	0	784	430	123	383	176	30
191866	RADIUS	201309	3	1	0	0	3	1	1	0	787	433	124	384	177	30
191866	RADIUS	201310	15	4	0	0	11	7	4	0	802	443	128	391	182	30
191866	RADIUS	201311	2	1	0	0	2	0	1	0	804	445	129	391	182	30
191866	RADIUS	201312	6	1	0	0	5	3	1	0	810	450	130	394	185	30
191866	RADIUS	201402	2	0	0	0	1	1	0	0	812	451	130	396	186	30
191866	RADIUS	201403	2	0	0	0	2	0	0	0	814	453	130	396	186	30
191866	RADIUS	201404	2	1	0	0	2	1	1	0	816	454	131	397	186	30
191866	RADIUS	201405	2	1	0	0	2	1	1	0	818	456	132	398	187	30
191866	RADIUS	201406	1	0	0	0	1	0	0	0	819	457	132	398	187	30
191866	RADIUS	201407	2	1	0	0	2	1	1	0	821	459	133	399	188	30
191866	RADIUS	201410	3	1	0	0	3	2	1	0	824	461	134	401	189	30
191866	RADIUS	201411	4	2	0	0	4	2	2	0	828	464	136	403	190	30
191866	RADIUS	201501	7	0	0	0	4	1	0	0	835	468	136	405	191	30
191866	RADIUS	201502	1	0	0	0	1	0	0	0	836	469	136	405	191	30
191866	RADIUS	201503	1	0	0	0	1	1	0	0	837	470	136	406	192	30
191866	RADIUS	201504	5	1	0	0	3	1	1	0	842	473	137	407	193	30
191866	RADIUS	201505	4	0	0	0	4	2	0	0	846	476	137	409	195	30
191866	RADIUS	201506	4	0	0	0	2	2	0	0	850	478	137	413	197	30
191866	RADIUS	201507	1	0	0	0	1	1	0	0	851	479	137	414	198	30
191866	RADIUS	201508	3	0	0	0	2	1	0	0	854	481	137	416	199	30
191866	RADIUS	201509	1	0	0	0	1	0	0	0	855	482	137	416	199	30
191866	RADIUS	201510	1	0	0	0	1	1	0	0	856	483	137	417	200	30
191866	RADIUS	201511	1	0	0	0	1	1	0	0	857	484	137	418	201	30
191866	RADIUS	201604	2	0	0	0	2	1	0	0	859	486	137	419	202	30
191866	RADIUS	201605	1	0	0	0	1	1	0	0	860	486	137	420	202	30
191866	RADIUS	201606	8	1	0	0	4	4	1	0	868	489	138	428	205	31
191866	RADIUS	201609	1	0	0	0	1	1	0	0	869	490	138	429	206	31
191866	RADIUS	201610	1	0	0	0	1	1	0	0	870	491	138	430	207	31
191866	RADIUS	201611	2	0	0	0	2	2	0	0	872	493	138	432	209	31
191866	RADIUS	201612	4	1	0	0	4	2	1	0	876	497	139	434	211	31
191866	RADIUS	201702	1	0	0	0	1	1	0	0	877	498	139	435	212	31
191866	RADIUS	201704	2	0	0	0	1	0	0	0	879	499	139	435	212	31
191866	RADIUS	201705	2	0	0	0	1	1	0	0	881	500	139	437	213	31
191866	RADIUS	201706	1	0	0	0	1	1	0	0	882	501	139	438	214	31
191866	RADIUS	201707	1	0	0	0	1	1	0	0	883	501	139	439	214	31
191866	RADIUS	201708	1	0	0	0	1	1	0	0	884	502	139	440	215	31
191866	RADIUS	201709	2	1	0	0	2	1	1	0	886	504	140	441	216	31
191866	RADIUS	201710	3	0	0	0	1	1	0	0	889	505	140	444	217	31
191866	RADIUS	201711	6	1	0	0	5	2	1	0	895	509	141	447	218	31
191866	RADIUS	201802	2	1	0	0	2	1	1	0	897	510	142	448	218	31
191866	RADIUS	201804	5	0	0	0	3	3	0	0	902	512	142	453	220	31
191866	RADIUS	201805	1	0	0	0	1	1	0	0	903	513	142	454	221	31
191866	RADIUS	201806	4	0	0	0	4	2	0	0	907	515	142	456	221	31
43653496	RISC-V	201409	15	0	0	0	6	5	0	0	15	6	0	14	5	0
43653496	RISC-V	201410	43	0	0	0	11	9	0	0	58	15	0	55	12	0
43653496	RISC-V	201412	11	0	0	0	5	3	0	0	69	19	0	64	14	0
43653496	RISC-V	201501	19	0	0	0	5	5	0	0	88	23	0	83	18	0
43653496	RISC-V	201502	2	0	0	0	2	2	0	0	90	24	0	85	19	0
43653496	RISC-V	201503	9	0	0	0	4	3	0	0	99	26	0	93	20	0
43653496	RISC-V	201505	7	0	0	0	3	2	0	0	106	28	0	95	21	0
43653496	RISC-V	201506	7	0	0	0	2	2	0	0	113	30	0	102	23	0
43653496	RISC-V	201507	24	0	0	0	4	3	0	0	137	33	0	125	25	0
43653496	RISC-V	201508	14	0	0	0	4	3	0	0	151	37	0	138	27	0
43653496	RISC-V	201509	1	0	0	0	1	1	0	0	152	38	0	139	28	0
43653496	RISC-V	201510	3	0	0	0	2	2	0	0	155	40	0	142	30	0
43653496	RISC-V	201601	1	0	0	0	1	0	0	0	156	41	0	142	30	0
43653496	RISC-V	201602	1	0	0	0	1	0	0	0	157	42	0	142	30	0
43653496	RISC-V	201603	13	0	0	0	4	2	0	0	170	45	0	153	31	0
43653496	RISC-V	201604	6	0	0	0	4	2	0	0	176	48	0	157	32	0
43653496	RISC-V	201605	14	0	0	0	6	3	0	0	190	54	0	166	35	0
43653496	RISC-V	201606	1	0	0	0	1	1	0	0	191	55	0	167	36	0
43653496	RISC-V	201607	6	0	0	0	1	1	0	0	197	56	0	173	37	0
43653496	RISC-V	201608	16	0	0	0	8	5	0	0	213	60	0	185	39	0
43653496	RISC-V	201609	24	0	0	0	7	5	0	0	237	64	0	204	40	0
43653496	RISC-V	201610	1	0	0	0	1	1	0	0	238	64	0	205	40	0
43653496	RISC-V	201611	3	0	0	0	3	3	0	0	241	66	0	208	42	0
43653496	RISC-V	201612	99	0	0	0	7	7	0	0	340	70	0	307	46	0
43653496	RISC-V	201701	22	0	0	0	8	5	0	0	362	76	0	326	49	0
43653496	RISC-V	201702	29	0	0	0	11	5	0	0	391	84	0	344	51	0
43653496	RISC-V	201703	19	3	0	0	13	11	3	0	410	94	3	360	58	3
43653496	RISC-V	201704	11	0	0	0	6	5	0	0	421	99	3	370	62	3
43653496	RISC-V	201705	9	0	0	0	6	4	0	0	430	102	3	375	63	3
43653496	RISC-V	201706	13	0	0	0	7	5	0	0	443	109	3	385	67	3
43653496	RISC-V	201707	6	0	0	0	4	2	0	0	449	113	3	389	68	3
43653496	RISC-V	201708	9	0	0	0	8	6	0	0	458	118	3	396	71	3
43653496	RISC-V	201709	9	0	0	0	6	2	0	0	467	124	3	398	73	3
43653496	RISC-V	201710	7	0	0	0	4	4	0	0	474	127	3	405	74	3
43653496	RISC-V	201711	9	0	0	0	7	6	0	0	483	133	3	413	79	3
43653496	RISC-V	201712	7	0	0	0	6	3	0	0	490	137	3	417	81	3
43653496	RISC-V	201801	8	0	0	0	7	5	0	0	498	143	3	422	85	3
43653496	RISC-V	201802	37	2	0	0	18	14	1	0	535	155	5	453	94	4
43653496	RISC-V	201803	13	1	0	0	9	6	1	0	548	161	6	462	97	4
43653496	RISC-V	201804	10	0	0	0	6	4	0	0	558	166	6	467	100	4
43653496	RISC-V	201805	19	0	0	0	11	8	0	0	577	174	6	483	104	4
43653496	RISC-V	201806	5	0	0	0	3	2	0	0	582	176	6	487	105	4
43653496	RISC-V	201807	10	1	0	0	7	5	1	0	592	182	7	495	109	4
3616426	Radio_access_network	200606	2	0	0	0	2	2	0	0	2	2	0	2	2	0
3616426	Radio_access_network	200609	2	1	0	0	2	1	1	0	4	4	1	3	3	0
3616426	Radio_access_network	200610	1	0	0	0	1	1	0	0	5	5	1	4	4	0
3616426	Radio_access_network	200701	1	0	0	0	1	0	0	0	6	6	1	4	4	0
3616426	Radio_access_network	200710	1	0	0	0	1	1	0	0	7	7	1	5	5	0
3616426	Radio_access_network	200802	2	1	0	0	2	1	1	0	9	9	2	6	6	0
3616426	Radio_access_network	200804	2	0	0	0	2	2	0	0	11	11	2	8	8	0
3616426	Radio_access_network	200805	1	0	0	0	1	1	0	0	12	12	2	9	9	0
3616426	Radio_access_network	200812	1	0	0	0	1	1	0	0	13	13	2	10	10	0
3616426	Radio_access_network	200901	1	0	0	0	1	1	0	0	14	14	2	11	11	0
3616426	Radio_access_network	200908	1	0	0	0	1	1	0	0	15	15	2	12	12	0
3616426	Radio_access_network	200912	1	0	0	0	1	1	0	0	16	16	2	13	13	0
3616426	Radio_access_network	201005	1	0	0	0	1	1	0	0	17	17	2	14	14	0
3616426	Radio_access_network	201006	2	0	0	0	1	0	0	0	19	18	2	14	14	0
3616426	Radio_access_network	201007	2	1	0	0	2	2	1	0	21	20	3	16	16	1
3616426	Radio_access_network	201008	1	0	0	0	1	1	0	0	22	21	3	17	17	1
3616426	Radio_access_network	201012	1	0	0	0	1	1	0	0	23	22	3	18	18	1
3616426	Radio_access_network	201106	1	0	0	0	1	1	0	0	24	23	3	19	19	1
3616426	Radio_access_network	201110	2	0	0	0	1	0	0	0	26	24	3	19	19	1
3616426	Radio_access_network	201205	3	0	0	0	2	0	0	0	29	26	3	19	19	1
3616426	Radio_access_network	201206	1	0	0	0	1	0	0	0	30	27	3	19	19	1
3616426	Radio_access_network	201207	2	0	0	0	1	1	0	0	32	28	3	21	20	1
3616426	Radio_access_network	201210	1	0	0	0	1	1	0	0	33	29	3	22	21	1
3616426	Radio_access_network	201211	1	0	0	0	1	1	0	0	34	30	3	23	22	1
3616426	Radio_access_network	201212	1	0	0	0	1	1	0	0	35	31	3	24	23	1
3616426	Radio_access_network	201301	1	0	0	0	1	1	0	0	36	32	3	25	24	1
3616426	Radio_access_network	201303	1	0	0	0	1	0	0	0	37	33	3	25	24	1
3616426	Radio_access_network	201501	1	0	0	0	1	1	0	0	38	34	3	26	25	1
3616426	Radio_access_network	201507	2	1	0	0	2	1	1	0	40	36	4	27	26	1
3616426	Radio_access_network	201708	1	0	0	0	1	0	0	0	41	37	4	27	26	1
26163	Real-time_Transport_Protocol	200211	1	0	0	0	1	1	0	0	1	1	0	1	1	0
26163	Real-time_Transport_Protocol	200305	1	0	0	0	1	1	0	0	2	2	0	2	2	0
26163	Real-time_Transport_Protocol	200312	1	0	0	0	1	1	0	0	3	3	0	3	3	0
26163	Real-time_Transport_Protocol	200402	2	0	0	0	1	0	0	0	5	4	0	3	3	0
26163	Real-time_Transport_Protocol	200403	2	0	0	0	2	1	0	0	7	5	0	4	3	0
26163	Real-time_Transport_Protocol	200405	2	0	0	0	2	1	0	0	9	7	0	5	4	0
26163	Real-time_Transport_Protocol	200407	1	0	0	0	1	0	0	0	10	8	0	5	4	0
26163	Real-time_Transport_Protocol	200408	2	0	0	0	2	1	0	0	12	10	0	6	5	0
26163	Real-time_Transport_Protocol	200409	5	0	0	0	4	2	0	0	17	14	0	9	7	0
26163	Real-time_Transport_Protocol	200410	7	0	0	0	5	4	0	0	24	19	0	13	11	0
26163	Real-time_Transport_Protocol	200411	4	0	0	0	4	4	0	0	28	22	0	17	14	0
26163	Real-time_Transport_Protocol	200412	1	0	0	0	1	0	0	0	29	23	0	17	14	0
26163	Real-time_Transport_Protocol	200501	2	0	0	0	2	0	0	0	31	25	0	17	14	0
26163	Real-time_Transport_Protocol	200502	2	0	0	0	2	1	0	0	33	27	0	18	15	0
26163	Real-time_Transport_Protocol	200504	4	0	0	0	3	2	0	0	37	30	0	21	17	0
26163	Real-time_Transport_Protocol	200505	4	0	0	0	4	3	0	0	41	34	0	24	20	0
26163	Real-time_Transport_Protocol	200506	7	0	0	0	5	1	0	0	48	38	0	26	21	0
26163	Real-time_Transport_Protocol	200507	4	0	0	0	4	1	0	0	52	41	0	27	22	0
26163	Real-time_Transport_Protocol	200508	6	1	0	0	3	2	1	0	58	44	1	30	24	0
26163	Real-time_Transport_Protocol	200509	3	0	0	0	1	1	0	0	61	45	1	33	25	0
26163	Real-time_Transport_Protocol	200510	1	0	0	0	1	1	0	0	62	46	1	34	26	0
26163	Real-time_Transport_Protocol	200511	3	0	0	0	3	2	0	0	65	49	1	36	28	0
26163	Real-time_Transport_Protocol	200512	5	0	0	0	4	3	0	0	70	51	1	40	29	0
26163	Real-time_Transport_Protocol	200601	2	0	0	0	2	1	0	0	72	52	1	41	29	0
26163	Real-time_Transport_Protocol	200602	3	0	0	0	2	2	0	0	75	54	1	44	31	0
26163	Real-time_Transport_Protocol	200603	4	0	0	0	4	1	0	0	79	57	1	45	31	0
26163	Real-time_Transport_Protocol	200604	8	0	0	0	7	5	0	0	87	64	1	50	36	0
26163	Real-time_Transport_Protocol	200605	7	0	0	0	6	4	0	0	94	69	1	54	39	0
26163	Real-time_Transport_Protocol	200606	3	1	0	0	3	2	1	0	97	72	2	56	41	0
26163	Real-time_Transport_Protocol	200607	5	1	0	0	5	3	1	0	102	77	3	59	44	0
26163	Real-time_Transport_Protocol	200608	5	0	0	0	3	1	0	0	107	80	3	62	45	0
26163	Real-time_Transport_Protocol	200609	6	0	0	0	6	5	0	0	113	86	3	67	50	0
26163	Real-time_Transport_Protocol	200610	3	0	0	0	3	1	0	0	116	88	3	68	50	0
26163	Real-time_Transport_Protocol	200611	3	1	0	0	3	1	1	0	119	91	4	69	51	0
26163	Real-time_Transport_Protocol	200612	8	1	0	0	6	1	1	0	127	97	5	71	52	0
26163	Real-time_Transport_Protocol	200701	2	0	0	0	2	0	0	0	129	99	5	71	52	0
26163	Real-time_Transport_Protocol	200703	1	0	0	0	1	1	0	0	130	100	5	72	53	0
26163	Real-time_Transport_Protocol	200704	2	0	0	0	2	1	0	0	132	102	5	73	54	0
26163	Real-time_Transport_Protocol	200705	15	0	0	0	3	1	0	0	147	105	5	74	55	0
26163	Real-time_Transport_Protocol	200706	8	0	0	0	7	2	0	0	155	111	5	77	57	0
26163	Real-time_Transport_Protocol	200707	7	0	0	0	7	4	0	0	162	118	5	81	61	0
26163	Real-time_Transport_Protocol	200708	3	1	0	0	2	1	1	0	165	120	6	82	62	0
26163	Real-time_Transport_Protocol	200710	2	0	0	0	2	1	0	0	167	121	6	83	63	0
26163	Real-time_Transport_Protocol	200711	5	0	0	0	4	0	0	0	172	125	6	83	63	0
26163	Real-time_Transport_Protocol	200712	6	0	0	0	5	1	0	0	178	130	6	84	64	0
26163	Real-time_Transport_Protocol	200801	3	0	0	0	3	2	0	0	181	133	6	86	66	0
26163	Real-time_Transport_Protocol	200802	6	1	0	0	5	4	1	0	187	138	7	91	70	1
26163	Real-time_Transport_Protocol	200803	1	0	0	0	1	1	0	0	188	139	7	92	71	1
26163	Real-time_Transport_Protocol	200804	5	1	0	0	4	1	1	0	193	143	8	93	72	1
26163	Real-time_Transport_Protocol	200805	1	0	0	0	1	0	0	0	194	144	8	93	72	1
26163	Real-time_Transport_Protocol	200806	12	3	0	0	10	5	3	0	206	154	11	98	77	1
26163	Real-time_Transport_Protocol	200807	3	0	0	0	3	1	0	0	209	157	11	99	78	1
26163	Real-time_Transport_Protocol	200808	9	0	0	0	8	4	0	0	218	165	11	103	82	1
26163	Real-time_Transport_Protocol	200810	5	0	0	0	5	2	0	0	223	168	11	105	83	1
26163	Real-time_Transport_Protocol	200811	3	0	0	0	3	2	0	0	226	171	11	107	85	1
26163	Real-time_Transport_Protocol	200812	2	0	0	0	2	1	0	0	228	173	11	108	86	1
26163	Real-time_Transport_Protocol	200901	8	0	0	0	3	3	0	0	236	176	11	116	89	1
26163	Real-time_Transport_Protocol	200902	4	1	0	0	4	1	1	0	240	180	12	117	90	1
26163	Real-time_Transport_Protocol	200903	9	0	0	0	7	3	0	0	249	186	12	120	92	1
26163	Real-time_Transport_Protocol	200904	80	0	0	0	7	7	0	0	329	190	12	200	96	1
26163	Real-time_Transport_Protocol	200905	6	2	0	0	6	4	2	0	335	195	14	204	99	2
26163	Real-time_Transport_Protocol	200906	8	1	0	0	7	4	1	0	343	199	15	208	100	2
26163	Real-time_Transport_Protocol	200907	9	1	0	0	8	6	1	0	352	205	16	214	104	3
26163	Real-time_Transport_Protocol	200908	5	0	0	0	3	3	0	0	357	207	16	219	106	3
26163	Real-time_Transport_Protocol	200909	3	0	0	0	3	1	0	0	360	210	16	220	107	3
26163	Real-time_Transport_Protocol	200910	8	2	0	0	6	2	2	0	368	216	18	222	109	3
26163	Real-time_Transport_Protocol	200911	4	1	0	0	4	2	1	0	372	219	19	224	110	3
26163	Real-time_Transport_Protocol	200912	3	1	0	0	3	3	1	0	375	221	20	227	112	4
26163	Real-time_Transport_Protocol	201001	2	0	0	0	2	2	0	0	377	222	20	229	113	4
26163	Real-time_Transport_Protocol	201002	8	2	0	0	6	3	2	0	385	226	22	232	114	4
26163	Real-time_Transport_Protocol	201003	5	1	0	0	4	3	1	0	390	229	23	236	116	4
26163	Real-time_Transport_Protocol	201004	1	0	0	0	1	1	0	0	391	230	23	237	117	4
26163	Real-time_Transport_Protocol	201005	6	0	0	0	6	4	0	0	397	235	23	241	120	4
26163	Real-time_Transport_Protocol	201006	2	0	0	0	1	1	0	0	399	236	23	243	121	4
26163	Real-time_Transport_Protocol	201007	2	0	0	0	2	2	0	0	401	238	23	245	123	4
26163	Real-time_Transport_Protocol	201008	5	1	0	0	5	3	1	0	406	242	24	248	125	4
26163	Real-time_Transport_Protocol	201009	1	0	0	0	1	1	0	0	407	243	24	249	126	4
26163	Real-time_Transport_Protocol	201010	10	0	0	0	3	3	0	0	417	244	24	259	127	4
26163	Real-time_Transport_Protocol	201011	4	0	0	0	4	3	0	0	421	247	24	262	129	4
26163	Real-time_Transport_Protocol	201012	5	1	0	0	4	3	1	0	426	250	25	266	131	4
26163	Real-time_Transport_Protocol	201101	6	0	0	0	4	3	0	0	432	253	25	271	133	4
26163	Real-time_Transport_Protocol	201102	3	0	0	0	3	1	0	0	435	255	25	272	133	4
26163	Real-time_Transport_Protocol	201103	2	0	0	0	2	1	0	0	437	257	25	273	134	4
26163	Real-time_Transport_Protocol	201104	1	0	0	0	1	0	0	0	438	258	25	273	134	4
26163	Real-time_Transport_Protocol	201105	1	0	0	0	1	1	0	0	439	258	25	274	134	4
26163	Real-time_Transport_Protocol	201108	3	0	0	0	2	1	0	0	442	260	25	275	135	4
26163	Real-time_Transport_Protocol	201110	5	0	0	0	2	2	0	0	447	261	25	280	136	4
26163	Real-time_Transport_Protocol	201111	2	0	0	0	2	0	0	0	449	263	25	280	136	4
26163	Real-time_Transport_Protocol	201112	1	0	0	0	1	1	0	0	450	263	25	281	136	4
26163	Real-time_Transport_Protocol	201201	6	1	0	0	5	4	1	0	456	266	26	286	138	5
26163	Real-time_Transport_Protocol	201202	3	0	0	0	3	1	0	0	459	268	26	287	138	5
26163	Real-time_Transport_Protocol	201204	4	1	0	0	4	1	1	0	463	271	27	288	138	5
26163	Real-time_Transport_Protocol	201205	1	0	0	0	1	1	0	0	464	271	27	289	138	5
26163	Real-time_Transport_Protocol	201206	1	0	0	0	1	1	0	0	465	272	27	290	139	5
26163	Real-time_Transport_Protocol	201208	1	0	0	0	1	1	0	0	466	273	27	291	140	5
26163	Real-time_Transport_Protocol	201209	3	0	0	0	2	0	0	0	469	275	27	291	140	5
26163	Real-time_Transport_Protocol	201210	5	1	0	0	3	3	1	0	474	276	28	296	141	6
26163	Real-time_Transport_Protocol	201211	2	0	0	0	2	2	0	0	476	278	28	298	143	6
26163	Real-time_Transport_Protocol	201212	4	2	0	0	3	1	1	0	480	280	30	300	143	6
26163	Real-time_Transport_Protocol	201301	4	1	0	0	3	2	1	0	484	282	31	302	144	6
26163	Real-time_Transport_Protocol	201302	1	0	0	0	1	1	0	0	485	283	31	303	144	6
26163	Real-time_Transport_Protocol	201303	1	0	0	0	1	1	0	0	486	284	31	304	145	6
26163	Real-time_Transport_Protocol	201305	2	1	0	0	2	1	1	0	488	285	32	305	145	6
26163	Real-time_Transport_Protocol	201306	15	9	0	0	11	5	6	0	503	295	41	314	149	9
26163	Real-time_Transport_Protocol	201307	6	2	0	0	6	3	2	0	509	298	43	317	149	9
26163	Real-time_Transport_Protocol	201308	2	1	0	0	2	1	1	0	511	300	44	318	150	9
26163	Real-time_Transport_Protocol	201309	7	2	0	0	4	3	2	0	518	303	46	324	152	10
26163	Real-time_Transport_Protocol	201311	4	1	0	0	4	2	1	0	522	307	47	326	154	10
26163	Real-time_Transport_Protocol	201312	3	0	0	0	3	2	0	0	525	308	47	328	154	10
26163	Real-time_Transport_Protocol	201401	7	1	0	0	4	3	1	0	532	310	48	334	155	10
26163	Real-time_Transport_Protocol	201402	1	0	0	0	1	1	0	0	533	310	48	335	155	10
26163	Real-time_Transport_Protocol	201403	7	0	0	0	5	1	0	0	540	314	48	336	155	10
26163	Real-time_Transport_Protocol	201404	2	1	0	0	2	1	1	0	542	316	49	337	156	10
26163	Real-time_Transport_Protocol	201405	1	0	0	0	1	0	0	0	543	317	49	337	156	10
26163	Real-time_Transport_Protocol	201406	1	0	0	0	1	1	0	0	544	317	49	338	156	10
26163	Real-time_Transport_Protocol	201407	2	0	0	0	1	1	0	0	546	318	49	340	156	10
26163	Real-time_Transport_Protocol	201409	4	0	0	0	2	2	0	0	550	319	49	344	157	10
26163	Real-time_Transport_Protocol	201410	1	0	0	0	1	1	0	0	551	319	49	345	157	10
26163	Real-time_Transport_Protocol	201412	2	0	0	0	2	1	0	0	553	321	49	346	158	10
26163	Real-time_Transport_Protocol	201501	4	1	0	0	3	1	1	0	557	323	50	347	158	10
26163	Real-time_Transport_Protocol	201502	1	0	0	0	1	1	0	0	558	324	50	348	159	10
26163	Real-time_Transport_Protocol	201503	7	0	0	0	6	4	0	0	565	329	50	352	161	10
26163	Real-time_Transport_Protocol	201504	3	0	0	0	2	1	0	0	568	331	50	353	162	10
26163	Real-time_Transport_Protocol	201507	3	1	0	0	2	1	1	0	571	332	51	354	162	10
26163	Real-time_Transport_Protocol	201508	4	0	0	0	3	2	0	0	575	334	51	357	163	10
26163	Real-time_Transport_Protocol	201509	11	2	0	0	3	3	2	0	586	336	53	368	165	11
26163	Real-time_Transport_Protocol	201510	2	0	0	0	2	2	0	0	588	337	53	370	166	11
26163	Real-time_Transport_Protocol	201511	1	0	0	0	1	1	0	0	589	338	53	371	167	11
26163	Real-time_Transport_Protocol	201512	5	1	0	0	5	4	1	0	594	343	54	375	171	12
26163	Real-time_Transport_Protocol	201601	3	0	0	0	3	3	0	0	597	345	54	378	173	12
26163	Real-time_Transport_Protocol	201602	8	2	0	0	6	3	1	0	605	349	56	382	174	12
26163	Real-time_Transport_Protocol	201603	2	0	0	0	2	2	0	0	607	350	56	384	175	12
26163	Real-time_Transport_Protocol	201606	5	2	0	0	4	4	2	0	612	352	58	389	177	14
26163	Real-time_Transport_Protocol	201607	2	1	0	0	2	1	1	0	614	353	59	390	177	14
26163	Real-time_Transport_Protocol	201611	3	0	0	0	3	2	0	0	617	355	59	392	178	14
26163	Real-time_Transport_Protocol	201612	3	0	0	0	2	1	0	0	620	357	59	393	179	14
26163	Real-time_Transport_Protocol	201703	3	0	0	0	1	1	0	0	623	358	59	396	180	14
26163	Real-time_Transport_Protocol	201707	3	0	0	0	2	2	0	0	626	359	59	399	181	14
26163	Real-time_Transport_Protocol	201708	1	0	0	0	1	1	0	0	627	360	59	400	182	14
26163	Real-time_Transport_Protocol	201709	3	0	0	0	3	2	0	0	630	363	59	402	182	14
26163	Real-time_Transport_Protocol	201710	2	0	0	0	2	2	0	0	632	364	59	404	183	14
26163	Real-time_Transport_Protocol	201711	1	0	0	0	1	1	0	0	633	364	59	405	183	14
26163	Real-time_Transport_Protocol	201712	2	0	0	0	2	2	0	0	635	365	59	407	184	14
26163	Real-time_Transport_Protocol	201801	1	0	0	0	1	1	0	0	636	365	59	408	184	14
26163	Real-time_Transport_Protocol	201802	2	0	0	0	2	2	0	0	638	366	59	410	185	14
26163	Real-time_Transport_Protocol	201803	2	0	0	0	2	1	0	0	640	368	59	411	186	14
26163	Real-time_Transport_Protocol	201804	1	0	0	0	1	1	0	0	641	368	59	412	186	14
26163	Real-time_Transport_Protocol	201805	5	1	0	0	5	4	1	0	646	372	60	416	188	14
26163	Real-time_Transport_Protocol	201807	1	0	0	0	1	1	0	0	647	372	60	417	188	14
4169615	Real-time_data	200610	2	0	0	0	1	1	0	0	2	1	0	2	1	0
4169615	Real-time_data	200611	2	0	0	0	2	2	0	0	4	3	0	4	3	0
4169615	Real-time_data	200612	1	0	0	0	1	1	0	0	5	4	0	5	4	0
4169615	Real-time_data	200701	1	0	0	0	1	1	0	0	6	5	0	6	5	0
4169615	Real-time_data	200702	1	0	0	0	1	1	0	0	7	6	0	7	6	0
4169615	Real-time_data	200704	1	0	0	0	1	1	0	0	8	6	0	8	6	0
4169615	Real-time_data	200705	1	0	0	0	1	1	0	0	9	6	0	9	6	0
4169615	Real-time_data	200807	5	1	0	0	3	1	1	0	14	9	1	10	7	0
4169615	Real-time_data	200902	1	0	0	0	1	1	0	0	15	10	1	11	8	0
4169615	Real-time_data	200903	1	0	0	0	1	1	0	0	16	11	1	12	9	0
4169615	Real-time_data	200908	9	0	0	0	1	1	0	0	25	12	1	21	10	0
4169615	Real-time_data	201007	2	0	0	0	1	1	0	0	27	13	1	23	11	0
4169615	Real-time_data	201109	2	0	0	0	1	0	0	0	29	14	1	23	11	0
4169615	Real-time_data	201209	4	2	0	0	4	2	2	0	33	18	3	25	13	0
4169615	Real-time_data	201307	4	1	0	0	3	1	1	0	37	21	4	26	14	0
4169615	Real-time_data	201309	2	0	0	0	1	0	0	0	39	22	4	26	14	0
4169615	Real-time_data	201312	6	1	0	0	2	1	1	0	45	24	5	27	15	0
4169615	Real-time_data	201402	13	5	0	0	4	3	3	0	58	27	10	32	17	0
4169615	Real-time_data	201409	1	0	0	0	1	1	0	0	59	28	10	33	18	0
4169615	Real-time_data	201506	2	1	0	0	2	1	1	0	61	30	11	34	19	0
4169615	Real-time_data	201512	1	0	0	0	1	1	0	0	62	31	11	35	20	0
4169615	Real-time_data	201602	1	0	0	0	1	0	0	0	63	32	11	35	20	0
4169615	Real-time_data	201604	4	2	0	0	4	2	2	0	67	36	13	37	22	0
4169615	Real-time_data	201709	1	0	0	0	1	1	0	0	68	37	13	38	23	0
4169615	Real-time_data	201710	2	1	0	0	2	1	1	0	70	38	14	39	23	0
4169615	Real-time_data	201711	2	1	0	0	2	1	1	0	72	39	15	40	23	0
4169615	Real-time_data	201802	4	2	0	0	3	3	2	0	76	41	17	44	25	2
4169615	Real-time_data	201803	2	0	0	0	1	1	0	0	78	42	17	46	26	2
4169615	Real-time_data	201804	1	0	0	0	1	1	0	0	79	43	17	47	27	2
4169615	Real-time_data	201805	1	0	0	0	1	1	0	0	80	44	17	48	28	2
596646	Recommender_system	200403	1	0	0	0	1	1	0	0	1	1	0	1	1	0
596646	Recommender_system	200404	1	0	0	0	1	1	0	0	2	2	0	2	2	0
596646	Recommender_system	200405	16	0	0	0	3	3	0	0	18	5	0	18	5	0
596646	Recommender_system	200406	1	0	0	0	1	1	0	0	19	6	0	19	6	0
596646	Recommender_system	200407	5	0	0	0	3	2	0	0	24	9	0	23	8	0
596646	Recommender_system	200408	1	0	0	0	1	0	0	0	25	10	0	23	8	0
596646	Recommender_system	200410	1	0	0	0	1	1	0	0	26	11	0	24	9	0
596646	Recommender_system	200411	1	0	0	0	1	0	0	0	27	12	0	24	9	0
596646	Recommender_system	200412	1	0	0	0	1	1	0	0	28	13	0	25	10	0
596646	Recommender_system	200501	2	0	0	0	2	2	0	0	30	14	0	27	11	0
596646	Recommender_system	200502	2	0	0	0	2	1	0	0	32	16	0	28	12	0
596646	Recommender_system	200503	1	0	0	0	1	1	0	0	33	17	0	29	13	0
596646	Recommender_system	200505	9	0	0	0	3	2	0	0	42	20	0	34	15	0
596646	Recommender_system	200506	1	0	0	0	1	1	0	0	43	21	0	35	16	0
596646	Recommender_system	200508	2	0	0	0	2	1	0	0	45	22	0	36	16	0
596646	Recommender_system	200510	2	0	0	0	2	1	0	0	47	24	0	37	17	0
596646	Recommender_system	200511	2	0	0	0	2	2	0	0	49	26	0	39	19	0
596646	Recommender_system	200512	1	0	0	0	1	0	0	0	50	27	0	39	19	0
596646	Recommender_system	200601	6	0	0	0	5	3	0	0	56	32	0	43	22	0
596646	Recommender_system	200604	2	0	0	0	1	1	0	0	58	33	0	45	23	0
596646	Recommender_system	200606	1	0	0	0	1	1	0	0	59	34	0	46	24	0
596646	Recommender_system	200607	5	0	0	0	3	2	0	0	64	37	0	48	26	0
596646	Recommender_system	200609	3	0	0	0	3	2	0	0	67	39	0	50	27	0
596646	Recommender_system	200610	2	0	0	0	1	0	0	0	69	40	0	50	27	0
596646	Recommender_system	200611	10	0	0	0	6	1	0	0	79	45	0	54	27	0
596646	Recommender_system	200612	5	1	0	0	5	3	1	0	84	49	1	57	29	0
596646	Recommender_system	200701	1	0	0	0	1	1	0	0	85	50	1	58	30	0
596646	Recommender_system	200702	4	0	0	0	3	2	0	0	89	53	1	60	32	0
596646	Recommender_system	200703	2	0	0	0	2	2	0	0	91	55	1	62	34	0
596646	Recommender_system	200704	3	1	0	0	3	1	1	0	94	58	2	63	35	0
596646	Recommender_system	200705	7	0	0	0	3	2	0	0	101	61	2	69	37	0
596646	Recommender_system	200706	3	0	0	0	2	1	0	0	104	63	2	70	38	0
596646	Recommender_system	200707	1	0	0	0	1	0	0	0	105	64	2	70	38	0
596646	Recommender_system	200708	5	0	0	0	2	2	0	0	110	66	2	75	40	0
596646	Recommender_system	200709	5	1	0	0	4	2	1	0	115	70	3	77	42	0
596646	Recommender_system	200710	10	0	0	0	6	3	0	0	125	76	3	83	45	0
596646	Recommender_system	200711	15	0	0	0	5	3	0	0	140	80	3	95	47	0
596646	Recommender_system	200712	11	0	0	0	4	2	0	0	151	81	3	104	47	0
596646	Recommender_system	200801	5	0	0	0	4	2	0	0	156	84	3	106	48	0
596646	Recommender_system	200802	8	0	0	0	6	3	0	0	164	90	3	109	51	0
596646	Recommender_system	200803	10	0	0	0	7	4	0	0	174	97	3	115	55	0
596646	Recommender_system	200804	25	1	0	0	8	4	1	0	199	105	4	126	59	0
596646	Recommender_system	200805	7	0	0	0	5	5	0	0	206	109	4	133	63	0
596646	Recommender_system	200806	11	0	0	0	8	5	0	0	217	114	4	141	66	0
596646	Recommender_system	200807	7	0	0	0	5	3	0	0	224	118	4	146	68	0
596646	Recommender_system	200808	8	0	0	0	6	3	0	0	232	124	4	150	71	0
596646	Recommender_system	200809	12	0	0	0	10	6	0	0	244	131	4	156	75	0
596646	Recommender_system	200810	6	0	0	0	5	0	0	0	250	136	4	156	75	0
596646	Recommender_system	200811	16	3	0	0	6	4	1	0	266	142	7	170	79	1
596646	Recommender_system	200812	7	2	0	0	5	4	1	0	273	145	9	176	81	2
596646	Recommender_system	200901	14	1	0	0	7	4	1	0	287	151	10	187	84	2
596646	Recommender_system	200902	10	0	0	0	5	3	0	0	297	154	10	195	85	2
596646	Recommender_system	200903	15	3	0	0	9	6	1	0	312	159	13	204	89	3
596646	Recommender_system	200904	4	0	0	0	4	1	0	0	316	163	13	205	90	3
596646	Recommender_system	200905	19	3	0	0	8	6	1	0	335	168	16	222	93	5
596646	Recommender_system	200906	12	1	0	0	11	6	1	0	347	178	17	229	98	6
596646	Recommender_system	200907	5	0	0	0	5	5	0	0	352	182	17	234	102	6
596646	Recommender_system	200908	3	1	0	0	3	1	1	0	355	184	18	235	102	6
596646	Recommender_system	200909	6	3	1	0	4	3	3	1	361	187	21	240	104	9
596646	Recommender_system	200910	3	0	0	0	2	1	0	0	364	189	21	242	105	9
596646	Recommender_system	200911	9	1	0	0	4	0	1	0	373	193	22	242	105	9
596646	Recommender_system	200912	3	1	0	0	3	0	1	0	376	196	23	242	105	9
596646	Recommender_system	201001	5	0	0	0	3	1	0	0	381	199	23	243	106	9
596646	Recommender_system	201002	4	0	0	0	2	1	0	0	385	201	23	244	107	9
596646	Recommender_system	201003	2	0	0	0	2	1	0	0	387	203	23	245	108	9
596646	Recommender_system	201004	24	2	0	0	9	6	2	0	411	212	25	264	114	9
596646	Recommender_system	201005	20	1	0	0	9	5	1	0	431	218	26	276	117	10
596646	Recommender_system	201006	18	0	0	0	7	2	0	0	449	224	26	278	118	10
596646	Recommender_system	201007	9	1	0	0	7	5	1	0	458	229	27	284	121	10
596646	Recommender_system	201008	5	0	0	0	5	3	0	0	463	234	27	287	124	10
596646	Recommender_system	201009	11	0	0	0	5	3	0	0	474	239	27	294	127	10
596646	Recommender_system	201010	14	0	0	0	5	2	0	0	488	242	27	297	128	10
596646	Recommender_system	201011	21	1	0	0	12	3	1	0	509	252	28	302	130	10
596646	Recommender_system	201012	6	1	0	0	5	4	1	0	515	257	29	307	134	10
596646	Recommender_system	201101	3	0	0	0	3	2	0	0	518	258	29	309	134	10
596646	Recommender_system	201102	7	0	0	0	5	1	0	0	525	263	29	310	135	10
596646	Recommender_system	201103	10	0	0	0	7	2	0	0	535	269	29	312	136	10
596646	Recommender_system	201104	5	0	0	0	5	3	0	0	540	272	29	315	138	10
596646	Recommender_system	201105	6	0	0	0	3	3	0	0	546	273	29	321	139	10
596646	Recommender_system	201106	2	0	0	0	2	2	0	0	548	275	29	323	141	10
596646	Recommender_system	201107	10	1	0	0	5	4	1	0	558	279	30	331	144	11
596646	Recommender_system	201108	2	0	0	0	1	0	0	0	560	280	30	331	144	11
596646	Recommender_system	201109	3	1	0	0	3	2	1	0	563	283	31	333	146	12
596646	Recommender_system	201110	1	0	0	0	1	1	0	0	564	284	31	334	147	12
596646	Recommender_system	201111	1	0	0	0	1	1	0	0	565	285	31	335	148	12
596646	Recommender_system	201112	18	1	0	0	9	6	1	0	583	292	32	350	152	13
596646	Recommender_system	201201	5	0	0	0	4	2	0	0	588	296	32	353	154	13
596646	Recommender_system	201202	10	0	0	0	8	5	0	0	598	303	32	360	158	13
596646	Recommender_system	201203	2	0	0	0	2	0	0	0	600	305	32	360	158	13
596646	Recommender_system	201204	1	0	0	0	1	1	0	0	601	306	32	361	159	13
596646	Recommender_system	201205	5	0	0	0	5	2	0	0	606	311	32	363	161	13
596646	Recommender_system	201206	4	0	0	0	3	2	0	0	610	314	32	366	163	13
596646	Recommender_system	201207	4	0	0	0	4	4	0	0	614	318	32	370	167	13
596646	Recommender_system	201208	2	0	0	0	2	0	0	0	616	320	32	370	167	13
596646	Recommender_system	201209	12	0	0	0	4	3	0	0	628	324	32	381	170	13
596646	Recommender_system	201210	3	0	0	0	2	2	0	0	631	326	32	384	172	13
596646	Recommender_system	201211	9	0	0	0	3	2	0	0	640	329	32	389	174	13
596646	Recommender_system	201212	7	0	0	0	4	2	0	0	647	332	32	392	175	13
596646	Recommender_system	201301	12	0	0	0	4	4	0	0	659	335	32	404	178	13
596646	Recommender_system	201302	4	0	0	0	4	1	0	0	663	339	32	405	179	13
596646	Recommender_system	201303	3	0	0	0	3	2	0	0	666	342	32	407	181	13
596646	Recommender_system	201304	14	0	0	0	8	4	0	0	680	349	32	411	184	13
596646	Recommender_system	201305	3	0	0	0	1	1	0	0	683	350	32	414	185	13
596646	Recommender_system	201306	12	0	0	0	5	3	0	0	695	353	32	418	186	13
596646	Recommender_system	201307	1	0	0	0	1	1	0	0	696	354	32	419	187	13
596646	Recommender_system	201308	2	0	0	0	1	0	0	0	698	355	32	419	187	13
596646	Recommender_system	201309	1	0	0	0	1	1	0	0	699	356	32	420	188	13
596646	Recommender_system	201310	1	0	0	0	1	1	0	0	700	357	32	421	189	13
596646	Recommender_system	201311	10	0	0	0	2	2	0	0	710	358	32	431	190	13
596646	Recommender_system	201312	4	0	0	0	3	3	0	0	714	359	32	435	191	13
596646	Recommender_system	201401	11	0	0	0	6	4	0	0	725	362	32	444	192	13
596646	Recommender_system	201402	11	2	1	0	7	4	2	1	736	369	34	451	195	14
596646	Recommender_system	201403	11	0	0	0	7	5	0	0	747	373	34	458	197	14
596646	Recommender_system	201404	3	0	0	0	3	1	0	0	750	376	34	459	198	14
596646	Recommender_system	201405	4	0	0	0	4	3	0	0	754	379	34	462	200	14
596646	Recommender_system	201406	10	0	0	0	7	7	0	0	764	385	34	472	206	14
596646	Recommender_system	201407	4	0	0	0	1	1	0	0	768	386	34	476	207	14
596646	Recommender_system	201408	14	0	0	0	7	5	0	0	782	390	34	483	209	14
596646	Recommender_system	201409	8	1	0	0	6	4	1	0	790	394	35	489	211	14
596646	Recommender_system	201410	1	0	0	0	1	1	0	0	791	395	35	490	212	14
596646	Recommender_system	201411	1	0	0	0	1	0	0	0	792	396	35	490	212	14
596646	Recommender_system	201412	1	0	0	0	1	1	0	0	793	397	35	491	213	14
596646	Recommender_system	201502	2	0	0	0	2	1	0	0	795	399	35	492	214	14
596646	Recommender_system	201503	4	1	0	0	4	3	1	0	799	403	36	495	217	15
596646	Recommender_system	201504	2	0	0	0	2	1	0	0	801	405	36	496	218	15
596646	Recommender_system	201505	1	0	0	0	1	1	0	0	802	406	36	497	219	15
596646	Recommender_system	201506	2	0	0	0	2	1	0	0	804	408	36	498	220	15
596646	Recommender_system	201507	8	0	0	0	5	4	0	0	812	412	36	503	223	15
596646	Recommender_system	201508	1	0	0	0	1	1	0	0	813	412	36	504	223	15
596646	Recommender_system	201509	7	1	0	0	5	2	1	0	820	416	37	506	224	15
596646	Recommender_system	201510	7	0	0	0	4	2	0	0	827	420	37	508	226	15
596646	Recommender_system	201511	7	1	0	0	3	2	1	0	834	423	38	513	228	16
596646	Recommender_system	201512	6	1	0	0	6	4	1	0	840	428	39	517	229	17
596646	Recommender_system	201601	2	0	0	0	2	2	0	0	842	430	39	519	231	17
596646	Recommender_system	201602	6	1	0	0	4	3	1	0	848	434	40	524	234	17
596646	Recommender_system	201603	3	0	0	0	3	1	0	0	851	437	40	525	235	17
596646	Recommender_system	201604	9	0	0	0	6	5	0	0	860	441	40	533	238	17
596646	Recommender_system	201605	4	0	0	0	3	3	0	0	864	443	40	537	240	17
596646	Recommender_system	201606	6	0	0	0	5	4	0	0	870	447	40	541	243	17
596646	Recommender_system	201607	14	0	0	0	7	6	0	0	884	452	40	554	248	17
596646	Recommender_system	201608	11	1	0	0	8	4	1	0	895	459	41	558	251	17
596646	Recommender_system	201609	5	1	0	0	5	4	1	0	900	463	42	562	253	18
596646	Recommender_system	201610	3	0	0	0	3	2	0	0	903	465	42	564	254	18
596646	Recommender_system	201611	19	2	0	0	10	7	2	0	922	475	44	578	261	20
596646	Recommender_system	201612	7	0	0	0	7	4	0	0	929	481	44	582	264	20
596646	Recommender_system	201701	11	1	0	0	6	5	1	0	940	485	45	592	267	21
596646	Recommender_system	201702	8	0	0	0	6	5	0	0	948	488	45	599	269	21
596646	Recommender_system	201703	2	0	0	0	2	2	0	0	950	489	45	601	270	21
596646	Recommender_system	201704	10	1	0	0	7	4	1	0	960	493	46	605	271	21
596646	Recommender_system	201705	6	0	0	0	4	3	0	0	966	497	46	610	274	21
596646	Recommender_system	201706	7	1	0	0	5	5	1	0	973	501	47	617	278	22
596646	Recommender_system	201709	4	0	0	0	4	4	0	0	977	504	47	621	281	22
596646	Recommender_system	201710	5	0	0	0	5	5	0	0	982	507	47	626	283	22
596646	Recommender_system	201711	7	1	0	0	7	5	1	0	989	512	48	631	286	22
596646	Recommender_system	201712	1	0	0	0	1	1	0	0	990	513	48	632	287	22
596646	Recommender_system	201801	7	0	0	0	6	4	0	0	997	517	48	636	289	22
596646	Recommender_system	201802	1	0	0	0	1	1	0	0	998	517	48	637	289	22
596646	Recommender_system	201803	2	0	0	0	2	2	0	0	1000	519	48	639	290	22
596646	Recommender_system	201804	3	0	0	0	3	0	0	0	1003	522	48	639	290	22
596646	Recommender_system	201805	5	0	0	0	4	3	0	0	1008	525	48	642	291	22
596646	Recommender_system	201806	1	0	0	0	1	0	0	0	1009	526	48	642	291	22
596646	Recommender_system	201807	8	0	0	0	8	4	0	0	1017	532	48	646	293	22
46229780	Recursive_InterNetwork_Architecture_(RINA)	201504	8	0	0	0	5	5	0	0	8	5	0	8	5	0
46229780	Recursive_InterNetwork_Architecture_(RINA)	201507	2	0	0	0	2	2	0	0	10	6	0	10	6	0
46229780	Recursive_InterNetwork_Architecture_(RINA)	201509	2	0	0	0	2	2	0	0	12	8	0	12	8	0
46229780	Recursive_InterNetwork_Architecture_(RINA)	201510	1	0	0	0	1	1	0	0	13	9	0	13	9	0
46229780	Recursive_InterNetwork_Architecture_(RINA)	201601	2	0	0	0	2	2	0	0	15	11	0	15	11	0
46229780	Recursive_InterNetwork_Architecture_(RINA)	201602	1	0	0	0	1	0	0	0	16	12	0	15	11	0
46229780	Recursive_InterNetwork_Architecture_(RINA)	201603	1	0	0	0	1	0	0	0	17	13	0	15	11	0
46229780	Recursive_InterNetwork_Architecture_(RINA)	201605	2	0	0	0	1	0	0	0	19	14	0	15	11	0
46229780	Recursive_InterNetwork_Architecture_(RINA)	201607	1	0	0	0	1	1	0	0	20	15	0	16	12	0
46229780	Recursive_InterNetwork_Architecture_(RINA)	201611	1	0	0	0	1	1	0	0	21	16	0	17	13	0
46229780	Recursive_InterNetwork_Architecture_(RINA)	201702	1	0	0	0	1	1	0	0	22	17	0	18	14	0
46229780	Recursive_InterNetwork_Architecture_(RINA)	201703	1	0	0	0	1	1	0	0	23	18	0	19	15	0
46229780	Recursive_InterNetwork_Architecture_(RINA)	201705	1	0	0	0	1	1	0	0	24	19	0	20	16	0
46229780	Recursive_InterNetwork_Architecture_(RINA)	201707	1	0	0	0	1	1	0	0	25	20	0	21	17	0
46229780	Recursive_InterNetwork_Architecture_(RINA)	201710	2	0	0	0	1	0	0	0	27	21	0	21	17	0
46229780	Recursive_InterNetwork_Architecture_(RINA)	201711	1	0	0	0	1	1	0	0	28	22	0	22	18	0
46229780	Recursive_InterNetwork_Architecture_(RINA)	201712	2	0	0	0	2	2	0	0	30	24	0	24	20	0
46229780	Recursive_InterNetwork_Architecture_(RINA)	201804	1	0	0	0	1	1	0	0	31	25	0	25	21	0
50726041	Regulatory_technology	201607	7	0	0	0	3	2	0	0	7	3	0	6	2	0
50726041	Regulatory_technology	201608	8	0	0	0	3	3	0	0	15	5	0	14	4	0
50726041	Regulatory_technology	201609	3	0	0	0	3	3	0	0	18	8	0	17	7	0
50726041	Regulatory_technology	201610	1	0	0	0	1	1	0	0	19	9	0	18	8	0
50726041	Regulatory_technology	201611	4	0	0	0	4	2	0	0	23	13	0	20	10	0
50726041	Regulatory_technology	201612	5	0	0	0	5	3	0	0	28	17	0	23	12	0
50726041	Regulatory_technology	201701	1	0	0	0	1	1	0	0	29	17	0	24	12	0
50726041	Regulatory_technology	201702	2	0	0	0	1	1	0	0	31	18	0	26	13	0
50726041	Regulatory_technology	201704	1	0	0	0	1	0	0	0	32	19	0	26	13	0
50726041	Regulatory_technology	201707	3	1	0	0	3	2	1	0	35	22	1	28	15	0
50726041	Regulatory_technology	201708	4	0	0	0	2	1	0	0	39	24	1	31	16	0
50726041	Regulatory_technology	201709	1	0	0	0	1	1	0	0	40	25	1	32	17	0
50726041	Regulatory_technology	201710	3	0	0	0	3	2	0	0	43	27	1	34	18	0
50726041	Regulatory_technology	201711	1	0	0	0	1	0	0	0	44	28	1	34	18	0
50726041	Regulatory_technology	201712	14	0	0	0	9	8	0	0	58	36	1	46	23	0
50726041	Regulatory_technology	201801	2	0	0	0	2	1	0	0	60	38	1	47	24	0
50726041	Regulatory_technology	201803	2	0	0	0	2	2	0	0	62	40	1	49	26	0
50726041	Regulatory_technology	201804	6	0	0	0	3	3	0	0	68	43	1	55	28	0
50726041	Regulatory_technology	201805	1	0	0	0	1	1	0	0	69	44	1	56	29	0
50726041	Regulatory_technology	201806	1	0	0	0	1	1	0	0	70	45	1	57	30	0
50726041	Regulatory_technology	201807	2	1	0	0	2	1	1	0	72	46	2	58	30	1
66294	Reinforcement_learning	200208	2	0	0	0	2	1	0	0	2	2	0	1	1	0
66294	Reinforcement_learning	200303	1	0	0	0	1	1	0	0	3	2	0	2	1	0
66294	Reinforcement_learning	200307	1	0	0	0	1	0	0	0	4	3	0	2	1	0
66294	Reinforcement_learning	200404	1	0	0	0	1	1	0	0	5	4	0	3	2	0
66294	Reinforcement_learning	200406	1	0	0	0	1	0	0	0	6	5	0	3	2	0
66294	Reinforcement_learning	200408	2	0	0	0	2	2	0	0	8	7	0	5	4	0
66294	Reinforcement_learning	200411	2	1	0	0	2	1	1	0	10	9	1	6	5	0
66294	Reinforcement_learning	200412	1	0	0	0	1	1	0	0	11	10	1	7	6	0
66294	Reinforcement_learning	200501	4	1	0	0	2	1	1	0	15	12	2	10	7	0
66294	Reinforcement_learning	200503	6	0	0	0	3	1	0	0	21	15	2	13	8	0
66294	Reinforcement_learning	200504	1	0	0	0	1	0	0	0	22	16	2	13	8	0
66294	Reinforcement_learning	200505	5	1	0	0	4	3	1	0	27	20	3	17	11	0
66294	Reinforcement_learning	200506	2	0	0	0	2	2	0	0	29	21	3	19	12	0
66294	Reinforcement_learning	200510	1	0	0	0	1	0	0	0	30	22	3	19	12	0
66294	Reinforcement_learning	200511	2	0	0	0	2	1	0	0	32	24	3	20	13	0
66294	Reinforcement_learning	200512	2	0	0	0	1	1	0	0	34	25	3	22	14	0
66294	Reinforcement_learning	200601	3	0	0	0	1	0	0	0	37	26	3	22	14	0
66294	Reinforcement_learning	200602	2	0	0	0	2	1	0	0	39	28	3	23	15	0
66294	Reinforcement_learning	200603	2	0	0	0	2	2	0	0	41	29	3	25	16	0
66294	Reinforcement_learning	200605	4	0	0	0	3	1	0	0	45	32	3	26	17	0
66294	Reinforcement_learning	200607	4	0	0	0	2	1	0	0	49	34	3	29	18	0
66294	Reinforcement_learning	200608	1	0	0	0	1	1	0	0	50	35	3	30	19	0
66294	Reinforcement_learning	200609	1	0	0	0	1	0	0	0	51	36	3	30	19	0
66294	Reinforcement_learning	200610	1	0	0	0	1	0	0	0	52	37	3	30	19	0
66294	Reinforcement_learning	200611	2	0	0	0	2	1	0	0	54	39	3	31	20	0
66294	Reinforcement_learning	200612	3	0	0	0	3	1	0	0	57	42	3	32	21	0
66294	Reinforcement_learning	200701	11	0	0	0	4	4	0	0	68	46	3	43	25	0
66294	Reinforcement_learning	200702	5	0	0	0	4	3	0	0	73	50	3	46	28	0
66294	Reinforcement_learning	200703	6	0	0	0	4	2	0	0	79	54	3	50	30	0
66294	Reinforcement_learning	200704	3	1	0	0	3	3	1	0	82	57	4	53	33	1
66294	Reinforcement_learning	200705	4	0	0	0	3	2	0	0	86	60	4	56	35	1
66294	Reinforcement_learning	200706	1	0	0	0	1	0	0	0	87	61	4	56	35	1
66294	Reinforcement_learning	200707	1	0	0	0	1	0	0	0	88	62	4	56	35	1
66294	Reinforcement_learning	200708	3	0	0	0	1	0	0	0	91	63	4	56	35	1
66294	Reinforcement_learning	200709	3	0	0	0	3	2	0	0	94	66	4	58	37	1
66294	Reinforcement_learning	200710	3	0	0	0	2	2	0	0	97	68	4	61	39	1
66294	Reinforcement_learning	200711	5	0	0	0	4	1	0	0	102	71	4	62	39	1
66294	Reinforcement_learning	200801	7	1	0	0	6	3	1	0	109	76	5	65	41	1
66294	Reinforcement_learning	200802	3	0	0	0	3	1	0	0	112	79	5	66	42	1
66294	Reinforcement_learning	200803	1	0	0	0	1	1	0	0	113	80	5	67	43	1
66294	Reinforcement_learning	200804	2	0	0	0	2	0	0	0	115	82	5	67	43	1
66294	Reinforcement_learning	200806	3	0	0	0	3	2	0	0	118	85	5	69	45	1
66294	Reinforcement_learning	200807	1	0	0	0	1	1	0	0	119	86	5	70	46	1
66294	Reinforcement_learning	200808	1	0	0	0	1	0	0	0	120	87	5	70	46	1
66294	Reinforcement_learning	200809	7	0	0	0	5	1	0	0	127	92	5	71	47	1
66294	Reinforcement_learning	200810	4	0	0	0	4	2	0	0	131	95	5	73	48	1
66294	Reinforcement_learning	200812	1	0	0	0	1	0	0	0	132	96	5	73	48	1
66294	Reinforcement_learning	200902	1	0	0	0	1	1	0	0	133	97	5	74	49	1
66294	Reinforcement_learning	200903	13	0	0	0	3	1	0	0	146	100	5	83	50	1
66294	Reinforcement_learning	200905	6	0	0	0	2	1	0	0	152	102	5	87	51	1
66294	Reinforcement_learning	200906	4	0	0	0	3	1	0	0	156	105	5	89	52	1
66294	Reinforcement_learning	200907	9	1	0	0	6	3	1	0	165	111	6	92	55	1
66294	Reinforcement_learning	200908	3	0	0	0	2	1	0	0	168	113	6	93	56	1
66294	Reinforcement_learning	200909	11	1	0	0	6	5	1	0	179	118	7	101	60	2
66294	Reinforcement_learning	200910	1	0	0	0	1	0	0	0	180	119	7	101	60	2
66294	Reinforcement_learning	200911	3	0	0	0	2	1	0	0	183	119	7	103	60	2
66294	Reinforcement_learning	200912	3	0	0	0	3	0	0	0	186	122	7	103	60	2
66294	Reinforcement_learning	201001	2	0	0	0	1	0	0	0	188	123	7	103	60	2
66294	Reinforcement_learning	201003	2	0	0	0	1	0	0	0	190	124	7	103	60	2
66294	Reinforcement_learning	201004	4	0	0	0	4	2	0	0	194	128	7	105	62	2
66294	Reinforcement_learning	201005	13	2	0	0	7	3	2	0	207	133	9	111	64	3
66294	Reinforcement_learning	201006	6	1	0	0	5	0	1	0	213	136	10	111	64	3
66294	Reinforcement_learning	201007	5	0	0	0	4	3	0	0	218	140	10	114	67	3
66294	Reinforcement_learning	201008	6	2	0	0	5	4	2	0	224	144	12	118	70	4
66294	Reinforcement_learning	201009	8	0	0	0	3	2	0	0	232	147	12	124	72	4
66294	Reinforcement_learning	201010	11	2	0	0	5	2	2	0	243	151	14	132	73	6
66294	Reinforcement_learning	201011	3	0	0	0	3	2	0	0	246	153	14	134	74	6
66294	Reinforcement_learning	201012	8	0	0	0	5	1	0	0	254	157	14	136	75	6
66294	Reinforcement_learning	201101	2	0	0	0	2	0	0	0	256	159	14	136	75	6
66294	Reinforcement_learning	201102	1	0	0	0	1	0	0	0	257	160	14	136	75	6
66294	Reinforcement_learning	201103	2	0	0	0	2	2	0	0	259	161	14	138	76	6
66294	Reinforcement_learning	201104	1	0	0	0	1	0	0	0	260	162	14	138	76	6
66294	Reinforcement_learning	201105	1	0	0	0	1	1	0	0	261	162	14	139	76	6
66294	Reinforcement_learning	201106	3	1	0	0	3	2	1	0	264	164	15	141	78	7
66294	Reinforcement_learning	201107	2	0	0	0	1	0	0	0	266	165	15	141	78	7
66294	Reinforcement_learning	201108	1	0	0	0	1	0	0	0	267	166	15	141	78	7
66294	Reinforcement_learning	201109	1	0	0	0	1	1	0	0	268	167	15	142	79	7
66294	Reinforcement_learning	201110	1	0	0	0	1	0	0	0	269	168	15	142	79	7
66294	Reinforcement_learning	201111	10	2	1	0	6	3	2	1	279	173	17	145	82	8
66294	Reinforcement_learning	201112	2	0	0	0	2	0	0	0	281	175	17	145	82	8
66294	Reinforcement_learning	201201	3	0	0	0	3	1	0	0	284	177	17	146	83	8
66294	Reinforcement_learning	201202	3	0	0	0	3	1	0	0	287	180	17	147	84	8
66294	Reinforcement_learning	201203	1	0	0	0	1	0	0	0	288	181	17	147	84	8
66294	Reinforcement_learning	201204	2	0	0	0	2	1	0	0	290	183	17	148	85	8
66294	Reinforcement_learning	201205	5	0	0	0	3	3	0	0	295	186	17	153	88	8
66294	Reinforcement_learning	201207	1	0	0	0	1	0	0	0	296	187	17	153	88	8
66294	Reinforcement_learning	201208	3	0	0	0	2	1	0	0	299	189	17	155	89	8
66294	Reinforcement_learning	201209	1	0	0	0	1	1	0	0	300	190	17	156	90	8
66294	Reinforcement_learning	201210	1	0	0	0	1	1	0	0	301	191	17	157	91	8
66294	Reinforcement_learning	201211	5	0	0	0	3	2	0	0	306	194	17	161	93	8
66294	Reinforcement_learning	201212	1	0	0	0	1	1	0	0	307	194	17	162	93	8
66294	Reinforcement_learning	201302	2	0	0	0	2	2	0	0	309	196	17	164	95	8
66294	Reinforcement_learning	201303	4	0	0	0	4	3	0	0	313	199	17	167	97	8
66294	Reinforcement_learning	201304	1	0	0	0	1	1	0	0	314	200	17	168	98	8
66294	Reinforcement_learning	201305	2	0	0	0	2	0	0	0	316	202	17	168	98	8
66294	Reinforcement_learning	201306	4	0	0	0	2	1	0	0	320	204	17	171	99	8
66294	Reinforcement_learning	201307	4	0	0	0	1	1	0	0	324	205	17	175	100	8
66294	Reinforcement_learning	201309	1	0	0	0	1	0	0	0	325	206	17	175	100	8
66294	Reinforcement_learning	201310	1	0	0	0	1	0	0	0	326	207	17	175	100	8
66294	Reinforcement_learning	201311	3	1	0	0	3	3	1	0	329	209	18	178	102	8
66294	Reinforcement_learning	201312	2	0	0	0	2	0	0	0	331	211	18	178	102	8
66294	Reinforcement_learning	201401	1	0	0	0	1	1	0	0	332	212	18	179	103	8
66294	Reinforcement_learning	201402	7	0	0	0	4	3	0	0	339	215	18	184	105	8
66294	Reinforcement_learning	201403	1	0	0	0	1	0	0	0	340	216	18	184	105	8
66294	Reinforcement_learning	201405	5	0	0	0	4	4	0	0	345	220	18	189	109	8
66294	Reinforcement_learning	201407	1	0	0	0	1	0	0	0	346	221	18	189	109	8
66294	Reinforcement_learning	201408	1	0	0	0	1	1	0	0	347	221	18	190	109	8
66294	Reinforcement_learning	201409	1	0	0	0	1	1	0	0	348	222	18	191	110	8
66294	Reinforcement_learning	201410	3	0	0	0	3	3	0	0	351	223	18	194	111	8
66294	Reinforcement_learning	201412	8	0	0	0	4	2	0	0	359	227	18	199	113	8
66294	Reinforcement_learning	201501	1	0	0	0	1	1	0	0	360	228	18	200	114	8
66294	Reinforcement_learning	201502	6	0	0	0	4	2	0	0	366	232	18	202	116	8
66294	Reinforcement_learning	201504	1	0	0	0	1	1	0	0	367	233	18	203	117	8
66294	Reinforcement_learning	201507	2	1	0	0	2	1	1	0	369	235	19	204	118	8
66294	Reinforcement_learning	201508	3	0	0	0	3	3	0	0	372	237	19	207	120	8
66294	Reinforcement_learning	201510	2	0	0	0	1	1	0	0	374	238	19	209	121	8
66294	Reinforcement_learning	201511	3	1	0	0	3	1	1	0	377	241	20	210	122	8
66294	Reinforcement_learning	201601	4	0	0	0	4	3	0	0	381	245	20	213	125	8
66294	Reinforcement_learning	201602	1	0	0	0	1	0	0	0	382	246	20	213	125	8
66294	Reinforcement_learning	201603	4	0	0	0	4	3	0	0	386	250	20	216	128	8
66294	Reinforcement_learning	201604	1	0	0	0	1	1	0	0	387	250	20	217	128	8
66294	Reinforcement_learning	201605	2	1	0	0	2	1	1	0	389	252	21	218	129	9
66294	Reinforcement_learning	201606	2	1	0	0	2	2	1	0	391	253	22	220	130	10
66294	Reinforcement_learning	201607	1	0	0	0	1	0	0	0	392	254	22	220	130	10
66294	Reinforcement_learning	201608	3	1	0	0	3	1	1	0	395	256	23	221	130	10
66294	Reinforcement_learning	201609	15	0	0	0	5	4	0	0	410	261	23	235	134	10
66294	Reinforcement_learning	201610	4	1	0	0	4	1	1	0	414	264	24	236	134	10
66294	Reinforcement_learning	201611	4	0	0	0	4	3	0	0	418	267	24	239	136	10
66294	Reinforcement_learning	201612	1	0	0	0	1	1	0	0	419	267	24	240	136	10
66294	Reinforcement_learning	201701	6	0	0	0	4	3	0	0	425	271	24	244	139	10
66294	Reinforcement_learning	201702	4	1	0	0	4	1	1	0	429	274	25	245	139	10
66294	Reinforcement_learning	201703	6	0	0	0	5	3	0	0	435	278	25	249	141	10
66294	Reinforcement_learning	201704	14	2	0	0	10	5	2	0	449	286	27	258	144	10
66294	Reinforcement_learning	201705	4	0	0	0	4	2	0	0	453	290	27	260	146	10
66294	Reinforcement_learning	201707	7	1	0	0	6	3	1	0	460	294	28	263	148	10
66294	Reinforcement_learning	201708	8	0	0	0	4	4	0	0	468	296	28	271	150	10
66294	Reinforcement_learning	201709	19	1	0	0	8	4	1	0	487	303	29	283	152	10
66294	Reinforcement_learning	201710	8	2	0	0	7	5	2	0	495	308	31	288	155	11
66294	Reinforcement_learning	201711	5	0	0	0	5	4	0	0	500	312	31	292	158	11
66294	Reinforcement_learning	201712	4	0	0	0	4	2	0	0	504	315	31	294	159	11
66294	Reinforcement_learning	201801	3	0	0	0	3	1	0	0	507	317	31	295	159	11
66294	Reinforcement_learning	201802	17	0	0	0	4	4	0	0	524	320	31	312	162	11
66294	Reinforcement_learning	201803	13	1	0	0	6	3	1	0	537	325	32	322	164	11
66294	Reinforcement_learning	201804	3	0	0	0	2	2	0	0	540	325	32	325	164	11
66294	Reinforcement_learning	201805	14	0	0	0	8	7	0	0	554	330	32	338	168	11
66294	Reinforcement_learning	201806	3	0	0	0	2	1	0	0	557	332	32	340	169	11
66294	Reinforcement_learning	201807	2	0	0	0	2	2	0	0	559	334	32	342	171	11
618171	Resource_Reservation_Protocol	200509	1	0	0	0	1	1	0	0	1	1	0	1	1	0
618171	Resource_Reservation_Protocol	200511	3	0	0	0	1	1	0	0	4	2	0	4	2	0
618171	Resource_Reservation_Protocol	200512	3	0	0	0	2	2	0	0	7	4	0	7	4	0
618171	Resource_Reservation_Protocol	200602	2	0	0	0	2	1	0	0	9	6	0	8	5	0
618171	Resource_Reservation_Protocol	200603	2	1	0	0	2	1	1	0	11	8	1	9	6	0
618171	Resource_Reservation_Protocol	200605	2	0	0	0	2	1	0	0	13	10	1	10	7	0
618171	Resource_Reservation_Protocol	200607	4	1	0	0	3	2	1	0	17	13	2	13	9	0
618171	Resource_Reservation_Protocol	200608	3	0	0	0	2	1	0	0	20	15	2	14	10	0
618171	Resource_Reservation_Protocol	200609	1	0	0	0	1	0	0	0	21	16	2	14	10	0
618171	Resource_Reservation_Protocol	200610	5	0	0	0	5	5	0	0	26	20	2	19	14	0
618171	Resource_Reservation_Protocol	200611	2	0	0	0	2	2	0	0	28	22	2	21	16	0
618171	Resource_Reservation_Protocol	200612	4	0	0	0	3	3	0	0	32	25	2	25	19	0
618171	Resource_Reservation_Protocol	200701	9	0	0	0	4	1	0	0	41	29	2	26	20	0
618171	Resource_Reservation_Protocol	200702	5	0	0	0	2	2	0	0	46	31	2	31	22	0
618171	Resource_Reservation_Protocol	200703	1	0	0	0	1	1	0	0	47	32	2	32	23	0
618171	Resource_Reservation_Protocol	200705	1	0	0	0	1	1	0	0	48	33	2	33	24	0
618171	Resource_Reservation_Protocol	200706	1	0	0	0	1	1	0	0	49	34	2	34	25	0
618171	Resource_Reservation_Protocol	200708	2	0	0	0	2	1	0	0	51	36	2	35	26	0
618171	Resource_Reservation_Protocol	200709	2	0	0	0	2	1	0	0	53	38	2	36	27	0
618171	Resource_Reservation_Protocol	200710	2	0	0	0	2	1	0	0	55	39	2	37	27	0
618171	Resource_Reservation_Protocol	200711	1	0	0	0	1	1	0	0	56	40	2	38	28	0
618171	Resource_Reservation_Protocol	200801	4	1	0	0	2	0	1	0	60	42	3	38	28	0
618171	Resource_Reservation_Protocol	200802	2	0	0	0	2	1	0	0	62	44	3	39	29	0
618171	Resource_Reservation_Protocol	200804	1	0	0	0	1	1	0	0	63	45	3	40	30	0
618171	Resource_Reservation_Protocol	200805	2	0	0	0	1	1	0	0	65	46	3	42	31	0
618171	Resource_Reservation_Protocol	200806	3	0	0	0	2	0	0	0	68	48	3	42	31	0
618171	Resource_Reservation_Protocol	200807	4	0	0	0	4	3	0	0	72	51	3	45	33	0
618171	Resource_Reservation_Protocol	200808	1	0	0	0	1	1	0	0	73	52	3	46	34	0
618171	Resource_Reservation_Protocol	200809	1	0	0	0	1	1	0	0	74	52	3	47	34	0
618171	Resource_Reservation_Protocol	200904	1	0	0	0	1	1	0	0	75	53	3	48	35	0
618171	Resource_Reservation_Protocol	200905	1	0	0	0	1	1	0	0	76	54	3	49	36	0
618171	Resource_Reservation_Protocol	200906	1	0	0	0	1	0	0	0	77	55	3	49	36	0
618171	Resource_Reservation_Protocol	200911	2	1	0	0	2	2	1	0	79	56	4	51	37	1
618171	Resource_Reservation_Protocol	200912	5	1	0	0	3	1	1	0	84	59	5	52	38	1
618171	Resource_Reservation_Protocol	201001	1	0	0	0	1	0	0	0	85	60	5	52	38	1
618171	Resource_Reservation_Protocol	201003	1	0	0	0	1	1	0	0	86	61	5	53	39	1
618171	Resource_Reservation_Protocol	201004	1	0	0	0	1	0	0	0	87	62	5	53	39	1
618171	Resource_Reservation_Protocol	201005	3	0	0	0	3	1	0	0	90	65	5	54	40	1
618171	Resource_Reservation_Protocol	201006	2	0	0	0	1	0	0	0	92	66	5	54	40	1
618171	Resource_Reservation_Protocol	201007	3	0	0	0	2	1	0	0	95	67	5	56	40	1
618171	Resource_Reservation_Protocol	201009	1	0	0	0	1	1	0	0	96	68	5	57	41	1
618171	Resource_Reservation_Protocol	201010	4	3	2	1	2	1	2	2	100	70	8	59	42	2
618171	Resource_Reservation_Protocol	201101	1	0	0	0	1	1	0	0	101	71	8	60	43	2
618171	Resource_Reservation_Protocol	201102	1	0	0	0	1	1	0	0	102	72	8	61	44	2
618171	Resource_Reservation_Protocol	201105	2	0	0	0	2	1	0	0	104	73	8	62	44	2
618171	Resource_Reservation_Protocol	201106	8	0	0	0	4	2	0	0	112	77	8	64	46	2
618171	Resource_Reservation_Protocol	201107	2	0	0	0	2	1	0	0	114	79	8	65	47	2
618171	Resource_Reservation_Protocol	201109	3	0	0	0	3	2	0	0	117	82	8	67	49	2
618171	Resource_Reservation_Protocol	201111	1	0	0	0	1	1	0	0	118	83	8	68	50	2
618171	Resource_Reservation_Protocol	201202	1	0	0	0	1	0	0	0	119	84	8	68	50	2
618171	Resource_Reservation_Protocol	201203	2	0	0	0	2	2	0	0	121	85	8	70	51	2
618171	Resource_Reservation_Protocol	201209	2	1	0	0	2	1	1	0	123	86	9	71	51	2
618171	Resource_Reservation_Protocol	201210	2	0	0	0	2	2	0	0	125	88	9	73	53	2
618171	Resource_Reservation_Protocol	201211	2	1	0	0	2	1	1	0	127	89	10	74	53	2
618171	Resource_Reservation_Protocol	201302	2	1	0	0	2	1	1	0	129	90	11	75	53	2
618171	Resource_Reservation_Protocol	201305	1	0	0	0	1	1	0	0	130	91	11	76	54	2
618171	Resource_Reservation_Protocol	201306	10	9	1	0	8	3	7	1	140	99	20	81	57	6
618171	Resource_Reservation_Protocol	201402	1	0	0	0	1	1	0	0	141	100	20	82	58	6
618171	Resource_Reservation_Protocol	201404	2	0	0	0	2	2	0	0	143	102	20	84	60	6
618171	Resource_Reservation_Protocol	201406	1	0	0	0	1	0	0	0	144	103	20	84	60	6
618171	Resource_Reservation_Protocol	201407	1	0	0	0	1	0	0	0	145	104	20	84	60	6
618171	Resource_Reservation_Protocol	201505	2	1	0	0	2	1	1	0	147	105	21	85	60	6
618171	Resource_Reservation_Protocol	201601	2	1	0	0	2	1	1	0	149	107	22	86	61	6
618171	Resource_Reservation_Protocol	201602	2	0	0	0	1	0	0	0	151	108	22	86	61	6
618171	Resource_Reservation_Protocol	201610	1	0	0	0	1	0	0	0	152	109	22	86	61	6
618171	Resource_Reservation_Protocol	201704	1	0	0	0	1	1	0	0	153	110	22	87	62	6
618171	Resource_Reservation_Protocol	201711	1	0	0	0	1	1	0	0	154	111	22	88	63	6
618171	Resource_Reservation_Protocol	201712	2	1	0	0	2	2	1	0	156	113	23	90	65	7
618171	Resource_Reservation_Protocol	201803	1	0	0	0	1	1	0	0	157	113	23	91	65	7
618171	Resource_Reservation_Protocol	201804	2	0	0	0	2	2	0	0	159	114	23	93	66	7
1141591	Rich_Internet_application	200412	5	0	0	0	3	1	0	0	5	3	0	2	1	0
1141591	Rich_Internet_application	200501	1	0	0	0	1	0	0	0	6	4	0	2	1	0
1141591	Rich_Internet_application	200502	1	0	0	0	1	1	0	0	7	5	0	3	2	0
1141591	Rich_Internet_application	200503	1	0	0	0	1	0	0	0	8	6	0	3	2	0
1141591	Rich_Internet_application	200504	8	1	0	0	5	4	1	0	16	11	1	8	6	1
1141591	Rich_Internet_application	200505	23	0	0	0	9	7	0	0	39	19	1	26	13	1
1141591	Rich_Internet_application	200506	3	0	0	0	3	1	0	0	42	22	1	27	14	1
1141591	Rich_Internet_application	200507	2	0	0	0	2	1	0	0	44	24	1	28	15	1
1141591	Rich_Internet_application	200508	1	0	0	0	1	0	0	0	45	25	1	28	15	1
1141591	Rich_Internet_application	200509	55	5	2	1	28	10	3	2	100	52	6	46	24	4
1141591	Rich_Internet_application	200510	3	0	0	0	3	1	0	0	103	54	6	47	24	4
1141591	Rich_Internet_application	200511	10	0	0	0	6	1	0	0	113	58	6	50	24	4
1141591	Rich_Internet_application	200512	10	3	0	0	9	4	3	0	123	66	9	55	27	4
1141591	Rich_Internet_application	200601	3	0	0	0	3	1	0	0	126	68	9	56	27	4
1141591	Rich_Internet_application	200602	36	5	0	0	16	8	3	0	162	83	14	77	34	4
1141591	Rich_Internet_application	200603	13	2	0	0	8	3	2	0	175	89	16	85	36	5
1141591	Rich_Internet_application	200604	17	1	0	0	10	3	1	0	192	99	17	94	39	5
1141591	Rich_Internet_application	200605	16	0	0	0	8	5	0	0	208	103	17	102	41	5
1141591	Rich_Internet_application	200606	23	2	0	0	10	6	2	0	231	110	19	116	44	5
1141591	Rich_Internet_application	200607	11	2	0	0	7	5	1	0	242	113	21	125	46	6
1141591	Rich_Internet_application	200608	53	1	0	0	9	6	1	0	295	120	22	172	50	6
1141591	Rich_Internet_application	200609	22	2	0	0	15	10	2	0	317	132	24	187	57	6
1141591	Rich_Internet_application	200610	8	1	0	0	6	3	1	0	325	136	25	191	58	6
1141591	Rich_Internet_application	200611	10	2	0	0	10	7	2	0	335	143	27	198	62	6
1141591	Rich_Internet_application	200612	17	2	0	0	10	5	2	0	352	151	29	207	65	6
1141591	Rich_Internet_application	200701	25	4	0	0	18	8	4	0	377	165	33	221	70	6
1141591	Rich_Internet_application	200702	27	2	0	0	17	9	2	0	404	176	35	237	74	6
1141591	Rich_Internet_application	200703	22	4	0	0	13	6	3	0	426	185	39	247	76	6
1141591	Rich_Internet_application	200704	16	0	0	0	14	6	0	0	442	198	39	253	81	6
1141591	Rich_Internet_application	200705	9	0	0	0	8	3	0	0	451	205	39	256	84	6
1141591	Rich_Internet_application	200706	18	0	0	0	12	2	0	0	469	217	39	262	86	6
1141591	Rich_Internet_application	200707	11	1	0	0	8	3	1	0	480	225	40	265	89	6
1141591	Rich_Internet_application	200708	25	1	0	0	19	8	1	0	505	242	41	276	95	6
1141591	Rich_Internet_application	200709	33	5	0	0	24	9	5	0	538	263	46	292	101	7
1141591	Rich_Internet_application	200710	20	2	0	0	14	7	2	0	558	275	48	304	106	7
1141591	Rich_Internet_application	200711	12	0	0	0	8	5	0	0	570	279	48	311	108	7
1141591	Rich_Internet_application	200712	15	3	0	0	11	6	3	0	585	289	51	318	113	8
1141591	Rich_Internet_application	200801	11	0	0	0	9	6	0	0	596	298	51	326	119	8
1141591	Rich_Internet_application	200802	20	0	0	0	15	7	0	0	616	311	51	336	125	8
1141591	Rich_Internet_application	200803	22	2	0	0	15	7	2	0	638	325	53	347	131	9
1141591	Rich_Internet_application	200804	32	2	0	0	22	11	2	0	670	345	55	362	140	9
1141591	Rich_Internet_application	200805	10	0	0	0	9	2	0	0	680	354	55	364	142	9
1141591	Rich_Internet_application	200806	36	3	0	0	25	10	3	0	716	378	58	381	151	10
1141591	Rich_Internet_application	200807	11	0	0	0	6	3	0	0	727	384	58	385	154	10
1141591	Rich_Internet_application	200808	19	0	0	0	10	5	0	0	746	389	58	398	155	10
1141591	Rich_Internet_application	200809	13	3	0	0	9	4	3	0	759	396	61	402	157	10
1141591	Rich_Internet_application	200810	10	2	0	0	8	4	1	0	769	401	63	407	158	10
1141591	Rich_Internet_application	200811	6	0	0	0	5	2	0	0	775	406	63	409	160	10
1141591	Rich_Internet_application	200812	9	1	0	0	9	3	1	0	784	415	64	412	163	10
1141591	Rich_Internet_application	200901	4	0	0	0	3	1	0	0	788	418	64	413	164	10
1141591	Rich_Internet_application	200902	94	2	0	0	8	4	2	0	882	425	66	503	168	11
1141591	Rich_Internet_application	200903	9	0	0	0	8	5	0	0	891	433	66	508	173	11
1141591	Rich_Internet_application	200904	15	0	0	0	7	3	0	0	906	437	66	519	173	11
1141591	Rich_Internet_application	200905	7	0	0	0	6	4	0	0	913	443	66	524	177	11
1141591	Rich_Internet_application	200906	7	1	0	0	6	3	1	0	920	449	67	528	180	11
1141591	Rich_Internet_application	200907	6	0	0	0	6	5	0	0	926	453	67	533	183	11
1141591	Rich_Internet_application	200908	25	4	0	0	14	6	4	0	951	465	71	539	187	11
1141591	Rich_Internet_application	200909	18	0	0	0	11	6	0	0	969	474	71	552	191	11
1141591	Rich_Internet_application	200910	9	1	0	0	7	5	1	0	978	480	72	559	195	11
1141591	Rich_Internet_application	200911	5	0	0	0	2	2	0	0	983	481	72	564	196	11
1141591	Rich_Internet_application	200912	6	0	0	0	4	2	0	0	989	484	72	566	197	11
1141591	Rich_Internet_application	201001	4	1	0	0	4	2	1	0	993	487	73	568	198	11
1141591	Rich_Internet_application	201002	31	9	2	1	14	6	6	2	1024	499	82	581	203	13
1141591	Rich_Internet_application	201003	11	0	0	0	6	4	0	0	1035	504	82	586	206	13
1141591	Rich_Internet_application	201004	51	3	0	0	14	7	2	0	1086	513	85	625	208	13
1141591	Rich_Internet_application	201005	15	0	0	0	10	5	0	0	1101	520	85	634	210	13
1141591	Rich_Internet_application	201006	3	0	0	0	1	1	0	0	1104	521	85	637	211	13
1141591	Rich_Internet_application	201007	26	3	0	0	11	5	3	0	1130	530	88	645	215	14
1141591	Rich_Internet_application	201008	20	2	0	0	9	3	1	0	1150	535	90	650	216	14
1141591	Rich_Internet_application	201009	14	1	0	0	12	8	1	0	1164	545	91	659	223	14
1141591	Rich_Internet_application	201010	6	0	0	0	4	2	0	0	1170	549	91	662	225	14
1141591	Rich_Internet_application	201011	1	0	0	0	1	0	0	0	1171	550	91	662	225	14
1141591	Rich_Internet_application	201012	3	0	0	0	2	1	0	0	1174	552	91	664	226	14
1141591	Rich_Internet_application	201101	2	0	0	0	2	2	0	0	1176	554	91	666	228	14
1141591	Rich_Internet_application	201102	3	0	0	0	3	2	0	0	1179	556	91	668	229	14
1141591	Rich_Internet_application	201103	2	0	0	0	2	2	0	0	1181	558	91	670	231	14
1141591	Rich_Internet_application	201104	1	0	0	0	1	1	0	0	1182	559	91	671	232	14
1141591	Rich_Internet_application	201105	5	0	0	0	2	1	0	0	1187	560	91	675	232	14
1141591	Rich_Internet_application	201106	2	0	0	0	2	2	0	0	1189	561	91	677	233	14
1141591	Rich_Internet_application	201107	1	0	0	0	1	1	0	0	1190	562	91	678	234	14
1141591	Rich_Internet_application	201108	12	3	0	0	6	5	2	0	1202	567	94	689	238	16
1141591	Rich_Internet_application	201109	11	1	0	0	7	5	1	0	1213	571	95	695	240	17
1141591	Rich_Internet_application	201110	1	0	0	0	1	1	0	0	1214	572	95	696	241	17
1141591	Rich_Internet_application	201111	4	0	0	0	3	0	0	0	1218	575	95	696	241	17
1141591	Rich_Internet_application	201112	5	0	0	0	3	1	0	0	1223	577	95	698	241	17
1141591	Rich_Internet_application	201201	3	1	0	0	3	2	1	0	1226	579	96	700	242	17
1141591	Rich_Internet_application	201202	2	1	0	0	2	1	1	0	1228	581	97	701	243	17
1141591	Rich_Internet_application	201203	7	1	0	0	5	2	1	0	1235	586	98	703	245	17
1141591	Rich_Internet_application	201204	2	1	0	0	2	1	1	0	1237	588	99	704	246	17
1141591	Rich_Internet_application	201205	6	1	0	0	5	3	1	0	1243	592	100	707	248	17
1141591	Rich_Internet_application	201206	3	0	0	0	2	2	0	0	1246	593	100	710	249	17
1141591	Rich_Internet_application	201208	1	0	0	0	1	0	0	0	1247	594	100	710	249	17
1141591	Rich_Internet_application	201209	2	0	0	0	2	1	0	0	1249	595	100	711	249	17
1141591	Rich_Internet_application	201210	22	1	0	0	12	8	1	0	1271	605	101	724	255	17
1141591	Rich_Internet_application	201211	9	1	0	0	6	4	1	0	1280	609	102	731	257	18
1141591	Rich_Internet_application	201212	7	1	0	0	6	4	1	0	1287	612	103	735	258	18
1141591	Rich_Internet_application	201301	4	2	0	0	4	1	2	0	1291	616	105	736	259	18
1141591	Rich_Internet_application	201302	4	0	0	0	4	2	0	0	1295	620	105	738	261	18
1141591	Rich_Internet_application	201303	3	0	0	0	3	3	0	0	1298	623	105	741	264	18
1141591	Rich_Internet_application	201304	5	2	0	0	3	2	1	0	1303	625	107	744	265	18
1141591	Rich_Internet_application	201306	2	1	0	0	2	2	1	0	1305	627	108	746	267	19
1141591	Rich_Internet_application	201307	3	0	0	0	2	0	0	0	1308	629	108	746	267	19
1141591	Rich_Internet_application	201309	1	0	0	0	1	1	0	0	1309	630	108	747	268	19
1141591	Rich_Internet_application	201310	2	1	0	0	2	1	1	0	1311	632	109	748	269	19
1141591	Rich_Internet_application	201311	5	0	0	0	4	3	0	0	1316	635	109	752	271	19
1141591	Rich_Internet_application	201312	1	0	0	0	1	1	0	0	1317	635	109	753	271	19
1141591	Rich_Internet_application	201403	1	0	0	0	1	0	0	0	1318	636	109	753	271	19
1141591	Rich_Internet_application	201404	5	2	0	0	4	3	2	0	1323	640	111	756	274	20
1141591	Rich_Internet_application	201405	3	0	0	0	3	1	0	0	1326	643	111	757	275	20
1141591	Rich_Internet_application	201408	2	1	0	0	2	1	1	0	1328	644	112	758	275	20
1141591	Rich_Internet_application	201410	4	1	0	0	4	2	1	0	1332	647	113	760	276	20
1141591	Rich_Internet_application	201503	2	1	0	0	2	0	1	0	1334	649	114	760	276	20
1141591	Rich_Internet_application	201505	3	0	0	0	2	0	0	0	1337	651	114	760	276	20
1141591	Rich_Internet_application	201506	1	0	0	0	1	1	0	0	1338	652	114	761	277	20
1141591	Rich_Internet_application	201507	3	0	0	0	2	2	0	0	1341	654	114	764	279	20
1141591	Rich_Internet_application	201509	1	0	0	0	1	1	0	0	1342	655	114	765	280	20
1141591	Rich_Internet_application	201511	2	0	0	0	1	0	0	0	1344	656	114	765	280	20
1141591	Rich_Internet_application	201512	3	0	0	0	3	1	0	0	1347	659	114	766	281	20
1141591	Rich_Internet_application	201601	2	0	0	0	2	2	0	0	1349	660	114	768	282	20
1141591	Rich_Internet_application	201603	3	0	0	0	1	0	0	0	1352	661	114	768	282	20
1141591	Rich_Internet_application	201607	2	0	0	0	1	0	0	0	1354	662	114	768	282	20
1141591	Rich_Internet_application	201608	4	1	0	0	3	2	1	0	1358	665	115	770	284	21
1141591	Rich_Internet_application	201611	3	0	0	0	3	2	0	0	1361	668	115	772	286	21
1141591	Rich_Internet_application	201701	12	0	0	0	7	5	0	0	1373	672	115	781	288	21
1141591	Rich_Internet_application	201702	2	1	0	0	2	1	1	0	1375	674	116	782	289	21
1141591	Rich_Internet_application	201704	1	0	0	0	1	1	0	0	1376	674	116	783	289	21
1141591	Rich_Internet_application	201706	1	0	0	0	1	0	0	0	1377	675	116	783	289	21
1141591	Rich_Internet_application	201709	3	0	0	0	3	3	0	0	1380	678	116	786	292	21
1141591	Rich_Internet_application	201711	1	0	0	0	1	1	0	0	1381	679	116	787	293	21
1141591	Rich_Internet_application	201802	7	1	0	0	2	1	1	0	1388	681	117	789	294	21
1141591	Rich_Internet_application	201803	1	0	0	0	1	1	0	0	1389	682	117	790	295	21
1141591	Rich_Internet_application	201804	1	0	0	0	1	1	0	0	1390	683	117	791	296	21
1141591	Rich_Internet_application	201806	11	0	0	0	3	3	0	0	1401	684	117	802	297	21
47642826	Robotic_process_automation	201509	4	0	0	0	3	3	0	0	4	3	0	4	3	0
47642826	Robotic_process_automation	201510	2	0	0	0	1	0	0	0	6	4	0	4	3	0
47642826	Robotic_process_automation	201601	1	0	0	0	1	1	0	0	7	4	0	5	3	0
47642826	Robotic_process_automation	201602	3	0	0	0	2	1	0	0	10	6	0	7	4	0
47642826	Robotic_process_automation	201604	7	1	0	0	3	2	1	0	17	8	1	12	5	0
47642826	Robotic_process_automation	201607	1	0	0	0	1	1	0	0	18	9	1	13	6	0
47642826	Robotic_process_automation	201608	5	0	0	0	4	3	0	0	23	13	1	16	9	0
47642826	Robotic_process_automation	201609	6	1	0	0	5	3	1	0	29	17	2	19	11	0
47642826	Robotic_process_automation	201610	6	0	0	0	5	3	0	0	35	22	2	23	14	0
47642826	Robotic_process_automation	201611	12	0	0	0	9	5	0	0	47	31	2	29	19	0
47642826	Robotic_process_automation	201612	39	13	0	0	23	12	5	0	86	50	15	55	28	3
47642826	Robotic_process_automation	201701	16	5	0	0	11	4	3	0	102	59	20	61	30	5
47642826	Robotic_process_automation	201702	7	3	0	0	6	4	3	0	109	63	23	66	32	5
47642826	Robotic_process_automation	201703	20	5	0	0	16	13	5	0	129	78	28	80	43	7
47642826	Robotic_process_automation	201704	16	5	0	0	12	6	5	0	145	90	33	86	49	8
47642826	Robotic_process_automation	201705	12	6	0	0	10	5	4	0	157	98	39	93	52	10
47642826	Robotic_process_automation	201706	16	6	0	0	9	7	3	0	173	105	45	106	57	14
47642826	Robotic_process_automation	201707	5	0	0	0	4	4	0	0	178	109	45	111	61	14
47642826	Robotic_process_automation	201708	5	0	0	0	3	3	0	0	183	111	45	116	63	14
47642826	Robotic_process_automation	201709	3	0	0	0	2	2	0	0	186	113	45	119	65	14
47642826	Robotic_process_automation	201710	7	0	0	0	3	3	0	0	193	116	45	126	68	14
47642826	Robotic_process_automation	201711	2	1	0	0	2	2	1	0	195	118	46	128	70	15
47642826	Robotic_process_automation	201801	1	0	0	0	1	1	0	0	196	119	46	129	71	15
47642826	Robotic_process_automation	201802	5	1	0	0	3	3	1	0	201	122	47	134	74	16
47642826	Robotic_process_automation	201803	5	0	0	0	3	3	0	0	206	124	47	139	76	16
47642826	Robotic_process_automation	201804	6	0	0	0	3	3	0	0	212	127	47	145	79	16
47642826	Robotic_process_automation	201805	5	1	0	0	5	5	1	0	217	129	48	150	81	17
47642826	Robotic_process_automation	201806	25	5	0	0	15	9	2	0	242	143	53	166	89	19
47642826	Robotic_process_automation	201807	10	5	1	0	7	5	3	1	252	147	58	174	91	22
20903754	Robotics	200504	1	0	0	0	1	0	0	0	1	1	0	0	0	0
20903754	Robotics	200505	12	0	0	0	5	3	0	0	13	6	0	6	3	0
20903754	Robotics	200506	3	0	0	0	3	3	0	0	16	9	0	9	6	0
20903754	Robotics	200507	3	0	0	0	3	2	0	0	19	12	0	11	8	0
20903754	Robotics	200508	7	0	0	0	7	5	0	0	26	19	0	16	13	0
20903754	Robotics	200702	1	1	0	0	1	1	1	0	27	20	1	17	14	0
20903754	Robotics	200704	2	1	0	0	2	1	1	0	29	22	2	18	15	0
20903754	Robotics	200705	6	1	0	0	5	3	1	0	35	27	3	22	18	0
20903754	Robotics	200706	12	2	0	0	10	5	2	0	47	37	5	28	23	1
20903754	Robotics	200707	6	1	0	0	5	4	1	0	53	41	6	33	26	1
20903754	Robotics	200708	26	5	0	0	18	11	4	0	79	56	11	50	34	2
20903754	Robotics	200709	27	1	0	0	18	9	1	0	106	72	12	60	41	2
20903754	Robotics	200710	47	10	0	0	30	13	6	0	153	100	22	78	52	2
20903754	Robotics	200711	37	12	0	0	27	16	10	0	190	124	34	102	65	5
20903754	Robotics	200712	61	15	0	0	32	13	8	0	251	154	49	139	76	6
20903754	Robotics	200801	27	10	0	0	14	6	5	0	278	163	59	150	77	6
20903754	Robotics	200802	45	9	0	0	28	14	7	0	323	189	68	169	89	7
20903754	Robotics	200803	49	17	2	0	27	16	13	1	372	213	85	198	103	10
20903754	Robotics	200804	30	4	0	0	17	8	4	0	402	225	89	206	107	10
20903754	Robotics	200805	46	11	0	0	32	17	8	0	448	253	100	229	120	12
20903754	Robotics	200806	55	18	0	0	37	17	13	0	503	285	118	255	132	13
20903754	Robotics	200807	55	13	2	1	32	21	6	2	558	313	131	296	149	19
20903754	Robotics	200808	23	10	0	0	18	11	8	0	581	329	141	309	158	20
20903754	Robotics	200809	58	13	0	0	36	17	9	0	639	360	154	340	170	21
20903754	Robotics	200810	62	12	1	0	33	16	11	1	701	385	166	376	179	22
20903754	Robotics	200811	34	14	0	0	19	11	7	0	735	402	180	395	188	24
20903754	Robotics	200812	22	7	0	0	19	12	7	0	757	420	187	407	199	25
20903754	Robotics	200901	40	9	1	0	30	18	8	1	797	448	196	429	215	26
20903754	Robotics	200902	15	0	0	0	7	7	0	0	812	455	196	444	222	26
20903754	Robotics	200903	4	0	0	0	4	4	0	0	816	458	196	448	225	26
20903754	Robotics	200904	9	0	0	0	6	5	0	0	825	463	196	456	229	26
20903754	Robotics	200905	75	25	0	0	40	19	16	0	900	497	221	487	242	26
20903754	Robotics	200906	50	2	0	0	30	14	2	0	950	522	223	515	251	26
20903754	Robotics	200907	18	3	0	0	11	4	2	0	968	532	226	522	254	27
20903754	Robotics	200908	36	4	0	0	22	16	4	0	1004	551	230	551	267	27
20903754	Robotics	200909	38	12	0	0	27	14	9	0	1042	575	242	571	278	27
20903754	Robotics	200910	27	9	0	0	21	12	6	0	1069	590	251	588	284	29
20903754	Robotics	200911	56	17	0	0	27	14	6	0	1125	615	268	618	296	33
20903754	Robotics	200912	53	12	0	0	31	17	9	0	1178	639	280	645	306	35
20903754	Robotics	201001	28	10	0	0	20	14	7	0	1206	657	290	664	318	40
20903754	Robotics	201002	36	7	0	0	24	14	5	0	1242	675	297	688	326	41
20903754	Robotics	201003	40	13	0	0	31	22	10	0	1282	700	310	716	342	44
20903754	Robotics	201004	20	6	0	0	18	9	5	0	1302	716	316	726	349	44
20903754	Robotics	201005	50	15	0	0	32	16	8	0	1352	742	331	751	360	48
20903754	Robotics	201006	53	13	0	0	30	20	10	0	1405	768	344	779	376	49
20903754	Robotics	201007	25	5	0	0	22	13	4	0	1430	785	349	795	384	50
20903754	Robotics	201008	18	7	0	0	17	9	6	0	1448	797	356	805	388	50
20903754	Robotics	201009	38	11	0	0	21	12	8	0	1486	813	367	832	395	55
20903754	Robotics	201010	28	8	0	0	17	8	6	0	1514	829	375	842	402	55
20903754	Robotics	201011	36	8	0	0	25	18	6	0	1550	848	383	869	414	58
20903754	Robotics	201012	25	7	0	0	21	10	7	0	1575	864	390	882	420	58
20903754	Robotics	201101	41	14	1	0	25	13	11	1	1616	883	404	899	427	59
20903754	Robotics	201102	33	8	0	0	20	12	6	0	1649	896	412	915	432	60
20903754	Robotics	201103	99	24	4	3	28	17	10	2	1748	918	436	976	443	63
20903754	Robotics	201104	22	3	0	0	9	5	3	0	1770	925	439	994	446	63
20903754	Robotics	201105	28	11	0	0	18	10	6	0	1798	937	450	1012	451	66
20903754	Robotics	201106	18	5	0	0	13	9	4	0	1816	947	455	1026	457	67
20903754	Robotics	201107	39	6	0	0	20	15	4	0	1855	963	461	1060	468	70
20903754	Robotics	201108	15	4	0	0	11	8	4	0	1870	971	465	1072	473	72
20903754	Robotics	201109	9	2	0	0	8	3	2	0	1879	977	467	1075	474	72
20903754	Robotics	201110	29	12	0	0	21	11	8	0	1908	992	479	1091	479	75
20903754	Robotics	201111	41	9	0	0	27	13	9	0	1949	1012	488	1112	485	75
20903754	Robotics	201112	17	5	0	0	14	7	5	0	1966	1022	493	1120	488	75
20903754	Robotics	201201	31	2	0	0	20	17	2	0	1997	1039	495	1148	502	76
20903754	Robotics	201202	48	9	0	0	20	13	7	0	2045	1053	504	1187	509	78
20903754	Robotics	201203	33	10	0	0	18	7	5	0	2078	1066	514	1204	511	78
20903754	Robotics	201204	27	12	0	0	18	10	7	0	2105	1080	526	1219	517	79
20903754	Robotics	201205	23	4	0	0	17	14	3	0	2128	1093	530	1239	527	81
20903754	Robotics	201206	29	9	0	0	20	15	8	0	2157	1108	539	1260	537	84
20903754	Robotics	201207	19	7	0	0	16	9	7	0	2176	1117	546	1270	539	84
20903754	Robotics	201208	11	2	0	0	9	5	2	0	2187	1124	548	1275	542	84
20903754	Robotics	201209	27	9	0	0	21	13	7	0	2214	1138	557	1293	548	87
20903754	Robotics	201210	27	9	0	0	19	10	5	0	2241	1152	566	1310	553	91
20903754	Robotics	201211	36	10	0	0	27	15	7	0	2277	1173	576	1330	562	91
20903754	Robotics	201212	40	16	0	0	27	15	11	0	2317	1196	592	1351	573	94
20903754	Robotics	201301	15	4	0	0	11	6	4	0	2332	1202	596	1361	574	95
20903754	Robotics	201302	28	12	0	0	17	9	9	0	2360	1215	608	1373	579	95
20903754	Robotics	201303	24	6	0	0	20	9	4	0	2384	1231	614	1385	584	95
20903754	Robotics	201304	37	13	0	0	26	14	8	0	2421	1248	627	1404	589	97
20903754	Robotics	201305	28	11	0	0	20	11	8	0	2449	1263	638	1420	595	97
20903754	Robotics	201306	22	5	0	0	18	11	5	0	2471	1274	643	1432	599	97
20903754	Robotics	201307	12	2	0	0	9	4	2	0	2483	1282	645	1436	602	97
20903754	Robotics	201308	15	6	0	0	11	7	5	0	2498	1290	651	1445	606	97
20903754	Robotics	201309	20	6	0	0	13	7	4	0	2518	1299	657	1456	609	98
20903754	Robotics	201310	27	8	0	0	19	12	7	0	2545	1313	665	1470	616	100
20903754	Robotics	201311	33	11	0	0	22	11	9	0	2578	1330	676	1484	622	100
20903754	Robotics	201312	16	3	0	0	11	6	2	0	2594	1339	679	1491	626	101
20903754	Robotics	201401	11	4	0	0	10	4	3	0	2605	1349	683	1496	630	102
20903754	Robotics	201402	16	7	0	0	13	6	5	0	2621	1359	690	1504	633	102
20903754	Robotics	201403	20	1	0	0	11	5	1	0	2641	1368	691	1513	636	102
20903754	Robotics	201404	14	5	0	0	13	10	5	0	2655	1377	696	1524	642	104
20903754	Robotics	201405	12	3	0	0	9	4	2	0	2667	1384	699	1531	644	104
20903754	Robotics	201406	29	5	0	0	17	12	4	0	2696	1399	704	1553	654	107
20903754	Robotics	201407	5	1	0	0	5	3	1	0	2701	1403	705	1556	656	107
20903754	Robotics	201408	14	3	0	0	11	8	2	0	2715	1412	708	1567	662	107
20903754	Robotics	201409	13	3	0	0	12	8	3	0	2728	1423	711	1575	669	108
20903754	Robotics	201410	34	13	0	0	24	11	8	0	2762	1443	724	1591	676	109
20903754	Robotics	201411	26	6	0	0	17	10	6	0	2788	1454	730	1605	681	109
20903754	Robotics	201412	20	4	0	0	17	11	4	0	2808	1469	734	1617	689	111
20903754	Robotics	201501	26	2	0	0	14	11	2	0	2834	1479	736	1638	696	112
20903754	Robotics	201502	9	1	0	0	7	4	1	0	2843	1485	737	1642	698	112
20903754	Robotics	201503	8	3	0	0	7	3	3	0	2851	1490	740	1646	699	113
20903754	Robotics	201504	121	21	0	0	35	29	9	0	2972	1519	761	1756	721	130
20903754	Robotics	201505	13	4	0	0	9	5	3	0	2985	1525	765	1763	723	131
20903754	Robotics	201506	9	3	1	0	8	6	3	1	2994	1532	768	1770	728	134
20903754	Robotics	201507	18	3	0	0	11	9	3	0	3012	1539	771	1786	733	135
20903754	Robotics	201508	13	4	0	0	11	7	4	0	3025	1546	775	1794	736	136
20903754	Robotics	201509	15	6	0	0	13	9	5	0	3040	1556	781	1804	742	138
20903754	Robotics	201510	75	16	0	0	25	16	10	0	3115	1573	797	1859	750	142
20903754	Robotics	201511	11	5	0	0	11	8	5	0	3126	1579	802	1867	752	144
20903754	Robotics	201512	16	5	0	0	13	5	4	0	3142	1590	807	1873	754	145
20903754	Robotics	201601	24	4	0	0	18	15	4	0	3166	1602	811	1891	763	146
20903754	Robotics	201602	16	6	0	0	13	7	4	0	3182	1612	817	1900	767	147
20903754	Robotics	201603	47	9	0	0	25	16	7	0	3229	1630	826	1918	776	147
20903754	Robotics	201604	18	3	0	0	10	7	1	0	3247	1637	829	1927	779	149
20903754	Robotics	201605	35	7	0	0	24	20	6	0	3282	1654	836	1955	790	152
20903754	Robotics	201606	25	4	0	0	13	7	3	0	3307	1663	840	1971	793	152
20903754	Robotics	201607	13	0	0	0	8	6	0	0	3320	1670	840	1981	797	152
20903754	Robotics	201608	10	1	0	0	8	2	1	0	3330	1676	841	1983	797	152
20903754	Robotics	201609	10	2	0	0	8	4	2	0	3340	1682	843	1987	798	153
20903754	Robotics	201610	7	1	0	0	6	5	1	0	3347	1687	844	1993	802	153
20903754	Robotics	201611	30	9	0	0	20	9	6	0	3377	1702	853	2007	805	154
20903754	Robotics	201612	26	11	0	0	15	11	7	0	3403	1711	864	2023	810	155
20903754	Robotics	201701	9	1	0	0	8	6	1	0	3412	1717	865	2030	814	155
20903754	Robotics	201702	52	17	0	0	29	24	12	0	3464	1736	882	2067	825	163
20903754	Robotics	201703	17	6	0	0	16	8	6	0	3481	1747	888	2075	828	163
20903754	Robotics	201704	44	17	1	0	23	13	10	1	3525	1762	905	2101	832	167
20903754	Robotics	201705	14	4	0	0	11	5	3	0	3539	1770	909	2108	834	167
20903754	Robotics	201706	16	3	0	0	10	5	2	0	3555	1778	912	2115	834	169
20903754	Robotics	201707	22	8	2	1	13	9	4	2	3577	1786	920	2133	838	173
20903754	Robotics	201708	13	4	0	0	10	6	4	0	3590	1793	924	2140	840	175
20903754	Robotics	201709	21	4	0	0	10	7	4	0	3611	1801	928	2156	845	176
20903754	Robotics	201710	13	5	0	0	11	6	4	0	3624	1810	933	2164	849	177
20903754	Robotics	201711	42	18	0	0	20	11	11	0	3666	1823	951	2182	853	177
20903754	Robotics	201712	15	4	0	0	14	8	3	0	3681	1834	955	2191	858	178
20903754	Robotics	201801	7	2	0	0	6	3	1	0	3688	1838	957	2195	859	178
20903754	Robotics	201802	33	11	0	0	20	15	7	0	3721	1852	968	2222	867	186
20903754	Robotics	201803	19	7	0	0	14	9	5	0	3740	1862	975	2234	872	187
20903754	Robotics	201804	38	18	5	3	21	14	10	3	3778	1875	993	2261	877	194
20903754	Robotics	201805	14	4	0	0	12	10	4	0	3792	1881	997	2273	881	196
20903754	Robotics	201806	32	11	0	0	20	12	8	0	3824	1895	1008	2290	885	200
20903754	Robotics	201807	16	6	0	0	12	8	5	0	3840	1902	1014	2299	886	201
2803310	Robust_Header_Compression	200510	4	0	0	0	2	1	0	0	4	2	0	2	1	0
2803310	Robust_Header_Compression	200511	1	0	0	0	1	1	0	0	5	3	0	3	2	0
2803310	Robust_Header_Compression	200512	1	0	0	0	1	1	0	0	6	4	0	4	3	0
2803310	Robust_Header_Compression	200601	1	0	0	0	1	1	0	0	7	5	0	5	4	0
2803310	Robust_Header_Compression	200603	5	0	0	0	2	1	0	0	12	7	0	6	5	0
2803310	Robust_Header_Compression	200606	2	0	0	0	1	1	0	0	14	8	0	8	6	0
2803310	Robust_Header_Compression	200701	2	1	0	0	2	0	1	0	16	10	1	8	6	0
2803310	Robust_Header_Compression	200704	1	0	0	0	1	1	0	0	17	11	1	9	7	0
2803310	Robust_Header_Compression	200708	1	0	0	0	1	1	0	0	18	12	1	10	8	0
2803310	Robust_Header_Compression	200801	1	0	0	0	1	0	0	0	19	13	1	10	8	0
2803310	Robust_Header_Compression	200807	1	0	0	0	1	1	0	0	20	14	1	11	9	0
2803310	Robust_Header_Compression	200905	1	0	0	0	1	1	0	0	21	15	1	12	10	0
2803310	Robust_Header_Compression	200906	5	1	0	0	4	4	1	0	26	19	2	17	14	1
2803310	Robust_Header_Compression	200907	5	0	0	0	2	1	0	0	31	21	2	18	15	1
2803310	Robust_Header_Compression	200908	2	1	0	0	2	1	1	0	33	23	3	19	16	1
2803310	Robust_Header_Compression	200910	2	0	0	0	2	1	0	0	35	25	3	20	17	1
2803310	Robust_Header_Compression	201007	3	0	0	0	2	0	0	0	38	27	3	20	17	1
2803310	Robust_Header_Compression	201008	1	0	0	0	1	1	0	0	39	28	3	21	18	1
2803310	Robust_Header_Compression	201106	3	1	0	0	3	2	1	0	42	31	4	23	20	1
2803310	Robust_Header_Compression	201112	3	0	0	0	1	1	0	0	45	32	4	26	21	1
2803310	Robust_Header_Compression	201210	1	0	0	0	1	0	0	0	46	33	4	26	21	1
2803310	Robust_Header_Compression	201211	1	0	0	0	1	1	0	0	47	34	4	27	22	1
2803310	Robust_Header_Compression	201212	2	0	0	0	1	0	0	0	49	35	4	27	22	1
2803310	Robust_Header_Compression	201302	1	0	0	0	1	1	0	0	50	36	4	28	23	1
2803310	Robust_Header_Compression	201303	2	0	0	0	1	1	0	0	52	36	4	30	23	1
2803310	Robust_Header_Compression	201305	1	0	0	0	1	1	0	0	53	37	4	31	24	1
2803310	Robust_Header_Compression	201309	1	0	0	0	1	1	0	0	54	38	4	32	25	1
2803310	Robust_Header_Compression	201312	1	0	0	0	1	1	0	0	55	39	4	33	26	1
2803310	Robust_Header_Compression	201411	2	0	0	0	1	1	0	0	57	40	4	35	27	1
2803310	Robust_Header_Compression	201504	1	0	0	0	1	1	0	0	58	41	4	36	27	1
2803310	Robust_Header_Compression	201510	3	0	0	0	1	1	0	0	61	42	4	39	28	1
2803310	Robust_Header_Compression	201512	2	0	0	0	1	1	0	0	63	43	4	41	29	1
2803310	Robust_Header_Compression	201804	1	0	0	0	1	1	0	0	64	44	4	42	30	1
2803310	Robust_Header_Compression	201807	1	0	0	0	1	1	0	0	65	45	4	43	31	1
25222851	Routing_bridge	200912	2	0	0	0	1	1	0	0	2	1	0	2	1	0
25222851	Routing_bridge	201207	2	0	0	0	1	1	0	0	4	2	0	4	2	0
25222851	Routing_bridge	201208	1	0	0	0	1	1	0	0	5	3	0	5	3	0
25222851	Routing_bridge	201301	2	0	0	0	1	1	0	0	7	3	0	7	3	0
25222851	Routing_bridge	201404	1	0	0	0	1	1	0	0	8	4	0	8	4	0
25222851	Routing_bridge	201408	2	0	0	0	1	1	0	0	10	5	0	10	5	0
25222851	Routing_bridge	201606	2	0	0	0	2	2	0	0	12	7	0	12	7	0
25222851	Routing_bridge	201701	1	0	0	0	1	1	0	0	13	8	0	13	8	0
2560969	Secure_Real-time_Transport_Protocol	200509	7	0	0	0	1	1	0	0	7	1	0	7	1	0
2560969	Secure_Real-time_Transport_Protocol	200510	1	0	0	0	1	1	0	0	8	2	0	8	2	0
2560969	Secure_Real-time_Transport_Protocol	200601	2	0	0	0	1	1	0	0	10	3	0	10	3	0
2560969	Secure_Real-time_Transport_Protocol	200602	3	0	0	0	3	3	0	0	13	6	0	13	6	0
2560969	Secure_Real-time_Transport_Protocol	200603	7	1	0	0	5	3	1	0	20	11	1	17	9	0
2560969	Secure_Real-time_Transport_Protocol	200604	1	0	0	0	1	1	0	0	21	12	1	18	10	0
2560969	Secure_Real-time_Transport_Protocol	200605	1	0	0	0	1	0	0	0	22	13	1	18	10	0
2560969	Secure_Real-time_Transport_Protocol	200606	2	0	0	0	2	1	0	0	24	15	1	19	11	0
2560969	Secure_Real-time_Transport_Protocol	200607	4	0	0	0	3	2	0	0	28	18	1	21	13	0
2560969	Secure_Real-time_Transport_Protocol	200609	2	0	0	0	2	1	0	0	30	19	1	22	14	0
2560969	Secure_Real-time_Transport_Protocol	200610	1	0	0	0	1	1	0	0	31	20	1	23	15	0
2560969	Secure_Real-time_Transport_Protocol	200611	1	0	0	0	1	1	0	0	32	20	1	24	15	0
2560969	Secure_Real-time_Transport_Protocol	200701	1	0	0	0	1	0	0	0	33	21	1	24	15	0
2560969	Secure_Real-time_Transport_Protocol	200702	5	1	0	0	5	4	1	0	38	25	2	28	18	0
2560969	Secure_Real-time_Transport_Protocol	200703	5	0	0	0	4	2	0	0	43	29	2	31	20	0
2560969	Secure_Real-time_Transport_Protocol	200704	5	0	0	0	3	1	0	0	48	32	2	33	21	0
2560969	Secure_Real-time_Transport_Protocol	200705	2	0	0	0	2	0	0	0	50	34	2	33	21	0
2560969	Secure_Real-time_Transport_Protocol	200706	6	1	0	0	5	3	1	0	56	38	3	36	23	0
2560969	Secure_Real-time_Transport_Protocol	200707	1	0	0	0	1	1	0	0	57	39	3	37	24	0
2560969	Secure_Real-time_Transport_Protocol	200708	3	0	0	0	2	1	0	0	60	41	3	38	25	0
2560969	Secure_Real-time_Transport_Protocol	200710	1	0	0	0	1	0	0	0	61	42	3	38	25	0
2560969	Secure_Real-time_Transport_Protocol	200712	2	0	0	0	2	0	0	0	63	44	3	38	25	0
2560969	Secure_Real-time_Transport_Protocol	200801	1	0	0	0	1	1	0	0	64	45	3	39	26	0
2560969	Secure_Real-time_Transport_Protocol	200802	6	0	0	0	3	1	0	0	70	48	3	43	27	0
2560969	Secure_Real-time_Transport_Protocol	200803	3	0	0	0	3	1	0	0	73	50	3	44	28	0
2560969	Secure_Real-time_Transport_Protocol	200805	10	0	0	0	3	2	0	0	83	53	3	49	30	0
2560969	Secure_Real-time_Transport_Protocol	200806	2	0	0	0	2	1	0	0	85	55	3	50	31	0
2560969	Secure_Real-time_Transport_Protocol	200807	6	1	0	0	4	1	1	0	91	59	4	51	32	0
2560969	Secure_Real-time_Transport_Protocol	200809	3	0	0	0	1	0	0	0	94	60	4	51	32	0
2560969	Secure_Real-time_Transport_Protocol	200812	3	1	0	0	2	2	1	0	97	61	5	54	33	0
2560969	Secure_Real-time_Transport_Protocol	200904	1	0	0	0	1	0	0	0	98	62	5	54	33	0
2560969	Secure_Real-time_Transport_Protocol	200911	2	1	0	0	2	1	1	0	100	63	6	55	33	0
2560969	Secure_Real-time_Transport_Protocol	200912	2	0	0	0	1	1	0	0	102	64	6	57	34	0
2560969	Secure_Real-time_Transport_Protocol	201003	2	0	0	0	2	0	0	0	104	66	6	57	34	0
2560969	Secure_Real-time_Transport_Protocol	201010	2	0	0	0	1	0	0	0	106	67	6	57	34	0
2560969	Secure_Real-time_Transport_Protocol	201101	2	0	0	0	2	1	0	0	108	69	6	58	35	0
2560969	Secure_Real-time_Transport_Protocol	201105	2	0	0	0	2	2	0	0	110	71	6	60	37	0
2560969	Secure_Real-time_Transport_Protocol	201112	1	0	0	0	1	0	0	0	111	72	6	60	37	0
2560969	Secure_Real-time_Transport_Protocol	201207	2	1	0	0	2	2	1	0	113	74	7	62	39	1
2560969	Secure_Real-time_Transport_Protocol	201212	1	0	0	0	1	1	0	0	114	75	7	63	40	1
2560969	Secure_Real-time_Transport_Protocol	201302	1	0	0	0	1	1	0	0	115	76	7	64	41	1
2560969	Secure_Real-time_Transport_Protocol	201306	1	0	0	0	1	1	0	0	116	77	7	65	42	1
2560969	Secure_Real-time_Transport_Protocol	201401	2	0	0	0	2	1	0	0	118	79	7	66	43	1
2560969	Secure_Real-time_Transport_Protocol	201405	1	0	0	0	1	0	0	0	119	80	7	66	43	1
2560969	Secure_Real-time_Transport_Protocol	201406	2	0	0	0	2	2	0	0	121	82	7	68	45	1
2560969	Secure_Real-time_Transport_Protocol	201502	2	1	0	0	2	2	1	0	123	83	8	70	46	2
2560969	Secure_Real-time_Transport_Protocol	201509	1	0	0	0	1	0	0	0	124	84	8	70	46	2
2560969	Secure_Real-time_Transport_Protocol	201601	1	0	0	0	1	1	0	0	125	85	8	71	47	2
2560969	Secure_Real-time_Transport_Protocol	201603	1	0	0	0	1	1	0	0	126	86	8	72	48	2
2560969	Secure_Real-time_Transport_Protocol	201709	1	0	0	0	1	0	0	0	127	87	8	72	48	2
2560969	Secure_Real-time_Transport_Protocol	201711	3	0	0	0	1	1	0	0	130	87	8	75	48	2
2560969	Secure_Real-time_Transport_Protocol	201712	4	2	1	0	2	1	2	1	134	88	10	76	48	3
2560969	Secure_Real-time_Transport_Protocol	201801	1	0	0	0	1	1	0	0	135	88	10	77	48	3
2560969	Secure_Real-time_Transport_Protocol	201802	6	0	0	0	3	3	0	0	141	90	10	83	50	3
2560969	Secure_Real-time_Transport_Protocol	201803	1	0	0	0	1	1	0	0	142	91	10	84	51	3
2560969	Secure_Real-time_Transport_Protocol	201805	3	1	0	0	3	2	1	0	145	92	11	86	51	3
2560969	Secure_Real-time_Transport_Protocol	201807	1	0	0	0	1	1	0	0	146	92	11	87	51	3
646233	Secure_multi-party_computation	200406	2	0	0	0	2	1	0	0	2	2	0	1	1	0
646233	Secure_multi-party_computation	200407	2	0	0	0	2	2	0	0	4	4	0	3	3	0
646233	Secure_multi-party_computation	200408	1	0	0	0	1	1	0	0	5	4	0	4	3	0
646233	Secure_multi-party_computation	200409	2	0	0	0	2	2	0	0	7	6	0	6	5	0
646233	Secure_multi-party_computation	200411	1	0	0	0	1	1	0	0	8	6	0	7	5	0
646233	Secure_multi-party_computation	200503	4	0	0	0	2	1	0	0	12	7	0	8	5	0
646233	Secure_multi-party_computation	200505	1	0	0	0	1	1	0	0	13	8	0	9	6	0
646233	Secure_multi-party_computation	200512	1	0	0	0	1	0	0	0	14	9	0	9	6	0
646233	Secure_multi-party_computation	200603	1	0	0	0	1	0	0	0	15	10	0	9	6	0
646233	Secure_multi-party_computation	200604	2	0	0	0	2	2	0	0	17	12	0	11	8	0
646233	Secure_multi-party_computation	200605	2	0	0	0	2	1	0	0	19	14	0	12	9	0
646233	Secure_multi-party_computation	200606	1	0	0	0	1	1	0	0	20	15	0	13	10	0
646233	Secure_multi-party_computation	200609	1	0	0	0	1	0	0	0	21	16	0	13	10	0
646233	Secure_multi-party_computation	200612	2	0	0	0	2	2	0	0	23	18	0	15	12	0
646233	Secure_multi-party_computation	200703	1	0	0	0	1	1	0	0	24	19	0	16	13	0
646233	Secure_multi-party_computation	200704	1	0	0	0	1	1	0	0	25	19	0	17	13	0
646233	Secure_multi-party_computation	200705	1	0	0	0	1	0	0	0	26	20	0	17	13	0
646233	Secure_multi-party_computation	200706	2	0	0	0	1	1	0	0	28	21	0	19	14	0
646233	Secure_multi-party_computation	200707	5	0	0	0	2	1	0	0	33	22	0	22	14	0
646233	Secure_multi-party_computation	200708	1	0	0	0	1	1	0	0	34	23	0	23	15	0
646233	Secure_multi-party_computation	200710	1	0	0	0	1	0	0	0	35	24	0	23	15	0
646233	Secure_multi-party_computation	200711	12	0	0	0	2	1	0	0	47	26	0	34	16	0
646233	Secure_multi-party_computation	200801	1	0	0	0	1	0	0	0	48	27	0	34	16	0
646233	Secure_multi-party_computation	200802	5	0	0	0	1	0	0	0	53	28	0	34	16	0
646233	Secure_multi-party_computation	200803	13	0	0	0	7	3	0	0	66	34	0	37	19	0
646233	Secure_multi-party_computation	200804	5	0	0	0	3	3	0	0	71	37	0	42	22	0
646233	Secure_multi-party_computation	200806	1	0	0	0	1	0	0	0	72	38	0	42	22	0
646233	Secure_multi-party_computation	200808	2	0	0	0	2	1	0	0	74	40	0	43	23	0
646233	Secure_multi-party_computation	200809	1	0	0	0	1	1	0	0	75	40	0	44	23	0
646233	Secure_multi-party_computation	200811	2	0	0	0	2	1	0	0	77	42	0	45	24	0
646233	Secure_multi-party_computation	200812	1	0	0	0	1	1	0	0	78	43	0	46	25	0
646233	Secure_multi-party_computation	200901	1	0	0	0	1	0	0	0	79	44	0	46	25	0
646233	Secure_multi-party_computation	200902	4	3	0	0	4	3	3	0	83	46	3	49	26	1
646233	Secure_multi-party_computation	200904	2	0	0	0	2	1	0	0	85	48	3	50	27	1
646233	Secure_multi-party_computation	200906	2	0	0	0	2	0	0	0	87	50	3	50	27	1
646233	Secure_multi-party_computation	200907	1	0	0	0	1	0	0	0	88	51	3	50	27	1
646233	Secure_multi-party_computation	200908	8	0	0	0	4	1	0	0	96	54	3	54	28	1
646233	Secure_multi-party_computation	200909	3	1	0	0	3	0	1	0	99	57	4	54	28	1
646233	Secure_multi-party_computation	200911	1	0	0	0	1	0	0	0	100	58	4	54	28	1
646233	Secure_multi-party_computation	201002	1	0	0	0	1	1	0	0	101	59	4	55	29	1
646233	Secure_multi-party_computation	201003	1	0	0	0	1	0	0	0	102	60	4	55	29	1
646233	Secure_multi-party_computation	201004	3	0	0	0	1	0	0	0	105	61	4	55	29	1
646233	Secure_multi-party_computation	201005	1	0	0	0	1	0	0	0	106	62	4	55	29	1
646233	Secure_multi-party_computation	201008	2	0	0	0	1	1	0	0	108	63	4	57	30	1
646233	Secure_multi-party_computation	201012	1	0	0	0	1	1	0	0	109	64	4	58	31	1
646233	Secure_multi-party_computation	201101	1	0	0	0	1	1	0	0	110	65	4	59	32	1
646233	Secure_multi-party_computation	201102	3	0	0	0	1	1	0	0	113	66	4	62	33	1
646233	Secure_multi-party_computation	201103	1	0	0	0	1	0	0	0	114	67	4	62	33	1
646233	Secure_multi-party_computation	201104	5	0	0	0	3	2	0	0	119	70	4	64	35	1
646233	Secure_multi-party_computation	201105	2	0	0	0	2	1	0	0	121	72	4	65	36	1
646233	Secure_multi-party_computation	201106	2	0	0	0	2	2	0	0	123	74	4	67	38	1
646233	Secure_multi-party_computation	201108	1	0	0	0	1	1	0	0	124	75	4	68	39	1
646233	Secure_multi-party_computation	201109	1	0	0	0	1	0	0	0	125	76	4	68	39	1
646233	Secure_multi-party_computation	201201	1	1	0	0	1	0	1	0	126	77	5	68	39	1
646233	Secure_multi-party_computation	201204	1	0	0	0	1	0	0	0	127	78	5	68	39	1
646233	Secure_multi-party_computation	201207	1	0	0	0	1	1	0	0	128	79	5	69	40	1
646233	Secure_multi-party_computation	201209	2	0	0	0	1	0	0	0	130	80	5	69	40	1
646233	Secure_multi-party_computation	201211	1	0	0	0	1	0	0	0	131	81	5	69	40	1
646233	Secure_multi-party_computation	201302	2	0	0	0	2	1	0	0	133	83	5	70	41	1
646233	Secure_multi-party_computation	201304	1	0	0	0	1	1	0	0	134	84	5	71	42	1
646233	Secure_multi-party_computation	201306	1	0	0	0	1	1	0	0	135	84	5	72	42	1
646233	Secure_multi-party_computation	201308	2	0	0	0	2	1	0	0	137	86	5	73	43	1
646233	Secure_multi-party_computation	201310	1	0	0	0	1	0	0	0	138	87	5	73	43	1
646233	Secure_multi-party_computation	201311	1	0	0	0	1	0	0	0	139	88	5	73	43	1
646233	Secure_multi-party_computation	201402	1	0	0	0	1	1	0	0	140	89	5	74	44	1
646233	Secure_multi-party_computation	201405	1	0	0	0	1	1	0	0	141	90	5	75	45	1
646233	Secure_multi-party_computation	201408	4	0	0	0	2	0	0	0	145	92	5	75	45	1
646233	Secure_multi-party_computation	201409	2	0	0	0	1	0	0	0	147	93	5	75	45	1
646233	Secure_multi-party_computation	201410	2	0	0	0	2	2	0	0	149	94	5	77	46	1
646233	Secure_multi-party_computation	201412	21	0	0	0	4	4	0	0	170	97	5	98	49	1
646233	Secure_multi-party_computation	201501	1	0	0	0	1	1	0	0	171	98	5	99	50	1
646233	Secure_multi-party_computation	201504	1	0	0	0	1	1	0	0	172	99	5	100	51	1
646233	Secure_multi-party_computation	201505	4	0	0	0	1	1	0	0	176	100	5	104	52	1
646233	Secure_multi-party_computation	201506	2	0	0	0	2	0	0	0	178	102	5	104	52	1
646233	Secure_multi-party_computation	201507	17	0	0	0	2	1	0	0	195	104	5	107	53	1
646233	Secure_multi-party_computation	201508	7	0	0	0	6	2	0	0	202	109	5	109	54	1
646233	Secure_multi-party_computation	201510	1	0	0	0	1	0	0	0	203	110	5	109	54	1
646233	Secure_multi-party_computation	201511	2	0	0	0	2	0	0	0	205	112	5	109	54	1
646233	Secure_multi-party_computation	201512	3	0	0	0	2	1	0	0	208	114	5	111	54	1
646233	Secure_multi-party_computation	201602	1	0	0	0	1	1	0	0	209	115	5	112	55	1
646233	Secure_multi-party_computation	201603	3	0	0	0	3	2	0	0	212	118	5	114	57	1
646233	Secure_multi-party_computation	201604	2	0	0	0	1	1	0	0	214	118	5	116	57	1
646233	Secure_multi-party_computation	201605	1	0	0	0	1	1	0	0	215	119	5	117	58	1
646233	Secure_multi-party_computation	201606	4	0	0	0	3	2	0	0	219	122	5	119	60	1
646233	Secure_multi-party_computation	201609	1	0	0	0	1	1	0	0	220	123	5	120	61	1
646233	Secure_multi-party_computation	201610	1	0	0	0	1	1	0	0	221	124	5	121	62	1
646233	Secure_multi-party_computation	201611	3	1	0	0	3	2	1	0	224	127	6	123	63	1
646233	Secure_multi-party_computation	201612	1	0	0	0	1	1	0	0	225	127	6	124	63	1
646233	Secure_multi-party_computation	201701	1	0	0	0	1	1	0	0	226	128	6	125	63	1
646233	Secure_multi-party_computation	201702	1	0	0	0	1	1	0	0	227	129	6	126	64	1
646233	Secure_multi-party_computation	201703	1	0	0	0	1	1	0	0	228	130	6	127	65	1
646233	Secure_multi-party_computation	201704	1	0	0	0	1	1	0	0	229	131	6	128	66	1
646233	Secure_multi-party_computation	201705	1	0	0	0	1	1	0	0	230	131	6	129	66	1
646233	Secure_multi-party_computation	201706	2	0	0	0	1	1	0	0	232	132	6	131	67	1
646233	Secure_multi-party_computation	201708	7	0	0	0	5	3	0	0	239	137	6	134	70	1
646233	Secure_multi-party_computation	201709	7	0	0	0	2	2	0	0	246	138	6	141	71	1
646233	Secure_multi-party_computation	201711	1	0	0	0	1	1	0	0	247	139	6	142	72	1
646233	Secure_multi-party_computation	201712	2	0	0	0	2	2	0	0	249	140	6	144	73	1
646233	Secure_multi-party_computation	201802	3	0	0	0	3	0	0	0	252	143	6	144	73	1
646233	Secure_multi-party_computation	201803	1	0	0	0	1	0	0	0	253	144	6	144	73	1
646233	Secure_multi-party_computation	201804	2	0	0	0	1	1	0	0	255	145	6	146	74	1
646233	Secure_multi-party_computation	201805	2	0	0	0	2	2	0	0	257	147	6	148	76	1
29123	Semantic_Web	200201	3	0	0	0	1	1	0	0	3	1	0	3	1	0
29123	Semantic_Web	200202	5	0	0	0	2	2	0	0	8	3	0	8	3	0
29123	Semantic_Web	200205	3	0	0	0	2	2	0	0	11	5	0	11	4	0
29123	Semantic_Web	200207	5	0	0	0	5	2	0	0	16	10	0	13	5	0
29123	Semantic_Web	200209	1	0	0	0	1	1	0	0	17	11	0	14	6	0
29123	Semantic_Web	200210	3	0	0	0	1	1	0	0	20	12	0	17	7	0
29123	Semantic_Web	200211	3	0	0	0	2	2	0	0	23	13	0	20	8	0
29123	Semantic_Web	200301	6	0	0	0	1	1	0	0	29	14	0	26	9	0
29123	Semantic_Web	200304	1	0	0	0	1	0	0	0	30	15	0	26	9	0
29123	Semantic_Web	200305	1	0	0	0	1	0	0	0	31	16	0	26	9	0
29123	Semantic_Web	200306	2	0	0	0	1	1	0	0	33	17	0	28	10	0
29123	Semantic_Web	200309	3	0	0	0	3	2	0	0	36	20	0	30	12	0
29123	Semantic_Web	200310	4	0	0	0	3	2	0	0	40	22	0	33	13	0
29123	Semantic_Web	200311	5	0	0	0	2	1	0	0	45	24	0	37	14	0
29123	Semantic_Web	200312	4	0	0	0	2	1	0	0	49	26	0	40	15	0
29123	Semantic_Web	200401	5	0	0	0	5	3	0	0	54	31	0	43	18	0
29123	Semantic_Web	200402	4	0	0	0	3	0	0	0	58	34	0	43	18	0
29123	Semantic_Web	200403	12	0	0	0	8	7	0	0	70	42	0	54	25	0
29123	Semantic_Web	200404	8	0	0	0	7	4	0	0	78	48	0	59	28	0
29123	Semantic_Web	200405	2	0	0	0	2	0	0	0	80	50	0	59	28	0
29123	Semantic_Web	200406	1	0	0	0	1	1	0	0	81	51	0	60	29	0
29123	Semantic_Web	200407	2	0	0	0	2	2	0	0	83	53	0	62	31	0
29123	Semantic_Web	200408	12	0	0	0	7	5	0	0	95	59	0	71	35	0
29123	Semantic_Web	200409	1	0	0	0	1	1	0	0	96	60	0	72	36	0
29123	Semantic_Web	200410	2	0	0	0	2	2	0	0	98	62	0	74	38	0
29123	Semantic_Web	200411	4	1	0	0	4	4	1	0	102	65	1	78	41	1
29123	Semantic_Web	200412	3	0	0	0	2	0	0	0	105	67	1	78	41	1
29123	Semantic_Web	200501	7	0	0	0	7	5	0	0	112	73	1	83	45	1
29123	Semantic_Web	200502	7	0	0	0	5	2	0	0	119	78	1	86	47	1
29123	Semantic_Web	200503	11	0	0	0	7	3	0	0	130	84	1	89	49	1
29123	Semantic_Web	200505	5	0	0	0	4	1	0	0	135	88	1	90	50	1
29123	Semantic_Web	200506	6	1	0	0	4	2	1	0	141	91	2	93	51	1
29123	Semantic_Web	200508	9	1	0	0	7	4	1	0	150	96	3	99	53	1
29123	Semantic_Web	200509	7	0	0	0	5	2	0	0	157	101	3	103	55	1
29123	Semantic_Web	200510	15	1	0	0	12	4	1	0	172	113	4	107	59	1
29123	Semantic_Web	200511	21	1	0	0	12	5	1	0	193	123	5	115	62	1
29123	Semantic_Web	200512	21	2	0	0	14	6	2	0	214	136	7	123	67	1
29123	Semantic_Web	200601	9	1	0	0	8	2	1	0	223	144	8	126	69	1
29123	Semantic_Web	200602	22	1	0	0	19	10	1	0	245	160	9	137	76	1
29123	Semantic_Web	200603	16	0	0	0	13	6	0	0	261	172	9	146	81	1
29123	Semantic_Web	200604	11	1	0	0	8	2	1	0	272	180	10	148	83	1
29123	Semantic_Web	200605	31	1	0	0	21	11	1	0	303	200	11	166	93	1
29123	Semantic_Web	200606	27	0	0	0	20	9	0	0	330	220	11	178	102	1
29123	Semantic_Web	200607	14	0	0	0	12	7	0	0	344	229	11	186	107	1
29123	Semantic_Web	200608	36	1	0	0	21	13	1	0	380	249	12	211	119	2
29123	Semantic_Web	200609	36	1	0	0	22	12	1	0	416	270	13	232	130	2
29123	Semantic_Web	200610	17	0	0	0	13	10	0	0	433	282	13	246	139	2
29123	Semantic_Web	200611	20	0	0	0	14	9	0	0	453	295	13	258	147	2
29123	Semantic_Web	200612	30	3	0	0	23	15	3	0	483	315	16	278	159	3
29123	Semantic_Web	200701	23	0	0	0	15	8	0	0	506	329	16	286	166	3
29123	Semantic_Web	200702	48	6	0	0	32	19	2	0	554	359	22	319	183	5
29123	Semantic_Web	200703	49	3	0	0	28	17	2	0	603	383	25	356	196	6
29123	Semantic_Web	200704	34	4	0	0	26	15	4	0	637	407	29	376	209	8
29123	Semantic_Web	200705	50	2	0	0	21	9	2	0	687	426	31	401	216	8
29123	Semantic_Web	200706	22	2	0	0	16	10	2	0	709	441	33	416	225	9
29123	Semantic_Web	200707	19	3	0	0	14	7	2	0	728	453	36	425	231	9
29123	Semantic_Web	200708	28	0	0	0	24	13	0	0	756	474	36	440	241	9
29123	Semantic_Web	200709	15	2	0	0	13	9	2	0	771	484	38	450	247	10
29123	Semantic_Web	200710	12	1	0	0	9	3	1	0	783	492	39	455	249	10
29123	Semantic_Web	200711	21	2	0	0	19	12	2	0	804	509	41	469	260	10
29123	Semantic_Web	200712	15	1	0	0	12	8	1	0	819	521	42	477	268	10
29123	Semantic_Web	200801	17	0	0	0	16	8	0	0	836	535	42	486	274	10
29123	Semantic_Web	200802	27	1	0	0	23	12	1	0	863	555	43	499	283	10
29123	Semantic_Web	200803	59	13	1	0	27	14	7	1	922	579	56	542	294	20
29123	Semantic_Web	200804	52	3	0	0	23	15	3	0	974	596	59	582	303	21
29123	Semantic_Web	200805	26	3	0	0	16	10	3	0	1000	609	62	598	310	21
29123	Semantic_Web	200806	40	6	0	0	26	17	4	0	1040	632	68	624	324	23
29123	Semantic_Web	200807	21	0	0	0	15	8	0	0	1061	646	68	636	331	23
29123	Semantic_Web	200808	22	1	0	0	18	9	1	0	1083	661	69	648	338	24
29123	Semantic_Web	200809	9	0	0	0	8	6	0	0	1092	668	69	655	343	24
29123	Semantic_Web	200810	15	2	0	0	12	4	2	0	1107	678	71	659	345	24
29123	Semantic_Web	200811	27	1	0	0	14	8	1	0	1134	689	72	677	350	24
29123	Semantic_Web	200812	22	7	0	0	16	9	6	0	1156	701	79	687	355	24
29123	Semantic_Web	200901	23	5	0	0	19	9	5	0	1179	712	84	698	358	24
29123	Semantic_Web	200902	18	5	0	0	10	4	3	0	1197	717	89	709	358	26
29123	Semantic_Web	200903	16	1	0	0	9	4	1	0	1213	723	90	715	359	26
29123	Semantic_Web	200904	14	0	0	0	11	5	0	0	1227	732	90	721	362	26
29123	Semantic_Web	200905	10	1	0	0	7	3	1	0	1237	738	91	727	364	26
29123	Semantic_Web	200906	10	1	0	0	9	4	1	0	1247	746	92	732	367	26
29123	Semantic_Web	200907	18	3	0	0	16	6	2	0	1265	760	95	740	371	26
29123	Semantic_Web	200908	14	4	0	0	11	5	3	0	1279	768	99	747	373	26
29123	Semantic_Web	200909	10	0	0	0	6	4	0	0	1289	774	99	753	377	26
29123	Semantic_Web	200910	11	1	0	0	11	6	1	0	1300	784	100	759	382	26
29123	Semantic_Web	200911	11	3	0	0	10	8	2	0	1311	793	103	768	389	27
29123	Semantic_Web	200912	40	5	1	0	20	14	4	1	1351	810	108	799	400	30
29123	Semantic_Web	201001	15	4	0	0	13	8	4	0	1366	821	112	808	406	32
29123	Semantic_Web	201002	11	2	0	0	8	4	2	0	1377	827	114	813	408	33
29123	Semantic_Web	201003	17	1	0	0	7	5	1	0	1394	833	115	822	412	34
29123	Semantic_Web	201004	25	6	0	0	17	11	5	0	1419	843	121	837	417	35
29123	Semantic_Web	201005	6	0	0	0	4	0	0	0	1425	847	121	837	417	35
29123	Semantic_Web	201006	10	1	0	0	8	4	1	0	1435	854	122	842	420	35
29123	Semantic_Web	201007	18	3	0	0	11	6	3	0	1453	862	125	853	423	36
29123	Semantic_Web	201008	17	5	0	0	15	10	5	0	1470	875	130	863	431	36
29123	Semantic_Web	201009	27	9	1	0	15	11	7	1	1497	888	139	885	440	43
29123	Semantic_Web	201010	11	2	0	0	9	7	1	0	1508	895	141	893	445	44
29123	Semantic_Web	201011	18	5	0	0	14	7	4	0	1526	906	146	902	449	44
29123	Semantic_Web	201012	45	5	0	0	15	11	5	0	1571	920	151	940	459	46
29123	Semantic_Web	201101	10	2	0	0	8	5	2	0	1581	925	153	946	461	47
29123	Semantic_Web	201102	14	1	0	0	12	9	1	0	1595	934	154	957	467	48
29123	Semantic_Web	201103	12	3	1	0	7	6	3	1	1607	940	157	968	472	50
29123	Semantic_Web	201104	11	3	0	0	10	6	3	0	1618	948	160	974	476	52
29123	Semantic_Web	201105	17	4	0	0	11	9	3	0	1635	956	164	987	482	53
29123	Semantic_Web	201106	8	2	0	0	8	7	2	0	1643	962	166	994	487	54
29123	Semantic_Web	201107	13	3	0	0	9	4	2	0	1656	968	169	999	488	54
29123	Semantic_Web	201108	22	1	0	0	11	8	1	0	1678	976	170	1013	493	54
29123	Semantic_Web	201109	7	0	0	0	6	5	0	0	1685	979	170	1018	495	54
29123	Semantic_Web	201110	32	1	0	0	18	10	1	0	1717	995	171	1041	503	54
29123	Semantic_Web	201111	6	0	0	0	5	4	0	0	1723	1000	171	1046	507	54
29123	Semantic_Web	201112	57	1	0	0	15	6	1	0	1780	1014	172	1064	512	54
29123	Semantic_Web	201201	10	1	0	0	8	5	1	0	1790	1021	173	1069	516	55
29123	Semantic_Web	201202	1	0	0	0	1	1	0	0	1791	1021	173	1070	516	55
29123	Semantic_Web	201203	9	3	0	0	8	6	2	0	1800	1027	176	1077	520	56
29123	Semantic_Web	201204	3	1	0	0	3	0	1	0	1803	1030	177	1077	520	56
29123	Semantic_Web	201205	6	0	0	0	5	2	0	0	1809	1035	177	1080	522	56
29123	Semantic_Web	201206	12	0	0	0	6	4	0	0	1821	1038	177	1088	524	56
29123	Semantic_Web	201207	17	2	0	0	9	7	2	0	1838	1044	179	1102	528	58
29123	Semantic_Web	201208	6	1	0	0	6	4	1	0	1844	1047	180	1106	529	58
29123	Semantic_Web	201209	12	0	0	0	8	5	0	0	1856	1053	180	1114	532	58
29123	Semantic_Web	201210	3	0	0	0	3	3	0	0	1859	1056	180	1117	535	58
29123	Semantic_Web	201211	10	1	0	0	7	3	1	0	1869	1062	181	1121	537	58
29123	Semantic_Web	201212	10	2	0	0	7	4	2	0	1879	1066	183	1127	538	58
29123	Semantic_Web	201301	6	4	3	2	2	1	2	2	1885	1067	187	1130	538	59
29123	Semantic_Web	201302	10	1	0	0	5	4	1	0	1895	1071	188	1139	541	59
29123	Semantic_Web	201303	13	1	0	0	9	7	1	0	1908	1079	189	1150	547	59
29123	Semantic_Web	201304	4	0	0	0	4	2	0	0	1912	1082	189	1152	548	59
29123	Semantic_Web	201305	3	1	0	0	3	2	1	0	1915	1084	190	1154	549	59
29123	Semantic_Web	201306	4	0	0	0	4	1	0	0	1919	1088	190	1155	550	59
29123	Semantic_Web	201307	8	0	0	0	5	4	0	0	1927	1092	190	1160	553	59
29123	Semantic_Web	201308	3	0	0	0	3	2	0	0	1930	1095	190	1162	555	59
29123	Semantic_Web	201309	11	2	0	0	8	6	2	0	1941	1101	192	1171	559	59
29123	Semantic_Web	201310	4	0	0	0	4	3	0	0	1945	1105	192	1174	562	59
29123	Semantic_Web	201311	22	5	0	0	13	9	4	0	1967	1117	197	1191	570	60
29123	Semantic_Web	201312	8	0	0	0	7	5	0	0	1975	1121	197	1197	572	60
29123	Semantic_Web	201401	2	0	0	0	2	2	0	0	1977	1123	197	1199	574	60
29123	Semantic_Web	201402	5	0	0	0	5	5	0	0	1982	1128	197	1204	578	60
29123	Semantic_Web	201403	4	0	0	0	4	2	0	0	1986	1132	197	1206	580	60
29123	Semantic_Web	201404	5	0	0	0	4	2	0	0	1991	1135	197	1208	581	60
29123	Semantic_Web	201405	4	1	0	0	4	2	1	0	1995	1138	198	1210	582	60
29123	Semantic_Web	201406	1	0	0	0	1	1	0	0	1996	1139	198	1211	583	60
29123	Semantic_Web	201407	5	1	0	0	5	3	1	0	2001	1143	199	1214	585	60
29123	Semantic_Web	201408	5	0	0	0	5	3	0	0	2006	1147	199	1217	587	60
29123	Semantic_Web	201409	2	1	0	0	2	2	1	0	2008	1148	200	1219	588	61
29123	Semantic_Web	201410	5	1	0	0	4	1	1	0	2013	1151	201	1220	588	61
29123	Semantic_Web	201411	5	1	0	0	5	4	1	0	2018	1154	202	1224	590	61
29123	Semantic_Web	201412	2	0	0	0	2	0	0	0	2020	1156	202	1224	590	61
29123	Semantic_Web	201501	3	1	0	0	3	2	1	0	2023	1158	203	1226	591	61
29123	Semantic_Web	201502	5	1	0	0	4	2	1	0	2028	1161	204	1228	592	61
29123	Semantic_Web	201503	6	0	0	0	5	4	0	0	2034	1164	204	1232	594	61
29123	Semantic_Web	201504	18	3	0	0	8	3	2	0	2052	1171	207	1244	596	62
29123	Semantic_Web	201505	7	1	0	0	7	6	1	0	2059	1174	208	1250	598	62
29123	Semantic_Web	201506	1	0	0	0	1	1	0	0	2060	1175	208	1251	599	62
29123	Semantic_Web	201507	5	0	0	0	4	3	0	0	2065	1179	208	1254	602	62
29123	Semantic_Web	201508	2	0	0	0	2	2	0	0	2067	1180	208	1256	603	62
29123	Semantic_Web	201509	1	0	0	0	1	1	0	0	2068	1181	208	1257	604	62
29123	Semantic_Web	201510	3	1	0	0	3	1	1	0	2071	1184	209	1258	605	62
29123	Semantic_Web	201511	9	3	0	0	5	3	3	0	2080	1187	212	1261	606	62
29123	Semantic_Web	201512	6	0	0	0	4	3	0	0	2086	1189	212	1265	607	62
29123	Semantic_Web	201601	9	3	0	0	7	4	3	0	2095	1195	215	1269	610	62
29123	Semantic_Web	201603	10	3	0	0	8	4	3	0	2105	1201	218	1275	612	64
29123	Semantic_Web	201605	7	1	0	0	5	3	1	0	2112	1206	219	1280	615	64
29123	Semantic_Web	201606	1	0	0	0	1	0	0	0	2113	1207	219	1280	615	64
29123	Semantic_Web	201607	10	1	0	0	7	6	1	0	2123	1213	220	1289	620	65
29123	Semantic_Web	201608	2	0	0	0	2	2	0	0	2125	1214	220	1291	621	65
29123	Semantic_Web	201609	6	2	0	0	4	3	2	0	2131	1216	222	1294	622	66
29123	Semantic_Web	201611	8	2	0	0	6	5	1	0	2139	1221	224	1301	626	67
29123	Semantic_Web	201612	6	2	0	0	4	4	2	0	2145	1223	226	1307	628	69
29123	Semantic_Web	201701	6	1	0	0	5	4	1	0	2151	1226	227	1311	630	69
29123	Semantic_Web	201702	7	1	0	0	5	4	1	0	2158	1228	228	1317	631	69
29123	Semantic_Web	201703	5	0	0	0	4	4	0	0	2163	1232	228	1322	635	69
29123	Semantic_Web	201705	3	1	0	0	3	2	1	0	2166	1235	229	1324	637	69
29123	Semantic_Web	201706	2	0	0	0	2	1	0	0	2168	1237	229	1325	638	69
29123	Semantic_Web	201707	6	2	0	0	6	5	2	0	2174	1242	231	1330	641	70
29123	Semantic_Web	201709	3	1	0	0	3	2	1	0	2177	1245	232	1332	643	70
29123	Semantic_Web	201710	2	0	0	0	2	1	0	0	2179	1247	232	1333	644	70
29123	Semantic_Web	201711	6	2	0	0	6	4	2	0	2185	1252	234	1337	647	70
29123	Semantic_Web	201712	6	2	0	0	6	4	2	0	2191	1256	236	1341	649	70
29123	Semantic_Web	201801	2	1	0	0	2	2	1	0	2193	1257	237	1343	649	71
29123	Semantic_Web	201802	2	0	0	0	2	2	0	0	2195	1258	237	1345	650	71
29123	Semantic_Web	201804	7	0	0	0	4	3	0	0	2202	1262	237	1350	653	71
29123	Semantic_Web	201805	2	0	0	0	2	2	0	0	2204	1264	237	1352	655	71
29123	Semantic_Web	201806	1	0	0	0	1	0	0	0	2205	1265	237	1352	655	71
29123	Semantic_Web	201807	3	0	0	0	2	1	0	0	2208	1266	237	1353	655	71
14271782	Semantic_analysis_(machine_learning)	200810	2	0	0	0	1	1	0	0	2	1	0	2	1	0
14271782	Semantic_analysis_(machine_learning)	200902	2	0	0	0	2	2	0	0	4	3	0	4	3	0
14271782	Semantic_analysis_(machine_learning)	200903	1	0	0	0	1	1	0	0	5	4	0	5	4	0
14271782	Semantic_analysis_(machine_learning)	201102	1	1	0	0	1	1	1	0	6	5	1	6	5	1
14271782	Semantic_analysis_(machine_learning)	201106	1	0	0	0	1	1	0	0	7	6	1	7	6	1
14271782	Semantic_analysis_(machine_learning)	201404	1	0	0	0	1	1	0	0	8	7	1	8	7	1
14271782	Semantic_analysis_(machine_learning)	201405	3	0	0	0	1	1	0	0	11	8	1	11	8	1
14271782	Semantic_analysis_(machine_learning)	201607	1	0	0	0	1	1	0	0	12	9	1	12	9	1
14271782	Semantic_analysis_(machine_learning)	201708	1	0	0	0	1	1	0	0	13	10	1	13	10	1
14271782	Semantic_analysis_(machine_learning)	201711	2	0	0	0	2	1	0	0	15	12	1	14	11	1
666924	Service-oriented_architecture	200406	3	0	0	0	3	2	0	0	3	3	0	2	2	0
666924	Service-oriented_architecture	200408	12	0	0	0	5	4	0	0	15	8	0	12	6	0
666924	Service-oriented_architecture	200410	1	0	0	0	1	0	0	0	16	9	0	12	6	0
666924	Service-oriented_architecture	200411	3	0	0	0	3	1	0	0	19	12	0	13	7	0
666924	Service-oriented_architecture	200412	1	0	0	0	1	1	0	0	20	13	0	14	8	0
666924	Service-oriented_architecture	200501	2	0	0	0	1	1	0	0	22	14	0	16	9	0
666924	Service-oriented_architecture	200502	8	0	0	0	5	2	0	0	30	19	0	18	11	0
666924	Service-oriented_architecture	200503	9	0	0	0	5	1	0	0	39	24	0	19	12	0
666924	Service-oriented_architecture	200504	5	0	0	0	4	1	0	0	44	28	0	21	13	0
666924	Service-oriented_architecture	200505	15	1	0	0	11	4	1	0	59	36	1	26	15	0
666924	Service-oriented_architecture	200506	11	2	0	0	10	4	1	0	70	44	3	31	18	0
666924	Service-oriented_architecture	200507	4	1	0	0	4	2	1	0	74	47	4	33	19	0
666924	Service-oriented_architecture	200508	12	1	0	0	8	3	1	0	86	53	5	39	20	0
666924	Service-oriented_architecture	200509	13	0	0	0	10	4	0	0	99	63	5	46	24	0
666924	Service-oriented_architecture	200510	32	1	0	0	20	7	1	0	131	81	6	58	30	0
666924	Service-oriented_architecture	200511	32	0	0	0	25	9	0	0	163	104	6	68	37	0
666924	Service-oriented_architecture	200512	34	0	0	0	22	3	0	0	197	126	6	71	40	0
666924	Service-oriented_architecture	200601	24	1	0	0	20	9	1	0	221	144	7	80	48	0
666924	Service-oriented_architecture	200602	42	1	0	0	24	7	1	0	263	166	8	88	53	0
666924	Service-oriented_architecture	200603	20	2	0	0	13	8	1	0	283	176	10	100	58	0
666924	Service-oriented_architecture	200604	32	2	0	0	21	8	2	0	315	195	12	111	65	1
666924	Service-oriented_architecture	200605	63	3	0	0	27	12	3	0	378	221	15	144	76	2
666924	Service-oriented_architecture	200606	40	4	0	0	28	14	4	0	418	246	19	165	87	2
666924	Service-oriented_architecture	200607	49	2	0	0	29	10	2	0	467	272	21	185	96	2
666924	Service-oriented_architecture	200608	77	5	0	0	33	16	5	0	544	302	26	236	109	3
666924	Service-oriented_architecture	200609	45	3	0	0	26	18	3	0	589	323	29	268	122	4
666924	Service-oriented_architecture	200610	56	3	0	0	39	23	3	0	645	358	32	304	141	5
666924	Service-oriented_architecture	200611	49	3	0	0	31	12	3	0	694	384	35	322	148	5
666924	Service-oriented_architecture	200612	79	6	0	0	41	20	5	0	773	423	41	353	166	6
666924	Service-oriented_architecture	200701	56	4	0	0	35	17	4	0	829	451	45	377	178	7
666924	Service-oriented_architecture	200702	37	2	0	0	28	13	2	0	866	474	47	394	188	8
666924	Service-oriented_architecture	200703	46	7	0	0	35	16	6	0	912	505	54	414	200	10
666924	Service-oriented_architecture	200704	49	6	0	0	36	12	6	0	961	535	60	428	208	11
666924	Service-oriented_architecture	200705	45	7	0	0	30	14	6	0	1006	559	67	449	217	14
666924	Service-oriented_architecture	200706	44	7	0	0	27	8	6	0	1050	585	74	470	224	16
666924	Service-oriented_architecture	200707	34	8	0	0	23	9	6	0	1084	602	82	484	228	19
666924	Service-oriented_architecture	200708	55	10	1	0	34	19	7	1	1139	630	92	524	242	25
666924	Service-oriented_architecture	200709	91	13	0	0	45	18	8	0	1230	667	105	560	253	31
666924	Service-oriented_architecture	200710	58	5	0	0	35	13	3	0	1288	696	110	582	261	32
666924	Service-oriented_architecture	200711	73	8	0	0	48	17	4	0	1361	738	118	615	272	33
666924	Service-oriented_architecture	200712	54	5	0	0	28	12	4	0	1415	759	123	640	279	34
666924	Service-oriented_architecture	200801	29	5	0	0	22	12	5	0	1444	775	128	653	287	37
666924	Service-oriented_architecture	200802	57	11	0	0	43	18	10	0	1501	812	139	678	301	38
666924	Service-oriented_architecture	200803	58	9	1	0	31	13	5	1	1559	839	148	696	310	40
666924	Service-oriented_architecture	200804	37	5	0	0	25	13	2	0	1596	861	153	718	320	41
666924	Service-oriented_architecture	200805	39	6	0	0	30	14	5	0	1635	885	159	737	330	43
666924	Service-oriented_architecture	200806	62	11	1	0	35	17	7	1	1697	916	170	768	343	46
666924	Service-oriented_architecture	200807	44	3	0	0	24	8	3	0	1741	934	173	778	345	46
666924	Service-oriented_architecture	200808	56	9	0	0	36	17	5	0	1797	966	182	804	358	48
666924	Service-oriented_architecture	200809	81	33	12	4	35	14	13	5	1878	998	215	854	369	66
666924	Service-oriented_architecture	200810	17	5	2	1	12	7	3	1	1895	1007	220	864	374	68
666924	Service-oriented_architecture	200811	35	7	1	0	22	16	6	1	1930	1025	227	891	386	71
666924	Service-oriented_architecture	200812	19	3	0	0	17	9	3	0	1949	1039	230	902	392	71
666924	Service-oriented_architecture	200901	27	4	0	0	19	9	3	0	1976	1052	234	913	398	72
666924	Service-oriented_architecture	200902	48	10	2	1	27	11	7	2	2024	1073	244	938	406	75
666924	Service-oriented_architecture	200903	9	0	0	0	7	3	0	0	2033	1080	244	942	409	75
666924	Service-oriented_architecture	200904	39	3	0	0	24	16	3	0	2072	1101	247	972	422	76
666924	Service-oriented_architecture	200905	14	2	0	0	12	6	2	0	2086	1112	249	978	427	77
666924	Service-oriented_architecture	200906	35	3	0	0	22	10	3	0	2121	1130	252	997	434	77
666924	Service-oriented_architecture	200907	28	2	0	0	20	11	2	0	2149	1146	254	1011	442	78
666924	Service-oriented_architecture	200908	14	3	0	0	12	7	3	0	2163	1155	257	1020	446	79
666924	Service-oriented_architecture	200909	16	1	0	0	11	4	1	0	2179	1164	258	1026	449	79
666924	Service-oriented_architecture	200910	15	0	0	0	11	8	0	0	2194	1174	258	1035	456	79
666924	Service-oriented_architecture	200911	30	2	0	0	21	10	2	0	2224	1192	260	1052	463	81
666924	Service-oriented_architecture	200912	32	8	0	0	21	13	6	0	2256	1210	268	1073	473	85
666924	Service-oriented_architecture	201001	11	1	0	0	8	6	1	0	2267	1216	269	1082	477	85
666924	Service-oriented_architecture	201002	21	2	0	0	11	7	2	0	2288	1221	271	1096	478	85
666924	Service-oriented_architecture	201003	20	3	0	0	17	5	3	0	2308	1235	274	1101	480	85
666924	Service-oriented_architecture	201004	16	2	0	0	9	5	2	0	2324	1240	276	1111	481	86
666924	Service-oriented_architecture	201005	10	1	0	0	8	4	1	0	2334	1248	277	1115	485	86
666924	Service-oriented_architecture	201006	12	3	0	0	12	8	3	0	2346	1258	280	1123	491	87
666924	Service-oriented_architecture	201007	18	4	0	0	11	4	2	0	2364	1266	284	1129	492	88
666924	Service-oriented_architecture	201008	11	3	1	0	8	4	3	1	2375	1272	287	1134	494	89
666924	Service-oriented_architecture	201009	15	1	0	0	9	3	1	0	2390	1278	288	1138	495	89
666924	Service-oriented_architecture	201010	37	8	1	0	16	10	3	1	2427	1289	296	1161	500	95
666924	Service-oriented_architecture	201011	32	4	0	0	14	10	2	0	2459	1301	300	1189	508	98
666924	Service-oriented_architecture	201012	10	3	0	0	8	6	3	0	2469	1306	303	1197	511	99
666924	Service-oriented_architecture	201101	9	1	0	0	8	4	1	0	2478	1312	304	1201	513	99
666924	Service-oriented_architecture	201102	23	4	0	0	16	8	4	0	2501	1326	308	1212	519	99
666924	Service-oriented_architecture	201103	10	2	0	0	9	6	2	0	2511	1332	310	1219	522	99
666924	Service-oriented_architecture	201104	4	0	0	0	4	3	0	0	2515	1336	310	1222	525	99
666924	Service-oriented_architecture	201105	4	0	0	0	3	3	0	0	2519	1337	310	1226	526	99
666924	Service-oriented_architecture	201106	14	2	0	0	11	6	2	0	2533	1345	312	1233	529	100
666924	Service-oriented_architecture	201107	8	0	0	0	6	5	0	0	2541	1350	312	1239	533	100
666924	Service-oriented_architecture	201108	14	3	0	0	9	5	3	0	2555	1357	315	1246	536	102
666924	Service-oriented_architecture	201109	9	0	0	0	4	4	0	0	2564	1361	315	1255	540	102
666924	Service-oriented_architecture	201110	18	0	0	0	7	5	0	0	2582	1366	315	1270	543	102
666924	Service-oriented_architecture	201111	16	3	0	0	9	4	2	0	2598	1373	318	1275	545	102
666924	Service-oriented_architecture	201112	5	0	0	0	4	1	0	0	2603	1377	318	1276	546	102
666924	Service-oriented_architecture	201201	10	3	0	0	9	4	3	0	2613	1385	321	1280	549	102
666924	Service-oriented_architecture	201202	9	1	0	0	8	6	1	0	2622	1392	322	1287	554	102
666924	Service-oriented_architecture	201203	3	0	0	0	3	1	0	0	2625	1394	322	1288	554	102
666924	Service-oriented_architecture	201204	8	1	0	0	7	0	1	0	2633	1400	323	1288	554	102
666924	Service-oriented_architecture	201205	8	0	0	0	6	0	0	0	2641	1406	323	1288	554	102
666924	Service-oriented_architecture	201206	9	0	0	0	8	4	0	0	2650	1413	323	1293	557	102
666924	Service-oriented_architecture	201207	10	0	0	0	10	8	0	0	2660	1420	323	1301	562	102
666924	Service-oriented_architecture	201208	8	0	0	0	4	4	0	0	2668	1423	323	1309	565	102
666924	Service-oriented_architecture	201209	21	1	0	0	12	8	1	0	2689	1433	324	1326	571	102
666924	Service-oriented_architecture	201210	8	0	0	0	7	5	0	0	2697	1439	324	1332	575	102
666924	Service-oriented_architecture	201211	5	1	0	0	5	1	1	0	2702	1443	325	1333	575	102
666924	Service-oriented_architecture	201212	13	1	0	0	10	5	1	0	2715	1450	326	1340	577	102
666924	Service-oriented_architecture	201301	3	0	0	0	2	0	0	0	2718	1452	326	1340	577	102
666924	Service-oriented_architecture	201302	11	4	2	1	7	5	3	2	2729	1458	330	1346	581	103
666924	Service-oriented_architecture	201303	6	0	0	0	5	4	0	0	2735	1463	330	1351	585	103
666924	Service-oriented_architecture	201304	15	3	0	0	10	6	3	0	2750	1470	333	1357	588	104
666924	Service-oriented_architecture	201305	10	4	0	0	7	2	2	0	2760	1476	337	1361	589	104
666924	Service-oriented_architecture	201306	7	0	0	0	6	4	0	0	2767	1482	337	1365	592	104
666924	Service-oriented_architecture	201307	13	0	0	0	11	7	0	0	2780	1490	337	1372	596	104
666924	Service-oriented_architecture	201308	13	1	0	0	10	3	1	0	2793	1499	338	1376	598	105
666924	Service-oriented_architecture	201309	9	1	0	0	8	3	1	0	2802	1506	339	1379	599	105
666924	Service-oriented_architecture	201310	7	0	0	0	4	2	0	0	2809	1510	339	1383	601	105
666924	Service-oriented_architecture	201311	13	1	0	0	6	4	1	0	2822	1514	340	1394	603	105
666924	Service-oriented_architecture	201312	17	1	0	0	9	5	1	0	2839	1520	341	1405	605	105
666924	Service-oriented_architecture	201401	15	4	0	0	11	6	4	0	2854	1529	345	1412	609	105
666924	Service-oriented_architecture	201402	16	0	0	0	9	3	0	0	2870	1538	345	1419	612	105
666924	Service-oriented_architecture	201403	9	2	0	0	7	5	2	0	2879	1543	347	1425	615	105
666924	Service-oriented_architecture	201404	11	2	0	0	9	4	2	0	2890	1552	349	1429	619	106
666924	Service-oriented_architecture	201405	2	0	0	0	2	0	0	0	2892	1554	349	1429	619	106
666924	Service-oriented_architecture	201406	10	0	0	0	7	2	0	0	2902	1560	349	1432	620	106
666924	Service-oriented_architecture	201407	8	0	0	0	6	5	0	0	2910	1564	349	1439	623	106
666924	Service-oriented_architecture	201408	12	0	0	0	9	3	0	0	2922	1571	349	1443	624	106
666924	Service-oriented_architecture	201409	1	0	0	0	1	0	0	0	2923	1572	349	1443	624	106
666924	Service-oriented_architecture	201410	5	0	0	0	5	4	0	0	2928	1577	349	1447	628	106
666924	Service-oriented_architecture	201411	19	1	0	0	10	9	1	0	2947	1584	350	1465	634	106
666924	Service-oriented_architecture	201412	8	1	0	0	7	5	1	0	2955	1589	351	1471	637	106
666924	Service-oriented_architecture	201501	5	1	0	0	5	3	1	0	2960	1593	352	1474	639	106
666924	Service-oriented_architecture	201502	6	2	0	0	5	1	1	0	2966	1597	354	1476	639	106
666924	Service-oriented_architecture	201503	11	0	0	0	5	4	0	0	2977	1601	354	1483	642	106
666924	Service-oriented_architecture	201504	1	0	0	0	1	1	0	0	2978	1602	354	1484	643	106
666924	Service-oriented_architecture	201505	19	2	0	0	11	8	2	0	2997	1610	356	1500	648	106
666924	Service-oriented_architecture	201506	8	0	0	0	7	5	0	0	3005	1615	356	1506	651	106
666924	Service-oriented_architecture	201507	4	0	0	0	4	2	0	0	3009	1618	356	1508	652	106
666924	Service-oriented_architecture	201509	7	1	0	0	4	1	1	0	3016	1621	357	1509	652	106
666924	Service-oriented_architecture	201510	10	2	0	0	6	3	2	0	3026	1626	359	1515	654	106
666924	Service-oriented_architecture	201511	2	0	0	0	2	1	0	0	3028	1628	359	1516	655	106
666924	Service-oriented_architecture	201512	4	0	0	0	4	2	0	0	3032	1631	359	1518	657	106
666924	Service-oriented_architecture	201601	3	1	0	0	3	2	1	0	3035	1633	360	1520	658	106
666924	Service-oriented_architecture	201602	4	0	0	0	2	2	0	0	3039	1635	360	1524	660	106
666924	Service-oriented_architecture	201603	4	0	0	0	3	2	0	0	3043	1637	360	1527	661	106
666924	Service-oriented_architecture	201604	2	0	0	0	2	2	0	0	3045	1639	360	1529	663	106
666924	Service-oriented_architecture	201605	1	0	0	0	1	0	0	0	3046	1640	360	1529	663	106
666924	Service-oriented_architecture	201606	3	0	0	0	2	1	0	0	3049	1642	360	1530	664	106
666924	Service-oriented_architecture	201607	4	0	0	0	3	1	0	0	3053	1645	360	1531	665	106
666924	Service-oriented_architecture	201609	6	0	0	0	4	1	0	0	3059	1649	360	1532	666	106
666924	Service-oriented_architecture	201610	53	0	0	0	15	11	0	0	3112	1661	360	1565	673	106
666924	Service-oriented_architecture	201611	19	3	0	0	16	9	3	0	3131	1673	363	1575	678	107
666924	Service-oriented_architecture	201612	18	0	0	0	8	3	0	0	3149	1680	363	1579	680	107
666924	Service-oriented_architecture	201701	6	0	0	0	4	1	0	0	3155	1683	363	1580	680	107
666924	Service-oriented_architecture	201702	14	0	0	0	8	5	0	0	3169	1690	363	1589	684	107
666924	Service-oriented_architecture	201703	4	0	0	0	2	0	0	0	3173	1692	363	1589	684	107
666924	Service-oriented_architecture	201704	4	0	0	0	3	2	0	0	3177	1695	363	1592	686	107
666924	Service-oriented_architecture	201705	3	0	0	0	3	2	0	0	3180	1698	363	1594	688	107
666924	Service-oriented_architecture	201706	3	0	0	0	2	2	0	0	3183	1700	363	1597	690	107
666924	Service-oriented_architecture	201707	1	0	0	0	1	1	0	0	3184	1701	363	1598	691	107
666924	Service-oriented_architecture	201708	4	0	0	0	2	2	0	0	3188	1703	363	1602	692	107
666924	Service-oriented_architecture	201709	11	1	0	0	9	4	1	0	3199	1710	364	1606	694	107
666924	Service-oriented_architecture	201711	1	0	0	0	1	0	0	0	3200	1711	364	1606	694	107
666924	Service-oriented_architecture	201712	1	0	0	0	1	1	0	0	3201	1712	364	1607	695	107
666924	Service-oriented_architecture	201802	4	0	0	0	4	2	0	0	3205	1716	364	1609	697	107
666924	Service-oriented_architecture	201803	1	0	0	0	1	1	0	0	3206	1717	364	1610	698	107
666924	Service-oriented_architecture	201804	2	1	0	0	2	1	1	0	3208	1718	365	1611	698	107
666924	Service-oriented_architecture	201805	2	0	0	0	2	1	0	0	3210	1720	365	1612	699	107
666924	Service-oriented_architecture	201806	1	0	0	0	1	1	0	0	3211	1720	365	1613	699	107
666924	Service-oriented_architecture	201807	4	0	0	0	3	1	0	0	3215	1723	365	1614	700	107
28702	Session_Description_Protocol	200212	1	0	0	0	1	1	0	0	1	1	0	1	1	0
28702	Session_Description_Protocol	200404	1	0	0	0	1	1	0	0	2	2	0	2	2	0
28702	Session_Description_Protocol	200407	1	0	0	0	1	1	0	0	3	3	0	3	3	0
28702	Session_Description_Protocol	200408	3	0	0	0	1	0	0	0	6	4	0	3	3	0
28702	Session_Description_Protocol	200502	1	0	0	0	1	1	0	0	7	5	0	4	4	0
28702	Session_Description_Protocol	200503	1	0	0	0	1	1	0	0	8	6	0	5	5	0
28702	Session_Description_Protocol	200505	1	0	0	0	1	1	0	0	9	7	0	6	6	0
28702	Session_Description_Protocol	200508	2	0	0	0	2	1	0	0	11	9	0	7	7	0
28702	Session_Description_Protocol	200509	1	0	0	0	1	1	0	0	12	10	0	8	8	0
28702	Session_Description_Protocol	200511	3	0	0	0	2	2	0	0	15	12	0	11	10	0
28702	Session_Description_Protocol	200512	1	0	0	0	1	0	0	0	16	13	0	11	10	0
28702	Session_Description_Protocol	200601	2	1	0	0	2	1	1	0	18	15	1	12	11	0
28702	Session_Description_Protocol	200602	2	0	0	0	2	2	0	0	20	17	1	14	13	0
28702	Session_Description_Protocol	200603	4	0	0	0	3	2	0	0	24	19	1	16	14	0
28702	Session_Description_Protocol	200604	2	0	0	0	2	1	0	0	26	21	1	17	15	0
28702	Session_Description_Protocol	200605	1	0	0	0	1	0	0	0	27	22	1	17	15	0
28702	Session_Description_Protocol	200607	1	0	0	0	1	0	0	0	28	23	1	17	15	0
28702	Session_Description_Protocol	200608	3	0	0	0	1	0	0	0	31	24	1	17	15	0
28702	Session_Description_Protocol	200609	4	0	0	0	3	1	0	0	35	27	1	18	16	0
28702	Session_Description_Protocol	200612	3	0	0	0	2	1	0	0	38	29	1	20	17	0
28702	Session_Description_Protocol	200702	2	0	0	0	2	2	0	0	40	31	1	22	19	0
28702	Session_Description_Protocol	200703	1	0	0	0	1	0	0	0	41	32	1	22	19	0
28702	Session_Description_Protocol	200708	2	0	0	0	2	1	0	0	43	34	1	23	20	0
28702	Session_Description_Protocol	200711	1	0	0	0	1	1	0	0	44	35	1	24	21	0
28702	Session_Description_Protocol	200803	8	0	0	0	4	3	0	0	52	39	1	27	24	0
28702	Session_Description_Protocol	200804	3	0	0	0	3	2	0	0	55	42	1	29	26	0
28702	Session_Description_Protocol	200805	3	0	0	0	2	2	0	0	58	44	1	32	28	0
28702	Session_Description_Protocol	200806	4	0	0	0	4	3	0	0	62	47	1	35	30	0
28702	Session_Description_Protocol	200809	1	0	0	0	1	1	0	0	63	48	1	36	31	0
28702	Session_Description_Protocol	200810	3	1	0	0	3	2	1	0	66	49	2	38	32	0
28702	Session_Description_Protocol	200902	4	0	0	0	1	1	0	0	70	50	2	42	33	0
28702	Session_Description_Protocol	200903	2	0	0	0	2	1	0	0	72	52	2	43	34	0
28702	Session_Description_Protocol	200904	2	0	0	0	2	1	0	0	74	53	2	44	34	0
28702	Session_Description_Protocol	200906	2	0	0	0	2	2	0	0	76	55	2	46	36	0
28702	Session_Description_Protocol	200911	3	0	0	0	3	2	0	0	79	58	2	48	38	0
28702	Session_Description_Protocol	201001	1	0	0	0	1	1	0	0	80	59	2	49	39	0
28702	Session_Description_Protocol	201002	3	1	0	0	2	1	1	0	83	60	3	50	39	0
28702	Session_Description_Protocol	201004	1	0	0	0	1	1	0	0	84	60	3	51	39	0
28702	Session_Description_Protocol	201006	1	0	0	0	1	1	0	0	85	61	3	52	40	0
28702	Session_Description_Protocol	201008	1	0	0	0	1	1	0	0	86	62	3	53	41	0
28702	Session_Description_Protocol	201012	2	0	0	0	1	1	0	0	88	63	3	55	42	0
28702	Session_Description_Protocol	201102	2	0	0	0	1	0	0	0	90	64	3	55	42	0
28702	Session_Description_Protocol	201103	1	0	0	0	1	0	0	0	91	65	3	55	42	0
28702	Session_Description_Protocol	201104	2	0	0	0	2	1	0	0	93	67	3	56	43	0
28702	Session_Description_Protocol	201107	1	0	0	0	1	1	0	0	94	68	3	57	44	0
28702	Session_Description_Protocol	201110	8	0	0	0	2	2	0	0	102	70	3	65	46	0
28702	Session_Description_Protocol	201203	1	0	0	0	1	0	0	0	103	71	3	65	46	0
28702	Session_Description_Protocol	201209	2	1	0	0	2	0	1	0	105	73	4	65	46	0
28702	Session_Description_Protocol	201211	4	0	0	0	1	0	0	0	109	74	4	65	46	0
28702	Session_Description_Protocol	201301	15	1	0	0	3	2	1	0	124	76	5	79	47	0
28702	Session_Description_Protocol	201302	3	0	0	0	3	3	0	0	127	79	5	82	50	0
28702	Session_Description_Protocol	201303	1	0	0	0	1	1	0	0	128	80	5	83	51	0
28702	Session_Description_Protocol	201308	1	0	0	0	1	1	0	0	129	81	5	84	52	0
28702	Session_Description_Protocol	201309	2	0	0	0	1	0	0	0	131	82	5	84	52	0
28702	Session_Description_Protocol	201311	1	0	0	0	1	1	0	0	132	83	5	85	53	0
28702	Session_Description_Protocol	201312	2	1	0	0	2	1	1	0	134	84	6	86	53	0
28702	Session_Description_Protocol	201407	1	0	0	0	1	1	0	0	135	85	6	87	54	0
28702	Session_Description_Protocol	201409	4	0	0	0	4	3	0	0	139	89	6	90	57	0
28702	Session_Description_Protocol	201501	4	0	0	0	2	1	0	0	143	90	6	93	57	0
28702	Session_Description_Protocol	201505	2	1	0	0	2	1	1	0	145	91	7	94	57	0
28702	Session_Description_Protocol	201509	1	0	0	0	1	1	0	0	146	92	7	95	57	0
28702	Session_Description_Protocol	201603	1	0	0	0	1	0	0	0	147	93	7	95	57	0
28702	Session_Description_Protocol	201606	1	0	0	0	1	1	0	0	148	94	7	96	58	0
28702	Session_Description_Protocol	201707	4	0	0	0	1	1	0	0	152	95	7	100	59	0
28702	Session_Description_Protocol	201708	1	0	0	0	1	0	0	0	153	96	7	100	59	0
28702	Session_Description_Protocol	201709	2	0	0	0	2	2	0	0	155	97	7	102	60	0
28702	Session_Description_Protocol	201710	1	0	0	0	1	0	0	0	156	98	7	102	60	0
28702	Session_Description_Protocol	201805	1	0	0	0	1	1	0	0	157	98	7	103	60	0
28684	Session_Initiation_Protocol	200202	2	0	0	0	2	2	0	0	2	2	0	2	2	0
28684	Session_Initiation_Protocol	200208	1	0	0	0	1	1	0	0	3	3	0	3	3	0
28684	Session_Initiation_Protocol	200211	3	0	0	0	3	1	0	0	6	6	0	4	4	0
28684	Session_Initiation_Protocol	200301	1	0	0	0	1	0	0	0	7	7	0	4	4	0
28684	Session_Initiation_Protocol	200305	1	0	0	0	1	1	0	0	8	8	0	5	5	0
28684	Session_Initiation_Protocol	200306	3	0	0	0	2	2	0	0	11	10	0	8	7	0
28684	Session_Initiation_Protocol	200307	5	0	0	0	5	3	0	0	16	14	0	11	9	0
28684	Session_Initiation_Protocol	200308	1	0	0	0	1	1	0	0	17	15	0	12	10	0
28684	Session_Initiation_Protocol	200310	1	0	0	0	1	0	0	0	18	16	0	12	10	0
28684	Session_Initiation_Protocol	200311	1	0	0	0	1	1	0	0	19	17	0	13	11	0
28684	Session_Initiation_Protocol	200401	3	0	0	0	2	2	0	0	22	19	0	16	13	0
28684	Session_Initiation_Protocol	200403	2	0	0	0	2	1	0	0	24	21	0	17	14	0
28684	Session_Initiation_Protocol	200404	4	0	0	0	3	2	0	0	28	24	0	20	16	0
28684	Session_Initiation_Protocol	200405	7	0	0	0	6	4	0	0	35	28	0	25	18	0
28684	Session_Initiation_Protocol	200406	3	0	0	0	2	1	0	0	38	30	0	27	19	0
28684	Session_Initiation_Protocol	200407	3	0	0	0	1	1	0	0	41	30	0	30	19	0
28684	Session_Initiation_Protocol	200408	4	0	0	0	3	2	0	0	45	32	0	32	21	0
28684	Session_Initiation_Protocol	200409	1	0	0	0	1	0	0	0	46	33	0	32	21	0
28684	Session_Initiation_Protocol	200410	8	0	0	0	7	2	0	0	54	39	0	34	22	0
28684	Session_Initiation_Protocol	200411	6	0	0	0	5	3	0	0	60	43	0	37	25	0
28684	Session_Initiation_Protocol	200412	3	0	0	0	3	0	0	0	63	46	0	37	25	0
28684	Session_Initiation_Protocol	200501	6	0	0	0	5	2	0	0	69	51	0	40	27	0
28684	Session_Initiation_Protocol	200502	5	0	0	0	4	2	0	0	74	55	0	42	29	0
28684	Session_Initiation_Protocol	200503	5	1	0	0	5	1	1	0	79	60	1	43	30	0
28684	Session_Initiation_Protocol	200504	16	0	0	0	7	0	0	0	95	67	1	43	30	0
28684	Session_Initiation_Protocol	200505	13	0	0	0	8	1	0	0	108	75	1	46	31	0
28684	Session_Initiation_Protocol	200506	15	0	0	0	8	2	0	0	123	83	1	48	33	0
28684	Session_Initiation_Protocol	200507	16	0	0	0	10	1	0	0	139	91	1	50	34	0
28684	Session_Initiation_Protocol	200508	24	0	0	0	12	4	0	0	163	103	1	57	38	0
28684	Session_Initiation_Protocol	200509	24	1	0	0	16	4	1	0	187	117	2	61	41	0
28684	Session_Initiation_Protocol	200510	25	0	0	0	15	6	0	0	212	132	2	70	47	0
28684	Session_Initiation_Protocol	200511	24	2	0	0	13	8	1	0	236	144	4	81	55	0
28684	Session_Initiation_Protocol	200512	19	1	0	0	15	6	1	0	255	158	5	88	60	0
28684	Session_Initiation_Protocol	200601	11	0	0	0	9	5	0	0	266	165	5	94	64	0
28684	Session_Initiation_Protocol	200602	13	1	0	0	13	6	1	0	279	178	6	100	70	0
28684	Session_Initiation_Protocol	200603	20	2	0	0	14	6	2	0	299	189	8	109	74	1
28684	Session_Initiation_Protocol	200604	26	1	0	0	20	12	1	0	325	207	9	123	84	1
28684	Session_Initiation_Protocol	200605	5	0	0	0	5	2	0	0	330	212	9	125	86	1
28684	Session_Initiation_Protocol	200606	26	0	0	0	15	9	0	0	356	225	9	140	94	1
28684	Session_Initiation_Protocol	200607	20	1	0	0	15	5	1	0	376	238	10	145	97	2
28684	Session_Initiation_Protocol	200608	20	0	0	0	14	3	0	0	396	250	10	150	99	2
28684	Session_Initiation_Protocol	200609	34	1	0	0	20	9	1	0	430	267	11	166	108	2
28684	Session_Initiation_Protocol	200610	20	2	0	0	15	8	2	0	450	281	13	176	115	2
28684	Session_Initiation_Protocol	200611	32	6	0	0	23	12	3	0	482	301	19	196	125	5
28684	Session_Initiation_Protocol	200612	27	4	0	0	18	8	3	0	509	318	23	210	132	5
28684	Session_Initiation_Protocol	200701	12	1	0	0	9	5	1	0	521	325	24	216	136	5
28684	Session_Initiation_Protocol	200702	37	6	0	0	19	9	5	0	558	339	30	227	141	5
28684	Session_Initiation_Protocol	200703	19	3	0	0	14	7	3	0	577	350	33	237	145	5
28684	Session_Initiation_Protocol	200704	11	5	0	0	10	5	4	0	588	358	38	243	148	6
28684	Session_Initiation_Protocol	200705	7	0	0	0	5	4	0	0	595	363	38	248	152	6
28684	Session_Initiation_Protocol	200706	10	0	0	0	8	5	0	0	605	371	38	255	157	6
28684	Session_Initiation_Protocol	200707	15	2	0	0	11	6	2	0	620	381	40	265	162	6
28684	Session_Initiation_Protocol	200708	15	2	0	0	10	5	1	0	635	389	42	275	165	6
28684	Session_Initiation_Protocol	200709	14	2	0	0	10	7	2	0	649	397	44	285	170	7
28684	Session_Initiation_Protocol	200710	5	1	0	0	4	3	1	0	654	400	45	289	172	7
28684	Session_Initiation_Protocol	200711	9	4	0	0	5	2	3	0	663	404	49	292	174	8
28684	Session_Initiation_Protocol	200712	7	3	0	0	5	1	1	0	670	408	52	295	174	8
28684	Session_Initiation_Protocol	200801	9	1	0	0	4	3	1	0	679	411	53	303	176	9
28684	Session_Initiation_Protocol	200802	7	3	0	0	7	4	3	0	686	417	56	307	179	9
28684	Session_Initiation_Protocol	200803	15	3	0	0	10	7	3	0	701	426	59	318	185	10
28684	Session_Initiation_Protocol	200804	2	0	0	0	1	1	0	0	703	427	59	320	186	10
28684	Session_Initiation_Protocol	200805	5	0	0	0	4	3	0	0	708	430	59	324	188	10
28684	Session_Initiation_Protocol	200806	7	2	0	0	7	2	2	0	715	435	61	326	188	10
28684	Session_Initiation_Protocol	200807	12	3	0	0	7	7	2	0	727	440	64	338	193	13
28684	Session_Initiation_Protocol	200808	15	2	0	0	9	6	2	0	742	447	66	349	197	14
28684	Session_Initiation_Protocol	200809	2	0	0	0	2	2	0	0	744	449	66	351	199	14
28684	Session_Initiation_Protocol	200810	6	2	0	0	6	3	2	0	750	453	68	354	200	14
28684	Session_Initiation_Protocol	200811	26	3	0	0	15	7	2	0	776	465	71	365	204	15
28684	Session_Initiation_Protocol	200812	4	1	0	0	4	1	1	0	780	467	72	366	204	15
28684	Session_Initiation_Protocol	200901	15	2	0	0	10	7	2	0	795	473	74	375	207	15
28684	Session_Initiation_Protocol	200902	9	0	0	0	6	3	0	0	804	478	74	380	209	15
28684	Session_Initiation_Protocol	200903	2	0	0	0	2	2	0	0	806	480	74	382	211	15
28684	Session_Initiation_Protocol	200904	15	1	0	0	5	3	1	0	821	483	75	395	212	15
28684	Session_Initiation_Protocol	200905	12	1	0	0	9	7	1	0	833	489	76	405	216	15
28684	Session_Initiation_Protocol	200906	14	3	0	0	11	6	3	0	847	499	79	412	221	16
28684	Session_Initiation_Protocol	200907	8	1	0	0	6	4	1	0	855	504	80	417	224	17
28684	Session_Initiation_Protocol	200908	19	2	0	0	7	4	2	0	874	508	82	432	225	18
28684	Session_Initiation_Protocol	200909	22	4	0	0	10	8	2	0	896	515	86	448	230	19
28684	Session_Initiation_Protocol	200910	8	2	0	0	7	6	2	0	904	520	88	454	234	19
28684	Session_Initiation_Protocol	200911	3	1	0	0	3	2	1	0	907	522	89	456	235	19
28684	Session_Initiation_Protocol	200912	14	3	0	0	10	7	2	0	921	530	92	465	240	19
28684	Session_Initiation_Protocol	201001	10	3	0	0	7	4	1	0	931	535	95	472	243	20
28684	Session_Initiation_Protocol	201002	18	4	0	0	11	7	3	0	949	543	99	485	247	21
28684	Session_Initiation_Protocol	201003	15	4	0	0	10	6	2	0	964	550	103	496	250	22
28684	Session_Initiation_Protocol	201004	10	2	0	0	7	4	2	0	974	556	105	502	253	22
28684	Session_Initiation_Protocol	201005	12	1	0	0	11	7	1	0	986	565	106	510	258	23
28684	Session_Initiation_Protocol	201006	5	0	0	0	3	1	0	0	991	568	106	511	259	23
28684	Session_Initiation_Protocol	201007	10	0	0	0	10	8	0	0	1001	578	106	519	267	23
28684	Session_Initiation_Protocol	201008	7	0	0	0	7	6	0	0	1008	582	106	525	270	23
28684	Session_Initiation_Protocol	201009	17	4	0	0	11	6	3	0	1025	589	110	534	272	24
28684	Session_Initiation_Protocol	201010	11	4	0	0	10	5	4	0	1036	596	114	539	275	24
28684	Session_Initiation_Protocol	201011	5	0	0	0	4	3	0	0	1041	600	114	543	278	24
28684	Session_Initiation_Protocol	201012	4	1	0	0	4	2	1	0	1045	603	115	545	279	24
28684	Session_Initiation_Protocol	201101	4	1	0	0	3	1	1	0	1049	605	116	546	279	24
28684	Session_Initiation_Protocol	201102	11	0	0	0	7	6	0	0	1060	609	116	555	282	24
28684	Session_Initiation_Protocol	201103	4	1	0	0	3	1	1	0	1064	611	117	556	282	24
28684	Session_Initiation_Protocol	201104	1	0	0	0	1	1	0	0	1065	612	117	557	283	24
28684	Session_Initiation_Protocol	201105	6	1	0	0	5	3	1	0	1071	616	118	560	285	24
28684	Session_Initiation_Protocol	201106	4	0	0	0	3	3	0	0	1075	618	118	564	287	24
28684	Session_Initiation_Protocol	201107	6	2	0	0	5	3	2	0	1081	622	120	568	289	24
28684	Session_Initiation_Protocol	201108	8	2	0	0	7	6	2	0	1089	628	122	575	294	25
28684	Session_Initiation_Protocol	201109	11	2	0	0	4	4	2	0	1100	630	124	586	296	27
28684	Session_Initiation_Protocol	201110	8	3	0	0	7	3	3	0	1108	634	127	589	296	27
28684	Session_Initiation_Protocol	201111	5	1	0	0	4	3	1	0	1113	637	128	593	298	27
28684	Session_Initiation_Protocol	201112	14	5	0	0	10	9	4	0	1127	642	133	604	302	31
28684	Session_Initiation_Protocol	201201	9	2	0	0	7	5	2	0	1136	647	135	609	305	33
28684	Session_Initiation_Protocol	201202	6	1	0	0	6	4	1	0	1142	650	136	613	306	33
28684	Session_Initiation_Protocol	201203	6	1	0	0	5	3	1	0	1148	653	137	616	307	33
28684	Session_Initiation_Protocol	201204	12	2	0	0	8	4	2	0	1160	659	139	623	309	33
28684	Session_Initiation_Protocol	201205	7	1	0	0	7	4	1	0	1167	663	140	627	310	33
28684	Session_Initiation_Protocol	201206	6	1	0	0	6	4	1	0	1173	668	141	631	313	34
28684	Session_Initiation_Protocol	201207	1	0	0	0	1	0	0	0	1174	669	141	631	313	34
28684	Session_Initiation_Protocol	201208	2	0	0	0	2	1	0	0	1176	671	141	632	314	34
28684	Session_Initiation_Protocol	201209	1	0	0	0	1	1	0	0	1177	672	141	633	314	34
28684	Session_Initiation_Protocol	201210	8	2	0	0	4	2	2	0	1185	675	143	635	315	34
28684	Session_Initiation_Protocol	201211	12	2	0	0	7	3	1	0	1197	681	145	640	317	34
28684	Session_Initiation_Protocol	201301	6	2	0	0	5	3	2	0	1203	684	147	643	318	34
28684	Session_Initiation_Protocol	201302	3	0	0	0	3	1	0	0	1206	687	147	644	319	34
28684	Session_Initiation_Protocol	201303	13	3	0	0	11	6	2	0	1219	696	150	651	323	34
28684	Session_Initiation_Protocol	201304	8	2	0	0	6	2	1	0	1227	701	152	654	324	34
28684	Session_Initiation_Protocol	201305	5	1	0	0	5	4	1	0	1232	706	153	658	328	34
28684	Session_Initiation_Protocol	201306	9	2	0	0	7	4	2	0	1241	710	155	663	329	34
28684	Session_Initiation_Protocol	201307	5	1	0	0	4	2	1	0	1246	714	156	665	331	34
28684	Session_Initiation_Protocol	201308	3	1	0	0	3	1	1	0	1249	717	157	666	332	34
28684	Session_Initiation_Protocol	201310	4	1	0	0	4	2	1	0	1253	720	158	668	333	34
28684	Session_Initiation_Protocol	201311	6	2	0	0	4	2	2	0	1259	722	160	670	333	34
28684	Session_Initiation_Protocol	201312	4	1	0	0	4	2	1	0	1263	724	161	672	333	34
28684	Session_Initiation_Protocol	201401	15	3	0	0	8	5	2	0	1278	730	164	678	335	36
28684	Session_Initiation_Protocol	201403	1	0	0	0	1	1	0	0	1279	731	164	679	336	36
28684	Session_Initiation_Protocol	201404	8	1	0	0	4	1	1	0	1287	734	165	680	336	36
28684	Session_Initiation_Protocol	201405	6	1	0	0	3	1	1	0	1293	736	166	681	336	36
28684	Session_Initiation_Protocol	201406	10	2	0	0	8	6	2	0	1303	740	168	687	338	36
28684	Session_Initiation_Protocol	201407	2	0	0	0	2	1	0	0	1305	742	168	688	339	36
28684	Session_Initiation_Protocol	201409	10	1	0	0	6	4	1	0	1315	747	169	696	342	37
28684	Session_Initiation_Protocol	201410	7	0	0	0	5	4	0	0	1322	750	169	702	344	37
28684	Session_Initiation_Protocol	201411	4	0	0	0	2	1	0	0	1326	752	169	703	345	37
28684	Session_Initiation_Protocol	201412	3	1	0	0	2	1	1	0	1329	754	170	704	346	37
28684	Session_Initiation_Protocol	201501	3	0	0	0	2	1	0	0	1332	756	170	705	347	37
28684	Session_Initiation_Protocol	201502	11	2	0	0	6	5	2	0	1343	760	172	715	350	39
28684	Session_Initiation_Protocol	201503	7	0	0	0	3	3	0	0	1350	761	172	722	351	39
28684	Session_Initiation_Protocol	201504	8	2	0	0	6	4	2	0	1358	765	174	728	353	39
28684	Session_Initiation_Protocol	201505	8	1	0	0	7	6	1	0	1366	769	175	735	356	39
28684	Session_Initiation_Protocol	201506	3	0	0	0	2	1	0	0	1369	770	175	737	356	39
28684	Session_Initiation_Protocol	201507	5	2	0	0	4	2	1	0	1374	773	177	740	357	39
28684	Session_Initiation_Protocol	201508	4	1	0	0	3	0	1	0	1378	776	178	740	357	39
28684	Session_Initiation_Protocol	201509	4	0	0	0	4	4	0	0	1382	778	178	744	359	39
28684	Session_Initiation_Protocol	201510	7	2	0	0	7	4	2	0	1389	783	180	748	360	40
28684	Session_Initiation_Protocol	201511	4	0	0	0	3	2	0	0	1393	785	180	751	360	40
28684	Session_Initiation_Protocol	201512	3	1	0	0	2	1	1	0	1396	786	181	752	360	40
28684	Session_Initiation_Protocol	201601	6	1	0	0	4	3	1	0	1402	789	182	756	362	40
28684	Session_Initiation_Protocol	201603	3	0	0	0	3	2	0	0	1405	791	182	758	363	40
28684	Session_Initiation_Protocol	201604	5	1	0	0	4	3	1	0	1410	793	183	762	364	40
28684	Session_Initiation_Protocol	201605	8	2	0	0	5	3	2	0	1418	796	185	765	365	40
28684	Session_Initiation_Protocol	201606	17	3	2	1	3	3	2	2	1435	798	188	782	367	43
28684	Session_Initiation_Protocol	201607	8	0	0	0	4	3	0	0	1443	801	188	789	369	43
28684	Session_Initiation_Protocol	201608	9	3	2	2	6	6	3	2	1452	802	191	798	370	46
28684	Session_Initiation_Protocol	201609	10	1	0	0	5	4	1	0	1462	804	192	807	371	46
28684	Session_Initiation_Protocol	201610	8	1	0	0	4	3	1	0	1470	806	193	814	372	46
28684	Session_Initiation_Protocol	201611	6	1	0	0	5	4	1	0	1476	809	194	819	374	46
28684	Session_Initiation_Protocol	201701	6	1	0	0	6	5	1	0	1482	813	195	824	377	47
28684	Session_Initiation_Protocol	201702	1	0	0	0	1	0	0	0	1483	814	195	824	377	47
28684	Session_Initiation_Protocol	201703	12	1	0	0	4	3	1	0	1495	817	196	835	379	48
28684	Session_Initiation_Protocol	201704	20	7	0	0	9	7	5	0	1515	822	203	853	381	53
28684	Session_Initiation_Protocol	201706	11	3	3	1	4	4	2	2	1526	824	206	864	383	56
28684	Session_Initiation_Protocol	201707	3	0	0	0	2	1	0	0	1529	826	206	865	384	56
28684	Session_Initiation_Protocol	201708	17	3	1	1	6	5	3	1	1546	829	209	877	386	59
28684	Session_Initiation_Protocol	201709	3	1	0	0	3	1	1	0	1549	831	210	878	386	59
28684	Session_Initiation_Protocol	201710	1	0	0	0	1	0	0	0	1550	832	210	878	386	59
28684	Session_Initiation_Protocol	201711	5	1	0	0	4	2	1	0	1555	834	211	881	386	59
28684	Session_Initiation_Protocol	201712	5	2	0	0	4	3	1	0	1560	837	213	885	387	60
28684	Session_Initiation_Protocol	201801	7	0	0	0	5	5	0	0	1567	839	213	892	389	60
28684	Session_Initiation_Protocol	201802	13	5	2	1	9	6	4	2	1580	845	218	901	392	63
28684	Session_Initiation_Protocol	201804	1	0	0	0	1	1	0	0	1581	845	218	902	392	63
28684	Session_Initiation_Protocol	201805	3	0	0	0	2	1	0	0	1584	847	218	903	393	63
28684	Session_Initiation_Protocol	201807	10	4	0	0	6	4	2	0	1594	853	222	909	396	64
5604205	Smart_contract	200607	6	0	0	0	3	2	0	0	6	3	0	5	2	0
5604205	Smart_contract	200608	5	0	0	0	2	1	0	0	11	5	0	6	3	0
5604205	Smart_contract	200609	11	0	0	0	2	2	0	0	22	6	0	17	4	0
5604205	Smart_contract	200701	1	0	0	0	1	0	0	0	23	7	0	17	4	0
5604205	Smart_contract	200702	1	0	0	0	1	1	0	0	24	8	0	18	5	0
5604205	Smart_contract	200710	3	0	0	0	1	1	0	0	27	8	0	21	5	0
5604205	Smart_contract	200711	1	0	0	0	1	1	0	0	28	9	0	22	6	0
5604205	Smart_contract	200803	1	0	0	0	1	1	0	0	29	10	0	23	7	0
5604205	Smart_contract	200905	1	0	0	0	1	1	0	0	30	11	0	24	8	0
5604205	Smart_contract	200906	1	0	0	0	1	1	0	0	31	12	0	25	9	0
5604205	Smart_contract	200909	1	1	0	0	1	1	1	0	32	13	1	26	10	1
5604205	Smart_contract	200912	1	0	0	0	1	1	0	0	33	14	1	27	11	1
5604205	Smart_contract	201003	2	0	0	0	2	2	0	0	35	16	1	29	13	1
5604205	Smart_contract	201007	1	0	0	0	1	0	0	0	36	17	1	29	13	1
5604205	Smart_contract	201108	1	0	0	0	1	0	0	0	37	18	1	29	13	1
5604205	Smart_contract	201111	1	0	0	0	1	0	0	0	38	19	1	29	13	1
5604205	Smart_contract	201202	1	0	0	0	1	1	0	0	39	20	1	30	14	1
5604205	Smart_contract	201210	3	0	0	0	1	0	0	0	42	21	1	30	14	1
5604205	Smart_contract	201212	1	0	0	0	1	0	0	0	43	22	1	30	14	1
5604205	Smart_contract	201301	2	0	0	0	1	1	0	0	45	23	1	32	15	1
5604205	Smart_contract	201302	1	0	0	0	1	1	0	0	46	24	1	33	16	1
5604205	Smart_contract	201303	1	0	0	0	1	1	0	0	47	25	1	34	17	1
5604205	Smart_contract	201306	1	0	0	0	1	1	0	0	48	26	1	35	18	1
5604205	Smart_contract	201308	3	0	0	0	1	1	0	0	51	27	1	38	19	1
5604205	Smart_contract	201401	2	0	0	0	1	1	0	0	53	28	1	40	20	1
5604205	Smart_contract	201402	14	0	0	0	3	2	0	0	67	31	1	53	22	1
5604205	Smart_contract	201404	1	0	0	0	1	1	0	0	68	32	1	54	23	1
5604205	Smart_contract	201408	5	0	0	0	4	2	0	0	73	36	1	56	25	1
5604205	Smart_contract	201411	1	0	0	0	1	1	0	0	74	37	1	57	26	1
5604205	Smart_contract	201412	1	0	0	0	1	1	0	0	75	38	1	58	27	1
5604205	Smart_contract	201507	9	2	0	0	3	2	2	0	84	41	3	65	29	2
5604205	Smart_contract	201508	1	0	0	0	1	0	0	0	85	42	3	65	29	2
5604205	Smart_contract	201509	1	0	0	0	1	1	0	0	86	43	3	66	30	2
5604205	Smart_contract	201511	7	0	0	0	2	2	0	0	93	45	3	73	32	2
5604205	Smart_contract	201512	3	1	0	0	3	2	1	0	96	47	4	75	33	2
5604205	Smart_contract	201602	2	1	0	0	2	1	1	0	98	49	5	76	34	3
5604205	Smart_contract	201603	5	1	0	0	5	5	1	0	103	53	6	81	38	4
5604205	Smart_contract	201604	4	1	0	0	4	4	1	0	107	56	7	85	41	5
5604205	Smart_contract	201605	1	0	0	0	1	0	0	0	108	57	7	85	41	5
5604205	Smart_contract	201606	7	0	0	0	7	6	0	0	115	62	7	91	45	5
5604205	Smart_contract	201607	6	0	0	0	5	4	0	0	121	65	7	96	46	5
5604205	Smart_contract	201608	3	0	0	0	1	1	0	0	124	65	7	99	46	5
5604205	Smart_contract	201609	4	0	0	0	3	3	0	0	128	65	7	103	46	5
5604205	Smart_contract	201610	21	2	0	0	10	6	1	0	149	73	9	115	50	5
5604205	Smart_contract	201611	11	2	0	0	3	3	1	0	160	74	11	126	51	7
5604205	Smart_contract	201612	15	0	0	0	6	6	0	0	175	77	11	141	54	7
5604205	Smart_contract	201701	10	0	0	0	5	5	0	0	185	80	11	151	57	7
5604205	Smart_contract	201702	8	0	0	0	3	3	0	0	193	82	11	159	59	7
5604205	Smart_contract	201703	2	0	0	0	1	0	0	0	195	83	11	159	59	7
5604205	Smart_contract	201704	9	0	0	0	4	3	0	0	204	85	11	167	60	7
5604205	Smart_contract	201705	2	0	0	0	2	1	0	0	206	87	11	168	61	7
5604205	Smart_contract	201706	3	0	0	0	2	1	0	0	209	89	11	170	62	7
5604205	Smart_contract	201707	28	2	0	0	7	5	1	0	237	93	13	195	64	8
5604205	Smart_contract	201708	12	0	0	0	8	6	0	0	249	100	13	205	67	8
5604205	Smart_contract	201709	7	1	0	0	5	5	1	0	256	104	14	212	71	9
5604205	Smart_contract	201710	9	2	0	0	6	5	1	0	265	108	16	220	74	11
5604205	Smart_contract	201711	45	10	0	0	13	8	3	0	310	118	26	256	78	16
5604205	Smart_contract	201712	7	2	0	0	5	4	2	0	317	120	28	262	79	17
5604205	Smart_contract	201801	14	3	0	0	9	7	3	0	331	127	31	272	85	18
5604205	Smart_contract	201802	7	1	0	0	5	3	1	0	338	131	32	275	86	18
5604205	Smart_contract	201803	5	1	0	0	5	3	1	0	343	136	33	278	89	18
5604205	Smart_contract	201804	54	12	4	3	13	11	4	2	397	144	45	311	95	27
5604205	Smart_contract	201805	10	2	0	0	7	7	2	0	407	148	47	321	99	29
5604205	Smart_contract	201806	12	2	0	0	6	5	2	0	419	152	49	327	102	30
5604205	Smart_contract	201807	15	4	0	0	12	11	4	0	434	160	53	341	109	33
13201685	Smart_grid	200712	8	1	0	0	3	3	1	0	8	3	1	8	3	1
13201685	Smart_grid	200801	13	2	0	0	7	5	2	0	21	9	3	19	7	2
13201685	Smart_grid	200802	13	0	0	0	7	4	0	0	34	15	3	26	10	2
13201685	Smart_grid	200803	5	0	0	0	4	1	0	0	39	19	3	27	11	2
13201685	Smart_grid	200804	4	0	0	0	3	3	0	0	43	21	3	31	13	2
13201685	Smart_grid	200805	9	0	0	0	2	1	0	0	52	22	3	39	13	2
13201685	Smart_grid	200806	15	0	0	0	5	3	0	0	67	27	3	48	16	2
13201685	Smart_grid	200807	9	0	0	0	7	3	0	0	76	34	3	51	19	2
13201685	Smart_grid	200808	12	0	0	0	7	5	0	0	88	41	3	58	24	2
13201685	Smart_grid	200809	3	0	0	0	3	0	0	0	91	44	3	58	24	2
13201685	Smart_grid	200810	7	0	0	0	5	2	0	0	98	49	3	60	26	2
13201685	Smart_grid	200811	19	0	0	0	10	3	0	0	117	59	3	64	29	2
13201685	Smart_grid	200812	18	1	0	0	6	3	1	0	135	65	4	78	32	2
13201685	Smart_grid	200901	31	0	0	0	14	11	0	0	166	74	4	106	38	2
13201685	Smart_grid	200902	23	0	0	0	10	5	0	0	189	83	4	122	42	2
13201685	Smart_grid	200903	28	2	0	0	22	7	2	0	217	103	6	135	47	2
13201685	Smart_grid	200904	36	0	0	0	26	12	0	0	253	126	6	149	56	2
13201685	Smart_grid	200905	31	3	0	0	20	15	3	0	284	141	9	174	66	5
13201685	Smart_grid	200906	24	0	0	0	13	5	0	0	308	153	9	189	70	5
13201685	Smart_grid	200907	19	0	0	0	13	5	0	0	327	165	9	196	75	5
13201685	Smart_grid	200908	19	0	0	0	15	6	0	0	346	176	9	204	78	5
13201685	Smart_grid	200909	21	3	0	0	16	6	3	0	367	191	12	215	83	5
13201685	Smart_grid	200910	31	4	2	1	17	10	3	2	398	203	16	236	88	7
13201685	Smart_grid	200911	39	1	0	0	20	10	1	0	437	220	17	253	96	7
13201685	Smart_grid	200912	32	4	0	0	25	15	4	0	469	239	21	274	107	9
13201685	Smart_grid	201001	16	2	0	0	13	7	2	0	485	249	23	282	111	9
13201685	Smart_grid	201002	2	1	0	0	2	1	1	0	487	250	24	283	111	9
13201685	Smart_grid	201003	13	2	0	0	10	6	2	0	500	258	26	289	116	11
13201685	Smart_grid	201004	25	3	0	0	16	8	3	0	525	273	29	305	123	11
13201685	Smart_grid	201005	28	2	0	0	12	6	1	0	553	282	31	325	127	11
13201685	Smart_grid	201006	8	0	0	0	6	2	0	0	561	287	31	329	128	11
13201685	Smart_grid	201007	20	5	0	0	15	10	3	0	581	300	36	343	136	13
13201685	Smart_grid	201008	14	1	0	0	13	10	1	0	595	312	37	354	145	14
13201685	Smart_grid	201009	15	2	0	0	14	10	2	0	610	321	39	365	150	14
13201685	Smart_grid	201010	17	0	0	0	14	7	0	0	627	330	39	375	154	14
13201685	Smart_grid	201011	10	1	0	0	4	2	1	0	637	334	40	382	156	14
13201685	Smart_grid	201012	20	2	0	0	16	10	1	0	657	347	42	396	163	14
13201685	Smart_grid	201101	25	4	0	0	19	12	4	0	682	365	46	412	174	15
13201685	Smart_grid	201102	16	4	0	0	13	8	4	0	698	375	50	420	179	16
13201685	Smart_grid	201103	11	2	0	0	8	6	2	0	709	380	52	426	182	17
13201685	Smart_grid	201104	15	2	0	0	10	8	1	0	724	388	54	439	188	19
13201685	Smart_grid	201105	13	2	0	0	10	5	2	0	737	396	56	445	191	20
13201685	Smart_grid	201106	17	0	0	0	13	9	0	0	754	405	56	458	196	20
13201685	Smart_grid	201107	10	0	0	0	4	3	0	0	764	407	56	465	197	20
13201685	Smart_grid	201108	19	2	0	0	6	3	1	0	783	412	58	481	199	21
13201685	Smart_grid	201109	16	2	0	0	12	6	2	0	799	421	60	488	202	21
13201685	Smart_grid	201110	12	0	0	0	11	7	0	0	811	431	60	496	208	21
13201685	Smart_grid	201111	13	0	0	0	9	6	0	0	824	436	60	506	210	21
13201685	Smart_grid	201112	17	2	0	0	7	4	1	0	841	442	62	514	213	21
13201685	Smart_grid	201201	19	1	0	0	16	8	1	0	860	454	63	524	217	21
13201685	Smart_grid	201202	14	3	0	0	10	6	2	0	874	462	66	534	221	23
13201685	Smart_grid	201203	21	7	1	0	13	9	4	1	895	470	73	549	225	28
13201685	Smart_grid	201204	20	4	0	0	10	8	3	0	915	477	77	558	230	28
13201685	Smart_grid	201205	10	0	0	0	6	5	0	0	925	482	77	567	234	28
13201685	Smart_grid	201206	22	2	0	0	16	6	2	0	947	495	79	576	237	28
13201685	Smart_grid	201207	7	0	0	0	5	3	0	0	954	500	79	581	240	28
13201685	Smart_grid	201208	12	2	0	0	9	7	2	0	966	508	81	591	246	28
13201685	Smart_grid	201209	21	0	0	0	8	7	0	0	987	514	81	610	251	28
13201685	Smart_grid	201210	28	0	0	0	5	4	0	0	1015	517	81	637	253	28
13201685	Smart_grid	201211	4	1	0	0	4	2	1	0	1019	521	82	639	255	28
13201685	Smart_grid	201212	3	0	0	0	3	2	0	0	1022	524	82	641	257	28
13201685	Smart_grid	201301	17	0	0	0	9	7	0	0	1039	528	82	656	259	28
13201685	Smart_grid	201302	16	1	0	0	12	7	1	0	1055	538	83	664	264	28
13201685	Smart_grid	201303	2	0	0	0	2	2	0	0	1057	540	83	666	266	28
13201685	Smart_grid	201304	14	1	0	0	7	3	1	0	1071	546	84	669	268	28
13201685	Smart_grid	201305	11	1	0	0	9	7	1	0	1082	553	85	678	273	29
13201685	Smart_grid	201306	22	0	0	0	6	4	0	0	1104	556	85	698	274	29
13201685	Smart_grid	201307	9	2	0	0	5	2	2	0	1113	560	87	700	275	29
13201685	Smart_grid	201308	14	2	0	0	12	8	2	0	1127	571	89	709	282	30
13201685	Smart_grid	201309	1	0	0	0	1	0	0	0	1128	571	89	709	282	30
13201685	Smart_grid	201310	5	1	0	0	5	2	1	0	1133	576	90	711	284	30
13201685	Smart_grid	201311	5	0	0	0	5	3	0	0	1138	581	90	714	287	30
13201685	Smart_grid	201312	7	1	0	0	4	3	1	0	1145	585	91	720	290	31
13201685	Smart_grid	201401	9	0	0	0	6	2	0	0	1154	591	91	722	292	31
13201685	Smart_grid	201402	7	1	0	0	6	5	1	0	1161	595	92	728	295	31
13201685	Smart_grid	201403	7	2	0	0	7	4	2	0	1168	601	94	732	298	31
13201685	Smart_grid	201404	7	1	0	0	5	4	1	0	1175	605	95	738	301	31
13201685	Smart_grid	201405	17	1	0	0	9	6	1	0	1192	612	96	751	305	31
13201685	Smart_grid	201406	12	0	0	0	5	3	0	0	1204	617	96	755	308	31
13201685	Smart_grid	201407	2	0	0	0	2	2	0	0	1206	618	96	757	309	31
13201685	Smart_grid	201408	14	0	0	0	9	6	0	0	1220	624	96	767	312	31
13201685	Smart_grid	201409	3	0	0	0	3	1	0	0	1223	626	96	768	312	31
13201685	Smart_grid	201410	4	1	0	0	3	2	1	0	1227	627	97	771	312	31
13201685	Smart_grid	201411	17	0	0	0	4	1	0	0	1244	631	97	781	313	31
13201685	Smart_grid	201412	4	1	0	0	4	1	1	0	1248	635	98	782	314	31
13201685	Smart_grid	201501	9	2	0	0	4	2	1	0	1257	638	100	785	315	31
13201685	Smart_grid	201502	8	2	0	0	5	3	2	0	1265	643	102	791	318	31
13201685	Smart_grid	201503	4	0	0	0	2	0	0	0	1269	645	102	791	318	31
13201685	Smart_grid	201504	3	1	0	0	3	2	1	0	1272	648	103	793	320	31
13201685	Smart_grid	201505	1	0	0	0	1	0	0	0	1273	649	103	793	320	31
13201685	Smart_grid	201506	3	0	0	0	2	0	0	0	1276	651	103	793	320	31
13201685	Smart_grid	201507	15	0	0	0	5	5	0	0	1291	655	103	808	324	31
13201685	Smart_grid	201508	5	2	0	0	4	3	1	0	1296	658	105	812	326	32
13201685	Smart_grid	201509	3	0	0	0	2	2	0	0	1299	660	105	815	327	32
13201685	Smart_grid	201511	6	0	0	0	4	1	0	0	1305	664	105	816	328	32
13201685	Smart_grid	201512	4	0	0	0	4	4	0	0	1309	667	105	820	331	32
13201685	Smart_grid	201601	5	0	0	0	3	2	0	0	1314	670	105	822	333	32
13201685	Smart_grid	201602	13	2	0	0	11	9	2	0	1327	678	107	833	339	32
13201685	Smart_grid	201603	8	1	0	0	5	4	1	0	1335	682	108	840	342	32
13201685	Smart_grid	201604	3	0	0	0	3	3	0	0	1338	684	108	843	344	32
13201685	Smart_grid	201606	1	0	0	0	1	1	0	0	1339	684	108	844	344	32
13201685	Smart_grid	201609	3	0	0	0	3	3	0	0	1342	687	108	847	347	32
13201685	Smart_grid	201610	3	0	0	0	2	0	0	0	1345	689	108	847	347	32
13201685	Smart_grid	201611	1	1	0	0	1	1	1	0	1346	690	109	848	348	32
13201685	Smart_grid	201612	4	0	0	0	4	1	0	0	1350	694	109	849	349	32
13201685	Smart_grid	201701	1	0	0	0	1	1	0	0	1351	695	109	850	350	32
13201685	Smart_grid	201702	1	0	0	0	1	1	0	0	1352	696	109	851	351	32
13201685	Smart_grid	201703	4	0	0	0	3	3	0	0	1356	699	109	855	354	32
13201685	Smart_grid	201704	4	1	0	0	3	3	1	0	1360	701	110	859	356	33
13201685	Smart_grid	201705	3	1	0	0	3	2	1	0	1363	703	111	861	357	33
13201685	Smart_grid	201706	3	0	0	0	3	3	0	0	1366	705	111	864	359	33
13201685	Smart_grid	201707	2	0	0	0	2	1	0	0	1368	706	111	865	359	33
13201685	Smart_grid	201708	1	0	0	0	1	1	0	0	1369	706	111	866	359	33
13201685	Smart_grid	201709	8	1	0	0	7	5	1	0	1377	711	112	872	362	34
13201685	Smart_grid	201710	1	0	0	0	1	1	0	0	1378	712	112	873	363	34
13201685	Smart_grid	201711	2	1	0	0	2	1	1	0	1380	714	113	874	364	34
13201685	Smart_grid	201712	6	0	0	0	5	4	0	0	1386	717	113	879	366	34
13201685	Smart_grid	201801	8	1	0	0	3	2	1	0	1394	719	114	884	367	34
13201685	Smart_grid	201802	7	0	0	0	7	6	0	0	1401	724	114	890	370	34
13201685	Smart_grid	201804	7	1	0	0	6	5	1	0	1408	730	115	896	375	34
13201685	Smart_grid	201805	4	2	0	0	4	3	2	0	1412	734	117	899	378	35
13201685	Smart_grid	201806	2	0	0	0	2	2	0	0	1414	735	117	901	379	35
13201685	Smart_grid	201807	6	1	0	0	4	4	1	0	1420	738	118	907	382	36
167079	Smartphone	200302	2	0	0	0	1	0	0	0	2	1	0	0	0	0
167079	Smartphone	200306	3	0	0	0	1	1	0	0	5	2	0	3	1	0
167079	Smartphone	200307	1	0	0	0	1	1	0	0	6	3	0	4	2	0
167079	Smartphone	200308	1	0	0	0	1	0	0	0	7	4	0	4	2	0
167079	Smartphone	200311	1	0	0	0	1	0	0	0	8	5	0	4	2	0
167079	Smartphone	200312	1	0	0	0	1	1	0	0	9	6	0	5	3	0
167079	Smartphone	200402	1	0	0	0	1	1	0	0	10	7	0	6	4	0
167079	Smartphone	200403	4	0	0	0	2	2	0	0	14	9	0	10	6	0
167079	Smartphone	200404	4	0	0	0	3	2	0	0	18	12	0	13	8	0
167079	Smartphone	200405	2	0	0	0	2	1	0	0	20	13	0	14	9	0
167079	Smartphone	200406	19	0	0	0	5	4	0	0	39	18	0	32	13	0
167079	Smartphone	200407	3	0	0	0	3	1	0	0	42	21	0	33	14	0
167079	Smartphone	200408	6	0	0	0	6	3	0	0	48	26	0	36	16	0
167079	Smartphone	200409	36	0	0	0	4	2	0	0	84	28	0	70	16	0
167079	Smartphone	200410	6	0	0	0	3	3	0	0	90	30	0	76	18	0
167079	Smartphone	200411	14	1	0	0	4	2	1	0	104	32	1	86	18	0
167079	Smartphone	200412	14	0	0	0	6	3	0	0	118	36	1	97	19	0
167079	Smartphone	200501	3	0	0	0	2	2	0	0	121	38	1	100	21	0
167079	Smartphone	200502	3	0	0	0	2	2	0	0	124	38	1	103	21	0
167079	Smartphone	200503	6	1	0	0	5	4	1	0	130	42	2	108	24	1
167079	Smartphone	200504	6	1	0	0	5	4	1	0	136	47	3	112	28	2
167079	Smartphone	200505	2	0	0	0	2	2	0	0	138	48	3	114	29	2
167079	Smartphone	200506	21	3	0	0	12	6	2	0	159	59	6	123	34	3
167079	Smartphone	200507	9	0	0	0	6	0	0	0	168	65	6	123	34	3
167079	Smartphone	200508	19	1	0	0	16	5	1	0	187	80	7	130	38	3
167079	Smartphone	200509	15	0	0	0	11	4	0	0	202	90	7	136	41	3
167079	Smartphone	200510	6	2	0	0	5	3	2	0	208	94	9	140	43	3
167079	Smartphone	200511	10	0	0	0	10	2	0	0	218	103	9	142	44	3
167079	Smartphone	200512	28	1	0	0	14	6	1	0	246	114	10	160	47	3
167079	Smartphone	200601	16	2	0	0	13	3	2	0	262	125	12	163	49	3
167079	Smartphone	200602	13	3	0	0	11	3	2	0	275	136	15	168	52	3
167079	Smartphone	200603	14	0	0	0	12	6	0	0	289	147	15	175	57	3
167079	Smartphone	200604	15	2	0	0	9	6	2	0	304	155	17	185	62	4
167079	Smartphone	200605	10	2	0	0	6	4	2	0	314	160	19	189	65	4
167079	Smartphone	200606	6	2	0	0	4	2	2	0	320	163	21	191	66	4
167079	Smartphone	200607	12	2	0	0	9	6	1	0	332	171	23	199	71	5
167079	Smartphone	200608	10	0	0	0	10	6	0	0	342	180	23	205	77	5
167079	Smartphone	200609	16	1	0	0	12	3	1	0	358	192	24	209	80	5
167079	Smartphone	200610	18	2	0	0	12	6	2	0	376	203	26	216	85	5
167079	Smartphone	200611	23	4	0	0	19	7	3	0	399	219	30	227	90	6
167079	Smartphone	200612	26	4	0	0	18	6	2	0	425	237	34	237	96	6
167079	Smartphone	200701	13	2	0	0	13	5	2	0	438	249	36	242	100	6
167079	Smartphone	200702	90	3	0	0	49	25	3	0	528	298	39	297	125	7
167079	Smartphone	200703	26	0	0	0	18	9	0	0	554	311	39	313	129	7
167079	Smartphone	200704	30	3	0	0	17	11	3	0	584	326	42	334	138	8
167079	Smartphone	200705	18	3	0	0	16	12	3	0	602	341	45	348	149	10
167079	Smartphone	200706	17	2	0	0	16	9	2	0	619	353	47	357	154	10
167079	Smartphone	200707	21	0	0	0	18	10	0	0	640	368	47	368	161	10
167079	Smartphone	200708	35	2	0	0	18	11	2	0	675	385	49	391	171	11
167079	Smartphone	200709	46	7	1	0	26	12	7	1	721	407	56	422	179	12
167079	Smartphone	200710	48	4	0	0	25	13	3	0	769	427	60	451	187	13
167079	Smartphone	200711	37	3	0	0	22	10	3	0	806	443	63	473	192	13
167079	Smartphone	200712	43	4	0	0	24	8	4	0	849	465	67	490	198	14
167079	Smartphone	200801	13	3	0	0	11	6	2	0	862	475	70	497	203	15
167079	Smartphone	200802	24	2	0	0	13	6	1	0	886	487	72	510	208	15
167079	Smartphone	200803	35	7	0	0	25	14	7	0	921	508	79	534	218	19
167079	Smartphone	200804	32	5	0	0	21	11	3	0	953	524	84	555	224	19
167079	Smartphone	200805	36	10	0	0	23	9	4	0	989	542	94	575	229	22
167079	Smartphone	200806	17	3	0	0	12	5	3	0	1006	550	97	580	231	22
167079	Smartphone	200807	28	0	0	0	14	4	0	0	1034	563	97	592	234	22
167079	Smartphone	200808	32	3	0	0	25	11	3	0	1066	584	100	606	241	22
167079	Smartphone	200809	34	2	0	0	24	14	2	0	1100	604	102	626	251	23
167079	Smartphone	200810	49	10	0	0	27	9	10	0	1149	630	112	636	259	24
167079	Smartphone	200811	23	5	0	0	15	5	4	0	1172	645	117	642	264	24
167079	Smartphone	200812	24	3	0	0	17	10	1	0	1196	657	120	659	270	24
167079	Smartphone	200901	34	7	0	0	21	12	6	0	1230	675	127	676	280	26
167079	Smartphone	200902	28	6	0	0	23	10	5	0	1258	694	133	688	287	26
167079	Smartphone	200903	26	5	0	0	13	8	5	0	1284	705	138	705	293	26
167079	Smartphone	200904	52	18	4	1	30	20	13	3	1336	730	156	735	308	34
167079	Smartphone	200905	34	5	0	0	23	10	5	0	1370	747	161	747	312	34
167079	Smartphone	200906	17	2	0	0	10	7	2	0	1387	753	163	760	315	34
167079	Smartphone	200907	16	1	0	0	11	6	1	0	1403	763	164	770	320	34
167079	Smartphone	200908	28	1	0	0	18	12	1	0	1431	777	165	791	329	34
167079	Smartphone	200909	10	2	0	0	10	5	2	0	1441	785	167	796	332	34
167079	Smartphone	200910	25	1	0	0	12	7	1	0	1466	797	168	811	339	34
167079	Smartphone	200911	12	1	0	0	10	7	1	0	1478	805	169	820	344	34
167079	Smartphone	200912	45	16	0	0	25	18	13	0	1523	824	185	851	357	41
167079	Smartphone	201001	16	2	0	0	13	8	2	0	1539	833	187	862	361	41
167079	Smartphone	201002	42	2	0	0	24	10	2	0	1581	854	189	886	368	41
167079	Smartphone	201003	18	4	0	0	12	6	2	0	1599	863	193	896	372	41
167079	Smartphone	201004	44	7	0	0	21	16	7	0	1643	879	200	931	383	43
167079	Smartphone	201005	48	15	3	2	31	18	12	2	1691	905	215	957	396	48
167079	Smartphone	201006	28	4	0	0	21	12	4	0	1719	922	219	975	404	48
167079	Smartphone	201007	45	5	0	0	32	15	4	0	1764	946	224	1000	411	49
167079	Smartphone	201008	36	6	0	0	25	16	6	0	1800	964	230	1025	420	52
167079	Smartphone	201009	49	10	1	0	22	11	5	1	1849	981	240	1057	426	56
167079	Smartphone	201010	48	10	0	0	31	16	7	0	1897	1006	250	1083	436	58
167079	Smartphone	201011	62	17	1	0	43	20	12	1	1959	1041	267	1110	448	61
167079	Smartphone	201012	28	7	0	0	25	12	6	0	1987	1061	274	1124	455	61
167079	Smartphone	201101	28	9	0	0	20	9	5	0	2015	1078	283	1140	461	63
167079	Smartphone	201102	114	20	2	0	52	23	12	2	2129	1120	303	1208	474	69
167079	Smartphone	201103	65	5	0	0	37	24	4	0	2194	1147	308	1258	488	71
167079	Smartphone	201104	33	4	0	0	24	16	3	0	2227	1164	312	1282	497	73
167079	Smartphone	201105	32	3	0	0	23	14	3	0	2259	1182	315	1300	506	74
167079	Smartphone	201106	69	19	0	0	43	26	10	0	2328	1217	334	1347	524	80
167079	Smartphone	201107	66	6	0	0	24	14	4	0	2394	1234	340	1397	531	80
167079	Smartphone	201108	31	3	0	0	25	17	3	0	2425	1254	343	1419	543	81
167079	Smartphone	201109	62	6	0	0	28	19	5	0	2487	1273	349	1469	553	82
167079	Smartphone	201110	89	11	0	0	35	23	7	0	2576	1302	360	1540	570	86
167079	Smartphone	201111	82	13	1	0	48	27	10	1	2658	1339	373	1597	588	90
167079	Smartphone	201112	76	14	0	0	38	22	5	0	2734	1368	387	1655	601	95
167079	Smartphone	201201	52	4	0	0	24	15	4	0	2786	1381	391	1697	605	96
167079	Smartphone	201202	45	14	1	0	27	16	8	1	2831	1402	405	1729	615	98
167079	Smartphone	201203	31	8	0	0	24	17	7	0	2862	1419	413	1750	625	103
167079	Smartphone	201204	61	8	0	0	33	21	4	0	2923	1443	421	1793	637	105
167079	Smartphone	201205	33	5	0	0	27	13	5	0	2956	1464	426	1809	644	105
167079	Smartphone	201206	44	6	0	0	25	15	5	0	3000	1484	432	1841	654	106
167079	Smartphone	201207	53	1	0	0	32	20	1	0	3053	1507	433	1874	665	106
167079	Smartphone	201208	48	6	0	0	25	17	5	0	3101	1525	439	1907	675	110
167079	Smartphone	201209	84	6	0	0	34	23	5	0	3185	1553	445	1976	692	111
167079	Smartphone	201210	59	22	1	0	36	20	13	1	3244	1581	467	2011	704	118
167079	Smartphone	201211	81	11	0	0	37	21	9	0	3325	1606	478	2064	714	119
167079	Smartphone	201212	28	1	0	0	20	13	1	0	3353	1621	479	2084	722	119
167079	Smartphone	201301	25	9	0	0	17	9	4	0	3378	1634	488	2100	727	121
167079	Smartphone	201302	36	7	0	0	27	14	6	0	3414	1653	495	2119	733	123
167079	Smartphone	201303	60	11	0	0	43	22	10	0	3474	1688	506	2153	747	125
167079	Smartphone	201304	49	15	0	0	39	18	12	0	3523	1717	521	2177	755	125
167079	Smartphone	201305	39	15	2	0	28	14	12	2	3562	1737	536	2196	761	128
167079	Smartphone	201306	35	7	0	0	28	12	6	0	3597	1761	543	2213	769	129
167079	Smartphone	201307	39	7	0	0	27	16	6	0	3636	1780	550	2238	778	130
167079	Smartphone	201308	16	1	0	0	10	7	1	0	3652	1788	551	2249	783	130
167079	Smartphone	201309	43	6	0	0	22	14	4	0	3695	1803	557	2278	791	130
167079	Smartphone	201310	62	10	0	0	34	17	8	0	3757	1832	567	2309	804	133
167079	Smartphone	201311	68	18	0	0	38	25	11	0	3825	1857	585	2357	816	139
167079	Smartphone	201312	30	8	0	0	24	14	7	0	3855	1873	593	2375	822	142
167079	Smartphone	201401	45	13	0	0	28	18	10	0	3900	1892	606	2404	832	147
167079	Smartphone	201402	64	9	0	0	33	20	6	0	3964	1915	615	2448	843	148
167079	Smartphone	201403	60	14	0	0	37	26	11	0	4024	1941	629	2492	858	154
167079	Smartphone	201404	72	23	1	0	38	22	11	1	4096	1969	652	2535	869	163
167079	Smartphone	201405	46	16	1	0	28	22	11	1	4142	1991	668	2574	883	172
167079	Smartphone	201406	35	9	0	0	21	13	7	0	4177	2008	677	2600	892	177
167079	Smartphone	201407	23	6	0	0	19	8	4	0	4200	2021	683	2612	894	179
167079	Smartphone	201408	21	3	0	0	17	12	3	0	4221	2034	686	2625	900	180
167079	Smartphone	201409	48	8	1	0	34	15	6	1	4269	2062	694	2649	909	182
167079	Smartphone	201410	64	11	0	0	45	27	9	0	4333	2095	705	2694	925	185
167079	Smartphone	201411	53	12	0	0	40	27	9	0	4386	2120	717	2731	936	187
167079	Smartphone	201412	28	6	0	0	21	12	5	0	4414	2134	723	2747	941	190
167079	Smartphone	201501	56	8	0	0	38	27	8	0	4470	2156	731	2787	952	194
167079	Smartphone	201502	50	22	10	7	23	17	10	2	4520	2169	753	2829	959	211
167079	Smartphone	201503	37	4	0	0	20	9	4	0	4557	2183	757	2848	961	212
167079	Smartphone	201504	74	14	4	1	33	17	11	3	4631	2208	771	2895	969	220
167079	Smartphone	201505	63	10	0	0	30	18	8	0	4694	2228	781	2945	977	223
167079	Smartphone	201506	33	8	0	0	24	19	7	0	4727	2244	789	2972	988	225
167079	Smartphone	201507	54	15	0	0	37	18	12	0	4781	2271	804	2995	995	226
167079	Smartphone	201508	35	8	0	0	23	13	5	0	4816	2288	812	3015	1002	230
167079	Smartphone	201509	54	7	0	0	28	18	5	0	4870	2310	819	3055	1015	230
167079	Smartphone	201510	38	10	0	0	32	19	9	0	4908	2335	829	3076	1025	231
167079	Smartphone	201511	37	6	0	0	29	16	6	0	4945	2359	835	3096	1034	234
167079	Smartphone	201512	62	20	0	0	42	26	12	0	5007	2390	855	3136	1048	243
167079	Smartphone	201601	46	12	0	0	30	15	8	0	5053	2412	867	3157	1055	245
167079	Smartphone	201602	49	12	0	0	40	29	9	0	5102	2447	879	3195	1079	249
167079	Smartphone	201603	52	14	1	0	37	28	12	1	5154	2475	893	3235	1094	254
167079	Smartphone	201604	40	6	0	0	29	21	6	0	5194	2494	899	3266	1104	256
167079	Smartphone	201605	49	16	0	0	33	21	12	0	5243	2517	915	3296	1114	258
167079	Smartphone	201606	71	8	0	0	21	15	3	0	5314	2528	923	3352	1119	261
167079	Smartphone	201607	72	20	1	0	33	23	13	1	5386	2549	943	3408	1129	269
167079	Smartphone	201608	34	11	0	0	24	17	11	0	5420	2561	954	3434	1134	275
167079	Smartphone	201609	86	12	0	0	28	24	9	0	5506	2577	966	3514	1140	284
167079	Smartphone	201610	60	13	0	0	41	28	11	0	5566	2606	979	3555	1154	285
167079	Smartphone	201611	40	11	0	0	28	19	8	0	5606	2625	990	3584	1162	289
167079	Smartphone	201612	43	15	0	0	31	19	11	0	5649	2650	1005	3609	1171	293
167079	Smartphone	201701	40	4	0	0	24	20	4	0	5689	2665	1009	3641	1182	295
167079	Smartphone	201702	65	12	0	0	34	22	10	0	5754	2690	1021	3690	1194	299
167079	Smartphone	201703	59	15	0	0	32	21	12	0	5813	2709	1036	3723	1200	304
167079	Smartphone	201704	65	22	7	6	35	21	13	2	5878	2732	1058	3771	1209	315
167079	Smartphone	201705	54	17	0	0	33	21	11	0	5932	2754	1075	3799	1214	319
167079	Smartphone	201706	57	13	0	0	34	22	12	0	5989	2777	1088	3842	1224	324
167079	Smartphone	201707	36	12	0	0	27	19	9	0	6025	2794	1100	3867	1232	327
167079	Smartphone	201708	25	7	0	0	22	14	6	0	6050	2809	1107	3884	1235	329
167079	Smartphone	201709	39	5	0	0	20	15	3	0	6089	2821	1112	3910	1242	333
167079	Smartphone	201710	68	10	2	1	24	21	7	2	6157	2837	1122	3974	1252	342
167079	Smartphone	201711	76	10	0	0	29	21	10	0	6233	2853	1132	4041	1258	347
167079	Smartphone	201712	58	21	5	2	36	22	14	3	6291	2878	1153	4081	1267	356
167079	Smartphone	201801	42	6	0	0	20	14	5	0	6333	2889	1159	4117	1272	359
167079	Smartphone	201802	48	7	0	0	20	15	6	0	6381	2900	1166	4160	1273	364
167079	Smartphone	201803	30	10	0	0	21	13	8	0	6411	2911	1176	4177	1276	366
167079	Smartphone	201804	39	5	0	0	20	16	5	0	6450	2922	1181	4212	1281	369
167079	Smartphone	201805	25	5	0	0	19	12	4	0	6475	2936	1186	4229	1285	371
167079	Smartphone	201806	26	9	0	0	19	11	6	0	6501	2950	1195	4245	1290	373
167079	Smartphone	201807	36	7	0	0	26	16	7	0	6537	2969	1202	4265	1298	375
41215289	Software-defined_infrastructure	201312	5	0	0	0	3	3	0	0	5	3	0	5	3	0
41215289	Software-defined_infrastructure	201410	1	0	0	0	1	1	0	0	6	4	0	6	4	0
41215289	Software-defined_infrastructure	201411	2	0	0	0	1	0	0	0	8	5	0	6	4	0
41215289	Software-defined_infrastructure	201507	1	0	0	0	1	1	0	0	9	6	0	7	5	0
41215289	Software-defined_infrastructure	201509	5	0	0	0	2	1	0	0	14	8	0	9	6	0
41215289	Software-defined_infrastructure	201510	1	0	0	0	1	0	0	0	15	9	0	9	6	0
41215289	Software-defined_infrastructure	201601	1	1	0	0	1	1	1	0	16	10	1	10	7	0
41215289	Software-defined_infrastructure	201702	5	0	0	0	1	1	0	0	21	11	1	15	8	0
41215289	Software-defined_infrastructure	201709	1	0	0	0	1	1	0	0	22	12	1	16	9	0
41215289	Software-defined_infrastructure	201801	1	0	0	0	1	1	0	0	23	13	1	17	10	0
33520674	Software-defined_networking	201111	5	1	0	0	2	2	1	0	5	2	1	5	2	1
33520674	Software-defined_networking	201112	6	0	0	0	4	4	0	0	11	6	1	11	6	1
33520674	Software-defined_networking	201203	1	0	0	0	1	1	0	0	12	7	1	12	7	1
33520674	Software-defined_networking	201204	6	0	0	0	5	3	0	0	18	12	1	16	10	1
33520674	Software-defined_networking	201205	12	1	0	0	5	3	1	0	30	16	2	24	12	2
33520674	Software-defined_networking	201206	26	0	0	0	7	3	0	0	56	22	2	33	14	2
33520674	Software-defined_networking	201207	10	1	0	0	5	4	1	0	66	27	3	42	18	2
33520674	Software-defined_networking	201208	7	0	0	0	5	2	0	0	73	32	3	46	20	2
33520674	Software-defined_networking	201209	4	0	0	0	3	3	0	0	77	35	3	50	23	2
33520674	Software-defined_networking	201210	12	0	0	0	3	3	0	0	89	38	3	62	26	2
33520674	Software-defined_networking	201211	4	0	0	0	4	2	0	0	93	41	3	64	27	2
33520674	Software-defined_networking	201212	2	1	0	0	2	1	1	0	95	43	4	65	28	3
33520674	Software-defined_networking	201301	11	0	0	0	7	4	0	0	106	50	4	73	32	3
33520674	Software-defined_networking	201302	7	0	0	0	6	5	0	0	113	55	4	79	36	3
33520674	Software-defined_networking	201303	11	1	0	0	7	5	1	0	124	61	5	88	40	4
33520674	Software-defined_networking	201304	6	0	0	0	5	3	0	0	130	66	5	92	43	4
33520674	Software-defined_networking	201305	11	1	0	0	9	4	1	0	141	75	6	98	47	4
33520674	Software-defined_networking	201306	7	0	0	0	4	2	0	0	148	78	6	103	48	4
33520674	Software-defined_networking	201307	8	0	0	0	8	4	0	0	156	86	6	107	52	4
33520674	Software-defined_networking	201308	7	0	0	0	6	5	0	0	163	92	6	112	57	4
33520674	Software-defined_networking	201309	22	0	0	0	9	7	0	0	185	98	6	131	61	4
33520674	Software-defined_networking	201310	1	0	0	0	1	0	0	0	186	99	6	131	61	4
33520674	Software-defined_networking	201311	1	0	0	0	1	1	0	0	187	100	6	132	62	4
33520674	Software-defined_networking	201312	10	0	0	0	7	3	0	0	197	107	6	135	65	4
33520674	Software-defined_networking	201401	4	1	0	0	4	3	1	0	201	111	7	138	68	4
33520674	Software-defined_networking	201402	25	4	0	0	8	7	2	0	226	119	11	162	75	7
33520674	Software-defined_networking	201404	2	0	0	0	2	1	0	0	228	121	11	163	76	7
33520674	Software-defined_networking	201405	4	1	0	0	4	2	1	0	232	123	12	165	76	7
33520674	Software-defined_networking	201406	6	1	0	0	5	4	1	0	238	127	13	170	79	7
33520674	Software-defined_networking	201407	19	0	0	0	10	5	0	0	257	136	13	183	83	7
33520674	Software-defined_networking	201408	25	0	0	0	9	5	0	0	282	145	13	199	88	7
33520674	Software-defined_networking	201409	29	0	0	0	12	8	0	0	311	154	13	208	92	7
33520674	Software-defined_networking	201410	5	1	0	0	4	3	1	0	316	158	14	212	95	7
33520674	Software-defined_networking	201411	14	0	0	0	6	6	0	0	330	161	14	226	98	7
33520674	Software-defined_networking	201412	16	2	0	0	7	5	1	0	346	166	16	240	101	8
33520674	Software-defined_networking	201501	5	2	0	0	5	2	2	0	351	170	18	242	102	8
33520674	Software-defined_networking	201502	3	0	0	0	2	1	0	0	354	172	18	244	102	8
33520674	Software-defined_networking	201504	9	0	0	0	7	3	0	0	363	178	18	248	104	8
33520674	Software-defined_networking	201505	12	1	0	0	5	5	1	0	375	182	19	260	108	9
33520674	Software-defined_networking	201506	9	2	0	0	4	4	1	0	384	184	21	269	109	11
33520674	Software-defined_networking	201507	3	0	0	0	2	1	0	0	387	185	21	270	109	11
33520674	Software-defined_networking	201508	2	1	0	0	2	1	1	0	389	186	22	271	109	11
33520674	Software-defined_networking	201509	15	3	0	0	7	6	2	0	404	191	25	285	111	13
33520674	Software-defined_networking	201510	1	0	0	0	1	0	0	0	405	192	25	285	111	13
33520674	Software-defined_networking	201511	5	0	0	0	4	3	0	0	410	195	25	289	112	13
33520674	Software-defined_networking	201512	2	0	0	0	1	1	0	0	412	196	25	291	113	13
33520674	Software-defined_networking	201601	7	2	1	0	6	3	2	1	419	202	27	294	116	14
33520674	Software-defined_networking	201602	4	0	0	0	3	1	0	0	423	205	27	296	117	14
33520674	Software-defined_networking	201603	2	0	0	0	2	0	0	0	425	207	27	296	117	14
33520674	Software-defined_networking	201604	3	0	0	0	3	2	0	0	428	210	27	298	119	14
33520674	Software-defined_networking	201605	12	2	0	0	8	5	2	0	440	217	29	303	123	14
33520674	Software-defined_networking	201606	5	1	0	0	4	3	1	0	445	221	30	307	126	14
33520674	Software-defined_networking	201607	11	0	0	0	5	3	0	0	456	226	30	316	129	14
33520674	Software-defined_networking	201608	4	0	0	0	4	2	0	0	460	229	30	318	130	14
33520674	Software-defined_networking	201609	4	0	0	0	4	4	0	0	464	232	30	322	133	14
33520674	Software-defined_networking	201611	10	0	0	0	6	5	0	0	474	235	30	331	135	14
33520674	Software-defined_networking	201612	23	2	0	0	15	11	2	0	497	248	32	346	144	15
33520674	Software-defined_networking	201701	1	0	0	0	1	1	0	0	498	249	32	347	145	15
33520674	Software-defined_networking	201702	3	0	0	0	2	2	0	0	501	251	32	350	146	15
33520674	Software-defined_networking	201703	2	0	0	0	2	2	0	0	503	253	32	352	147	15
33520674	Software-defined_networking	201704	2	0	0	0	2	1	0	0	505	255	32	353	148	15
33520674	Software-defined_networking	201706	6	2	0	0	4	4	2	0	511	258	34	359	151	17
33520674	Software-defined_networking	201707	1	0	0	0	1	0	0	0	512	259	34	359	151	17
33520674	Software-defined_networking	201708	5	0	0	0	4	1	0	0	517	263	34	360	152	17
33520674	Software-defined_networking	201709	1	0	0	0	1	1	0	0	518	264	34	361	153	17
33520674	Software-defined_networking	201710	6	0	0	0	5	4	0	0	524	268	34	366	156	17
33520674	Software-defined_networking	201711	1	0	0	0	1	0	0	0	525	269	34	366	156	17
33520674	Software-defined_networking	201712	7	0	0	0	3	2	0	0	532	272	34	372	158	17
33520674	Software-defined_networking	201801	1	0	0	0	1	0	0	0	533	273	34	372	158	17
33520674	Software-defined_networking	201802	5	0	0	0	3	3	0	0	538	276	34	377	161	17
33520674	Software-defined_networking	201803	5	0	0	0	3	2	0	0	543	279	34	381	163	17
33520674	Software-defined_networking	201804	4	0	0	0	2	2	0	0	547	280	34	385	164	17
33520674	Software-defined_networking	201805	1	0	0	0	1	0	0	0	548	281	34	385	164	17
33520674	Software-defined_networking	201806	5	1	0	0	5	3	1	0	553	284	35	388	165	17
33520674	Software-defined_networking	201807	7	1	0	0	7	4	1	0	560	290	36	392	167	17
83137	Software-defined_radio	200211	9	0	0	0	1	0	0	0	9	1	0	0	0	0
83137	Software-defined_radio	200212	1	0	0	0	1	1	0	0	10	2	0	1	1	0
83137	Software-defined_radio	200302	2	0	0	0	1	0	0	0	12	3	0	1	1	0
83137	Software-defined_radio	200308	1	0	0	0	1	0	0	0	13	4	0	1	1	0
83137	Software-defined_radio	200401	1	0	0	0	1	1	0	0	14	5	0	2	2	0
83137	Software-defined_radio	200403	1	0	0	0	1	1	0	0	15	6	0	3	3	0
83137	Software-defined_radio	200405	2	0	0	0	2	1	0	0	17	8	0	4	4	0
83137	Software-defined_radio	200408	1	0	0	0	1	1	0	0	18	9	0	5	5	0
83137	Software-defined_radio	200409	4	0	0	0	2	1	0	0	22	11	0	6	6	0
83137	Software-defined_radio	200410	2	0	0	0	2	2	0	0	24	12	0	8	7	0
83137	Software-defined_radio	200411	2	0	0	0	2	2	0	0	26	13	0	10	8	0
83137	Software-defined_radio	200412	2	0	0	0	1	1	0	0	28	14	0	12	9	0
83137	Software-defined_radio	200501	5	0	0	0	4	2	0	0	33	18	0	14	11	0
83137	Software-defined_radio	200502	1	0	0	0	1	0	0	0	34	19	0	14	11	0
83137	Software-defined_radio	200503	2	0	0	0	2	2	0	0	36	21	0	16	13	0
83137	Software-defined_radio	200504	1	0	0	0	1	0	0	0	37	22	0	16	13	0
83137	Software-defined_radio	200505	5	0	0	0	2	0	0	0	42	24	0	16	13	0
83137	Software-defined_radio	200506	3	0	0	0	2	2	0	0	45	26	0	19	15	0
83137	Software-defined_radio	200507	2	0	0	0	2	1	0	0	47	28	0	20	16	0
83137	Software-defined_radio	200508	6	0	0	0	4	1	0	0	53	32	0	21	17	0
83137	Software-defined_radio	200509	5	1	0	0	3	1	1	0	58	35	1	23	18	0
83137	Software-defined_radio	200510	1	0	0	0	1	1	0	0	59	36	1	24	19	0
83137	Software-defined_radio	200511	3	0	0	0	3	1	0	0	62	39	1	25	20	0
83137	Software-defined_radio	200512	6	1	0	0	5	3	1	0	68	44	2	28	23	1
83137	Software-defined_radio	200601	1	0	0	0	1	1	0	0	69	45	2	29	24	1
83137	Software-defined_radio	200602	10	0	0	0	6	2	0	0	79	51	2	31	26	1
83137	Software-defined_radio	200603	3	0	0	0	3	3	0	0	82	53	2	34	28	1
83137	Software-defined_radio	200604	5	0	0	0	5	3	0	0	87	58	2	37	31	1
83137	Software-defined_radio	200605	8	1	0	0	7	3	1	0	95	64	3	40	34	1
83137	Software-defined_radio	200606	11	0	0	0	7	6	0	0	106	71	3	50	40	1
83137	Software-defined_radio	200607	6	0	0	0	5	2	0	0	112	74	3	52	42	1
83137	Software-defined_radio	200608	3	0	0	0	3	1	0	0	115	76	3	53	43	1
83137	Software-defined_radio	200609	2	0	0	0	2	0	0	0	117	78	3	53	43	1
83137	Software-defined_radio	200610	9	1	0	0	6	5	1	0	126	84	4	61	48	1
83137	Software-defined_radio	200611	5	1	0	0	5	2	1	0	131	89	5	63	50	1
83137	Software-defined_radio	200612	4	0	0	0	3	0	0	0	135	92	5	63	50	1
83137	Software-defined_radio	200701	10	0	0	0	7	5	0	0	145	96	5	69	54	1
83137	Software-defined_radio	200702	15	2	0	0	13	6	2	0	160	107	7	76	59	1
83137	Software-defined_radio	200703	10	2	0	0	9	2	1	0	170	114	9	79	60	1
83137	Software-defined_radio	200704	34	2	0	0	15	8	1	0	204	124	11	99	63	2
83137	Software-defined_radio	200705	19	6	4	3	10	6	3	2	223	132	17	111	67	4
83137	Software-defined_radio	200706	3	0	0	0	3	1	0	0	226	134	17	112	68	4
83137	Software-defined_radio	200707	8	1	0	0	5	3	1	0	234	138	18	118	70	5
83137	Software-defined_radio	200708	3	0	0	0	3	0	0	0	237	141	18	118	70	5
83137	Software-defined_radio	200709	5	1	0	0	5	4	1	0	242	146	19	122	74	5
83137	Software-defined_radio	200710	3	0	0	0	3	1	0	0	245	149	19	123	75	5
83137	Software-defined_radio	200711	3	1	0	0	3	2	1	0	248	152	20	125	77	5
83137	Software-defined_radio	200712	9	0	0	0	7	4	0	0	257	159	20	130	81	5
83137	Software-defined_radio	200801	1	0	0	0	1	1	0	0	258	160	20	131	82	5
83137	Software-defined_radio	200802	10	0	0	0	7	2	0	0	268	166	20	134	83	5
83137	Software-defined_radio	200803	20	1	0	0	7	2	1	0	288	173	21	136	85	5
83137	Software-defined_radio	200804	4	0	0	0	3	3	0	0	292	176	21	140	88	5
83137	Software-defined_radio	200805	8	0	0	0	7	3	0	0	300	183	21	144	91	5
83137	Software-defined_radio	200806	20	2	0	0	10	6	2	0	320	191	23	156	95	5
83137	Software-defined_radio	200807	4	0	0	0	3	1	0	0	324	194	23	157	96	5
83137	Software-defined_radio	200808	4	0	0	0	3	2	0	0	328	197	23	160	98	5
83137	Software-defined_radio	200809	8	0	0	0	6	2	0	0	336	203	23	163	100	5
83137	Software-defined_radio	200810	11	0	0	0	7	4	0	0	347	210	23	170	104	5
83137	Software-defined_radio	200811	3	0	0	0	3	1	0	0	350	213	23	171	105	5
83137	Software-defined_radio	200812	17	0	0	0	7	3	0	0	367	220	23	174	108	5
83137	Software-defined_radio	200901	30	0	0	0	9	5	0	0	397	228	23	196	112	5
83137	Software-defined_radio	200902	1	0	0	0	1	0	0	0	398	229	23	196	112	5
83137	Software-defined_radio	200903	5	0	0	0	4	2	0	0	403	233	23	198	114	5
83137	Software-defined_radio	200904	10	1	0	0	6	3	1	0	413	239	24	203	117	5
83137	Software-defined_radio	200905	2	0	0	0	2	2	0	0	415	240	24	205	118	5
83137	Software-defined_radio	200906	7	0	0	0	4	3	0	0	422	244	24	211	121	5
83137	Software-defined_radio	200907	10	1	0	0	5	1	1	0	432	249	25	212	122	5
83137	Software-defined_radio	200908	2	0	0	0	2	2	0	0	434	250	25	214	123	5
83137	Software-defined_radio	200909	1	0	0	0	1	0	0	0	435	251	25	214	123	5
83137	Software-defined_radio	200910	4	0	0	0	2	1	0	0	439	253	25	217	124	5
83137	Software-defined_radio	200911	1	0	0	0	1	1	0	0	440	254	25	218	125	5
83137	Software-defined_radio	200912	3	0	0	0	2	1	0	0	443	256	25	219	126	5
83137	Software-defined_radio	201001	11	1	0	0	6	4	1	0	454	259	26	228	127	6
83137	Software-defined_radio	201002	8	0	0	0	2	2	0	0	462	261	26	236	129	6
83137	Software-defined_radio	201003	10	1	0	0	6	5	1	0	472	263	27	242	130	6
83137	Software-defined_radio	201005	5	1	0	0	4	3	1	0	477	266	28	245	132	6
83137	Software-defined_radio	201006	3	0	0	0	3	2	0	0	480	268	28	247	133	6
83137	Software-defined_radio	201007	1	0	0	0	1	0	0	0	481	269	28	247	133	6
83137	Software-defined_radio	201008	3	0	0	0	3	0	0	0	484	272	28	247	133	6
83137	Software-defined_radio	201009	4	0	0	0	4	3	0	0	488	276	28	250	136	6
83137	Software-defined_radio	201010	1	0	0	0	1	1	0	0	489	277	28	251	137	6
83137	Software-defined_radio	201012	1	0	0	0	1	1	0	0	490	278	28	252	138	6
83137	Software-defined_radio	201101	5	0	0	0	3	2	0	0	495	281	28	256	140	6
83137	Software-defined_radio	201102	9	1	0	0	5	3	1	0	504	285	29	259	142	6
83137	Software-defined_radio	201103	9	0	0	0	3	1	0	0	513	286	29	260	143	6
83137	Software-defined_radio	201104	1	0	0	0	1	1	0	0	514	286	29	261	143	6
83137	Software-defined_radio	201105	9	0	0	0	6	5	0	0	523	291	29	268	147	6
83137	Software-defined_radio	201106	4	0	0	0	3	2	0	0	527	294	29	270	149	6
83137	Software-defined_radio	201107	3	0	0	0	2	1	0	0	530	296	29	271	150	6
83137	Software-defined_radio	201108	1	0	0	0	1	1	0	0	531	297	29	272	151	6
83137	Software-defined_radio	201109	1	0	0	0	1	1	0	0	532	298	29	273	152	6
83137	Software-defined_radio	201110	5	1	0	0	4	2	1	0	537	301	30	275	153	6
83137	Software-defined_radio	201111	4	2	0	0	4	2	2	0	541	302	32	277	153	6
83137	Software-defined_radio	201112	9	3	0	0	8	6	3	0	550	307	35	284	156	7
83137	Software-defined_radio	201201	3	1	0	0	3	2	1	0	553	309	36	286	157	7
83137	Software-defined_radio	201202	6	2	0	0	6	3	2	0	559	314	38	289	159	7
83137	Software-defined_radio	201203	3	1	0	0	3	3	1	0	562	316	39	292	161	8
83137	Software-defined_radio	201204	3	1	0	0	3	2	1	0	565	318	40	294	162	8
83137	Software-defined_radio	201205	2	0	0	0	2	2	0	0	567	319	40	296	163	8
83137	Software-defined_radio	201206	3	0	0	0	3	2	0	0	570	321	40	298	164	8
83137	Software-defined_radio	201207	8	0	0	0	4	3	0	0	578	323	40	305	165	8
83137	Software-defined_radio	201208	6	0	0	0	5	3	0	0	584	326	40	308	166	8
83137	Software-defined_radio	201209	3	0	0	0	3	3	0	0	587	329	40	311	169	8
83137	Software-defined_radio	201210	16	0	0	0	6	5	0	0	603	332	40	325	171	8
83137	Software-defined_radio	201211	2	0	0	0	2	1	0	0	605	334	40	326	172	8
83137	Software-defined_radio	201212	1	0	0	0	1	0	0	0	606	335	40	326	172	8
83137	Software-defined_radio	201301	5	2	0	0	4	2	1	0	611	338	42	329	173	8
83137	Software-defined_radio	201302	9	1	0	0	7	4	1	0	620	344	43	333	175	8
83137	Software-defined_radio	201303	5	1	0	0	4	2	1	0	625	347	44	335	176	8
83137	Software-defined_radio	201304	12	1	0	0	7	6	1	0	637	354	45	346	182	8
83137	Software-defined_radio	201305	4	1	0	0	4	1	1	0	641	357	46	347	182	9
83137	Software-defined_radio	201306	3	1	0	0	3	2	1	0	644	360	47	349	184	9
83137	Software-defined_radio	201307	3	1	0	0	2	1	1	0	647	361	48	350	184	9
83137	Software-defined_radio	201308	2	0	0	0	2	2	0	0	649	363	48	352	186	9
83137	Software-defined_radio	201309	3	1	0	0	3	2	1	0	652	365	49	354	187	9
83137	Software-defined_radio	201310	4	2	0	0	4	2	2	0	656	367	51	356	187	9
83137	Software-defined_radio	201311	9	0	0	0	3	3	0	0	665	368	51	365	188	9
83137	Software-defined_radio	201312	3	1	0	0	3	2	1	0	668	370	52	367	189	10
83137	Software-defined_radio	201401	2	1	0	0	2	1	1	0	670	371	53	368	189	10
83137	Software-defined_radio	201403	11	0	0	0	6	4	0	0	681	377	53	377	192	10
83137	Software-defined_radio	201404	2	1	0	0	2	2	1	0	683	378	54	379	193	11
83137	Software-defined_radio	201405	4	1	0	0	4	2	1	0	687	381	55	381	194	11
83137	Software-defined_radio	201406	1	0	0	0	1	1	0	0	688	381	55	382	194	11
83137	Software-defined_radio	201407	2	0	0	0	1	1	0	0	690	382	55	384	195	11
83137	Software-defined_radio	201408	7	1	0	0	3	2	1	0	697	383	56	390	195	11
83137	Software-defined_radio	201409	2	0	0	0	2	2	0	0	699	384	56	392	196	11
83137	Software-defined_radio	201410	2	1	0	0	2	2	1	0	701	385	57	394	197	12
83137	Software-defined_radio	201411	2	0	0	0	2	2	0	0	703	386	57	396	197	12
83137	Software-defined_radio	201412	11	2	0	0	4	3	2	0	714	388	59	405	198	13
83137	Software-defined_radio	201501	13	1	0	0	9	5	1	0	727	395	60	414	201	14
83137	Software-defined_radio	201502	4	1	0	0	4	3	1	0	731	398	61	417	202	15
83137	Software-defined_radio	201503	2	0	0	0	2	0	0	0	733	400	61	417	202	15
83137	Software-defined_radio	201505	3	0	0	0	2	1	0	0	736	401	61	418	202	15
83137	Software-defined_radio	201506	2	0	0	0	2	2	0	0	738	403	61	420	204	15
83137	Software-defined_radio	201508	4	0	0	0	3	3	0	0	742	404	61	424	204	15
83137	Software-defined_radio	201509	4	0	0	0	2	2	0	0	746	405	61	428	205	15
83137	Software-defined_radio	201510	5	1	0	0	2	1	1	0	751	406	62	429	205	15
83137	Software-defined_radio	201511	1	0	0	0	1	1	0	0	752	407	62	430	206	15
83137	Software-defined_radio	201604	1	0	0	0	1	1	0	0	753	408	62	431	207	15
83137	Software-defined_radio	201606	3	0	0	0	3	1	0	0	756	410	62	432	207	15
83137	Software-defined_radio	201607	1	0	0	0	1	1	0	0	757	411	62	433	208	15
83137	Software-defined_radio	201608	3	0	0	0	3	3	0	0	760	413	62	436	210	15
83137	Software-defined_radio	201609	5	2	0	0	4	4	2	0	765	417	64	441	214	17
83137	Software-defined_radio	201612	3	1	0	0	2	1	1	0	768	419	65	442	215	17
83137	Software-defined_radio	201702	1	0	0	0	1	1	0	0	769	420	65	443	216	17
83137	Software-defined_radio	201706	3	0	0	0	2	2	0	0	772	422	65	446	218	17
83137	Software-defined_radio	201708	3	0	0	0	3	3	0	0	775	424	65	449	219	17
83137	Software-defined_radio	201709	2	0	0	0	2	0	0	0	777	426	65	449	219	17
83137	Software-defined_radio	201710	3	0	0	0	3	2	0	0	780	428	65	451	219	17
83137	Software-defined_radio	201711	2	0	0	0	2	1	0	0	782	430	65	452	220	17
83137	Software-defined_radio	201801	1	0	0	0	1	1	0	0	783	431	65	453	221	17
83137	Software-defined_radio	201803	2	1	0	0	2	2	1	0	785	432	66	455	222	18
83137	Software-defined_radio	201804	2	1	0	0	2	1	1	0	787	434	67	456	223	18
83137	Software-defined_radio	201805	3	0	0	0	3	2	0	0	790	435	67	458	223	18
83137	Software-defined_radio	201807	1	0	0	0	1	1	0	0	791	436	67	459	224	18
29468	Speech_recognition	200202	5	0	0	0	4	4	0	0	5	4	0	5	4	0
29468	Speech_recognition	200203	1	0	0	0	1	1	0	0	6	5	0	6	4	0
29468	Speech_recognition	200204	1	0	0	0	1	1	0	0	7	6	0	7	5	0
29468	Speech_recognition	200205	2	0	0	0	2	2	0	0	9	7	0	9	6	0
29468	Speech_recognition	200208	2	0	0	0	2	1	0	0	11	9	0	10	7	0
29468	Speech_recognition	200210	1	0	0	0	1	1	0	0	12	10	0	11	8	0
29468	Speech_recognition	200211	3	0	0	0	1	1	0	0	15	11	0	14	9	0
29468	Speech_recognition	200303	1	0	0	0	1	1	0	0	16	12	0	15	10	0
29468	Speech_recognition	200307	1	0	0	0	1	1	0	0	17	13	0	16	11	0
29468	Speech_recognition	200308	1	0	0	0	1	1	0	0	18	14	0	17	12	0
29468	Speech_recognition	200309	3	0	0	0	2	1	0	0	21	16	0	18	13	0
29468	Speech_recognition	200312	2	1	0	0	2	1	1	0	23	18	1	19	14	0
29468	Speech_recognition	200402	4	0	0	0	2	1	0	0	27	20	1	21	15	0
29468	Speech_recognition	200403	2	0	0	0	2	1	0	0	29	22	1	22	16	0
29468	Speech_recognition	200404	5	1	0	0	5	2	1	0	34	27	2	24	18	0
29468	Speech_recognition	200405	6	1	0	0	4	2	1	0	40	31	3	27	20	0
29468	Speech_recognition	200406	2	0	0	0	2	0	0	0	42	33	3	27	20	0
29468	Speech_recognition	200407	1	0	0	0	1	1	0	0	43	34	3	28	21	0
29468	Speech_recognition	200408	3	0	0	0	3	2	0	0	46	37	3	30	23	0
29468	Speech_recognition	200409	4	1	0	0	4	3	1	0	50	41	4	33	26	0
29468	Speech_recognition	200410	3	0	0	0	3	2	0	0	53	43	4	35	27	0
29468	Speech_recognition	200411	1	0	0	0	1	1	0	0	54	44	4	36	28	0
29468	Speech_recognition	200412	6	0	0	0	6	2	0	0	60	50	4	38	30	0
29468	Speech_recognition	200502	5	0	0	0	4	1	0	0	65	54	4	39	31	0
29468	Speech_recognition	200503	7	0	0	0	2	0	0	0	72	56	4	39	31	0
29468	Speech_recognition	200504	11	0	0	0	7	3	0	0	83	63	4	45	34	0
29468	Speech_recognition	200505	37	2	0	0	20	7	2	0	120	82	6	63	40	0
29468	Speech_recognition	200506	16	2	0	0	12	4	2	0	136	91	8	69	42	0
29468	Speech_recognition	200507	15	3	0	0	11	3	3	0	151	102	11	72	45	0
29468	Speech_recognition	200508	3	0	0	0	3	2	0	0	154	105	11	74	47	0
29468	Speech_recognition	200509	22	1	0	0	14	5	1	0	176	117	12	80	50	0
29468	Speech_recognition	200510	22	1	0	0	9	4	1	0	198	126	13	93	54	0
29468	Speech_recognition	200511	16	2	0	0	11	4	2	0	214	136	15	100	57	0
29468	Speech_recognition	200512	5	1	0	0	5	1	1	0	219	141	16	101	58	0
29468	Speech_recognition	200601	32	4	0	0	20	5	4	0	251	160	20	114	63	0
29468	Speech_recognition	200602	18	1	0	0	15	5	1	0	269	174	21	120	67	0
29468	Speech_recognition	200603	20	0	0	0	14	7	0	0	289	187	21	128	73	0
29468	Speech_recognition	200604	28	2	0	0	21	10	2	0	317	206	23	142	82	0
29468	Speech_recognition	200605	29	3	0	0	16	10	3	0	346	220	26	161	90	1
29468	Speech_recognition	200606	49	6	0	0	22	12	6	0	395	237	32	193	98	2
29468	Speech_recognition	200607	45	1	0	0	19	9	1	0	440	254	33	223	105	2
29468	Speech_recognition	200608	16	0	0	0	12	8	0	0	456	263	33	232	110	2
29468	Speech_recognition	200609	13	3	0	0	10	5	3	0	469	273	36	237	115	2
29468	Speech_recognition	200610	23	2	0	0	13	8	2	0	492	284	38	252	121	2
29468	Speech_recognition	200611	21	2	0	0	16	8	2	0	513	298	40	264	127	2
29468	Speech_recognition	200612	23	6	0	0	16	3	4	0	536	312	46	272	128	3
29468	Speech_recognition	200701	16	4	0	0	11	5	2	0	552	322	50	280	132	4
29468	Speech_recognition	200702	15	3	0	0	14	8	3	0	567	335	53	288	139	4
29468	Speech_recognition	200703	17	2	0	0	13	4	2	0	584	348	55	294	143	5
29468	Speech_recognition	200704	33	4	0	0	24	13	4	0	617	370	59	311	154	5
29468	Speech_recognition	200705	19	1	0	0	9	5	1	0	636	376	60	324	156	5
29468	Speech_recognition	200706	19	1	0	0	12	9	1	0	655	386	61	340	163	5
29468	Speech_recognition	200707	14	2	0	0	10	5	2	0	669	394	63	345	166	5
29468	Speech_recognition	200708	29	5	0	0	17	8	4	0	698	410	68	356	173	5
29468	Speech_recognition	200709	22	3	0	0	14	8	3	0	720	422	71	369	179	5
29468	Speech_recognition	200710	48	7	0	0	22	9	5	0	768	441	78	390	186	5
29468	Speech_recognition	200711	24	2	0	0	12	6	2	0	792	452	80	405	191	5
29468	Speech_recognition	200712	25	2	0	0	15	6	2	0	817	465	82	412	196	5
29468	Speech_recognition	200801	28	1	0	0	15	5	1	0	845	478	83	426	200	5
29468	Speech_recognition	200802	24	1	0	0	16	10	1	0	869	494	84	444	210	5
29468	Speech_recognition	200803	24	5	0	0	17	6	4	0	893	508	89	453	214	5
29468	Speech_recognition	200804	23	2	0	0	17	8	2	0	916	523	91	466	220	6
29468	Speech_recognition	200805	16	2	0	0	11	9	2	0	932	531	93	478	226	6
29468	Speech_recognition	200806	31	0	0	0	14	9	0	0	963	541	93	492	231	6
29468	Speech_recognition	200807	22	2	0	0	14	8	2	0	985	554	95	504	238	7
29468	Speech_recognition	200808	17	3	0	0	13	6	3	0	1002	564	98	513	241	7
29468	Speech_recognition	200809	7	2	0	0	7	4	2	0	1009	569	100	517	244	7
29468	Speech_recognition	200810	27	8	0	0	22	13	8	0	1036	590	108	531	256	7
29468	Speech_recognition	200811	8	2	0	0	8	4	2	0	1044	598	110	535	260	8
29468	Speech_recognition	200812	12	4	0	0	6	5	2	0	1056	603	114	543	264	8
29468	Speech_recognition	200901	11	1	0	0	9	4	1	0	1067	612	115	547	268	8
29468	Speech_recognition	200902	13	3	0	0	9	7	2	0	1080	619	118	555	273	8
29468	Speech_recognition	200903	5	0	0	0	5	3	0	0	1085	624	118	558	276	8
29468	Speech_recognition	200904	20	1	0	0	9	6	1	0	1105	632	119	575	281	8
29468	Speech_recognition	200905	20	5	0	0	11	4	3	0	1125	643	124	581	285	8
29468	Speech_recognition	200906	6	1	0	0	4	4	1	0	1131	646	125	587	288	9
29468	Speech_recognition	200907	8	1	0	0	6	5	1	0	1139	652	126	594	293	10
29468	Speech_recognition	200908	23	3	1	0	14	10	3	1	1162	662	129	612	299	12
29468	Speech_recognition	200909	6	1	0	0	6	5	1	0	1168	666	130	617	302	12
29468	Speech_recognition	200910	3	0	0	0	3	0	0	0	1171	669	130	617	302	12
29468	Speech_recognition	200911	11	2	0	0	10	3	2	0	1182	679	132	620	305	12
29468	Speech_recognition	200912	28	9	0	0	15	9	5	0	1210	690	141	635	311	15
29468	Speech_recognition	201001	5	1	0	0	4	2	1	0	1215	693	142	638	312	15
29468	Speech_recognition	201002	13	5	0	0	7	4	3	0	1228	698	147	644	314	15
29468	Speech_recognition	201003	7	1	0	0	4	3	1	0	1235	700	148	649	315	16
29468	Speech_recognition	201004	22	5	0	0	10	4	4	0	1257	709	153	663	318	18
29468	Speech_recognition	201005	10	1	0	0	8	5	1	0	1267	714	154	669	320	18
29468	Speech_recognition	201006	21	2	0	0	15	10	2	0	1288	729	156	681	330	18
29468	Speech_recognition	201007	6	1	0	0	6	5	1	0	1294	734	157	686	334	18
29468	Speech_recognition	201008	10	1	0	0	8	3	1	0	1304	742	158	690	337	18
29468	Speech_recognition	201009	10	2	0	0	7	5	2	0	1314	746	160	695	339	18
29468	Speech_recognition	201010	8	1	0	0	6	3	1	0	1322	751	161	699	341	18
29468	Speech_recognition	201011	14	2	0	0	9	4	2	0	1336	760	163	706	345	18
29468	Speech_recognition	201012	15	2	0	0	12	8	2	0	1351	768	165	715	349	18
29468	Speech_recognition	201101	12	3	0	0	10	6	3	0	1363	777	168	723	354	18
29468	Speech_recognition	201102	3	1	0	0	3	2	1	0	1366	780	169	725	356	18
29468	Speech_recognition	201103	20	1	0	0	12	4	1	0	1386	790	170	734	359	18
29468	Speech_recognition	201104	17	3	0	0	9	6	3	0	1403	797	173	745	363	18
29468	Speech_recognition	201105	12	1	0	0	9	7	1	0	1415	804	174	754	368	18
29468	Speech_recognition	201106	8	2	0	0	7	5	2	0	1423	809	176	759	371	18
29468	Speech_recognition	201107	7	2	0	0	6	6	2	0	1430	813	178	766	375	20
29468	Speech_recognition	201108	6	1	0	0	6	4	1	0	1436	819	179	770	379	20
29468	Speech_recognition	201109	6	0	0	0	6	2	0	0	1442	825	179	772	381	20
29468	Speech_recognition	201110	13	3	0	0	10	5	2	0	1455	834	182	779	385	20
29468	Speech_recognition	201111	11	3	0	0	9	6	3	0	1466	842	185	785	390	20
29468	Speech_recognition	201112	14	4	0	0	11	5	3	0	1480	851	189	792	393	21
29468	Speech_recognition	201201	22	1	0	0	13	5	1	0	1502	864	190	801	398	21
29468	Speech_recognition	201202	2	1	0	0	2	1	1	0	1504	865	191	802	398	21
29468	Speech_recognition	201203	19	2	0	0	12	6	2	0	1523	876	193	815	403	21
29468	Speech_recognition	201204	18	5	1	0	11	6	4	1	1541	885	198	828	407	24
29468	Speech_recognition	201205	14	2	0	0	9	8	2	0	1555	893	200	841	414	26
29468	Speech_recognition	201206	16	4	0	0	13	8	3	0	1571	903	204	852	419	28
29468	Speech_recognition	201207	11	1	0	0	10	7	1	0	1582	911	205	860	425	29
29468	Speech_recognition	201208	8	0	0	0	7	5	0	0	1590	916	205	866	428	29
29468	Speech_recognition	201209	6	0	0	0	4	4	0	0	1596	920	205	872	432	29
29468	Speech_recognition	201210	5	0	0	0	4	3	0	0	1601	923	205	876	434	29
29468	Speech_recognition	201211	3	0	0	0	3	2	0	0	1604	925	205	878	435	29
29468	Speech_recognition	201212	9	2	0	0	8	5	2	0	1613	930	207	884	437	29
29468	Speech_recognition	201301	5	0	0	0	5	4	0	0	1618	932	207	888	438	29
29468	Speech_recognition	201302	16	1	0	0	9	5	1	0	1634	939	208	899	441	29
29468	Speech_recognition	201305	3	1	0	0	3	3	1	0	1637	941	209	902	443	30
29468	Speech_recognition	201306	9	1	0	0	8	6	1	0	1646	947	210	908	447	30
29468	Speech_recognition	201307	6	0	0	0	6	5	0	0	1652	951	210	913	450	30
29468	Speech_recognition	201308	8	1	0	0	6	3	1	0	1660	956	211	917	452	30
29468	Speech_recognition	201309	1	0	0	0	1	1	0	0	1661	956	211	918	452	30
29468	Speech_recognition	201311	2	0	0	0	2	1	0	0	1663	958	211	919	453	30
29468	Speech_recognition	201312	10	2	0	0	7	1	2	0	1673	965	213	920	454	30
29468	Speech_recognition	201401	10	3	0	0	9	5	3	0	1683	973	216	926	458	31
29468	Speech_recognition	201402	2	0	0	0	2	2	0	0	1685	974	216	928	459	31
29468	Speech_recognition	201403	5	1	0	0	5	4	1	0	1690	977	217	932	461	31
29468	Speech_recognition	201404	38	3	0	0	13	12	3	0	1728	986	220	958	469	33
29468	Speech_recognition	201405	7	0	0	0	6	1	0	0	1735	991	220	959	469	33
29468	Speech_recognition	201406	6	0	0	0	3	1	0	0	1741	994	220	960	470	33
29468	Speech_recognition	201407	1	0	0	0	1	1	0	0	1742	995	220	961	471	33
29468	Speech_recognition	201408	5	1	0	0	4	3	1	0	1747	998	221	965	473	33
29468	Speech_recognition	201409	5	0	0	0	3	2	0	0	1752	1000	221	969	474	33
29468	Speech_recognition	201410	6	1	0	0	6	5	1	0	1758	1003	222	974	476	33
29468	Speech_recognition	201411	4	0	0	0	3	3	0	0	1762	1005	222	978	478	33
29468	Speech_recognition	201412	6	0	0	0	6	3	0	0	1768	1011	222	981	481	33
29468	Speech_recognition	201501	3	0	0	0	3	2	0	0	1771	1013	222	983	481	33
29468	Speech_recognition	201502	25	0	0	0	4	4	0	0	1796	1014	222	1008	482	33
29468	Speech_recognition	201503	20	0	0	0	9	8	0	0	1816	1022	222	1027	484	33
29468	Speech_recognition	201504	15	2	0	0	8	5	2	0	1831	1028	224	1037	487	33
29468	Speech_recognition	201505	9	1	0	0	5	3	1	0	1840	1032	225	1042	488	33
29468	Speech_recognition	201506	5	0	0	0	4	4	0	0	1845	1035	225	1047	490	33
29468	Speech_recognition	201507	5	0	0	0	3	2	0	0	1850	1036	225	1051	490	33
29468	Speech_recognition	201508	3	0	0	0	3	2	0	0	1853	1038	225	1053	491	33
29468	Speech_recognition	201509	3	0	0	0	3	3	0	0	1856	1040	225	1056	493	33
29468	Speech_recognition	201510	2	1	0	0	2	1	1	0	1858	1042	226	1057	494	33
29468	Speech_recognition	201511	5	2	0	0	5	4	2	0	1863	1046	228	1061	497	34
29468	Speech_recognition	201512	7	0	0	0	4	2	0	0	1870	1049	228	1066	498	34
29468	Speech_recognition	201601	2	0	0	0	2	2	0	0	1872	1051	228	1068	500	34
29468	Speech_recognition	201602	3	0	0	0	3	3	0	0	1875	1053	228	1071	502	34
29468	Speech_recognition	201603	10	1	0	0	7	4	1	0	1885	1059	229	1078	505	34
29468	Speech_recognition	201604	6	0	0	0	4	3	0	0	1891	1061	229	1083	506	34
29468	Speech_recognition	201605	18	0	0	0	10	10	0	0	1909	1068	229	1101	512	34
29468	Speech_recognition	201606	14	0	0	0	9	6	0	0	1923	1074	229	1112	515	34
29468	Speech_recognition	201607	17	3	0	0	13	11	3	0	1940	1082	232	1125	521	36
29468	Speech_recognition	201608	2	0	0	0	2	2	0	0	1942	1083	232	1127	522	36
29468	Speech_recognition	201609	2	0	0	0	2	2	0	0	1944	1083	232	1129	522	36
29468	Speech_recognition	201610	14	0	0	0	8	7	0	0	1958	1088	232	1142	524	36
29468	Speech_recognition	201611	9	1	0	0	7	5	1	0	1967	1094	233	1149	528	36
29468	Speech_recognition	201612	4	0	0	0	4	2	0	0	1971	1096	233	1151	528	36
29468	Speech_recognition	201701	7	1	0	0	5	4	1	0	1978	1100	234	1156	530	37
29468	Speech_recognition	201702	18	0	0	0	8	7	0	0	1996	1104	234	1165	533	37
29468	Speech_recognition	201703	11	1	0	0	7	6	1	0	2007	1109	235	1175	537	37
29468	Speech_recognition	201704	9	1	0	0	5	4	1	0	2016	1111	236	1183	538	37
29468	Speech_recognition	201705	4	0	0	0	2	2	0	0	2020	1111	236	1187	538	37
29468	Speech_recognition	201706	9	1	0	0	6	4	1	0	2029	1116	237	1191	541	37
29468	Speech_recognition	201707	6	0	0	0	5	4	0	0	2035	1119	237	1195	543	37
29468	Speech_recognition	201708	16	0	0	0	8	8	0	0	2051	1124	237	1211	548	37
29468	Speech_recognition	201709	24	2	0	0	11	8	2	0	2075	1130	239	1232	551	37
29468	Speech_recognition	201711	9	1	0	0	7	6	1	0	2084	1134	240	1240	553	37
29468	Speech_recognition	201712	4	0	0	0	2	1	0	0	2088	1136	240	1241	554	37
29468	Speech_recognition	201801	6	1	0	0	5	3	1	0	2094	1139	241	1244	555	37
29468	Speech_recognition	201802	11	1	0	0	7	5	1	0	2105	1143	242	1253	557	38
29468	Speech_recognition	201803	5	2	0	0	5	5	2	0	2110	1147	244	1258	560	40
29468	Speech_recognition	201804	7	2	0	0	7	5	2	0	2117	1151	246	1263	562	40
29468	Speech_recognition	201805	2	0	0	0	2	2	0	0	2119	1152	246	1265	563	40
29468	Speech_recognition	201806	4	0	0	0	2	2	0	0	2123	1153	246	1269	564	40
29468	Speech_recognition	201807	8	1	0	0	6	5	1	0	2131	1158	247	1275	568	40
31325867	Speech_translation	201104	5	0	0	0	2	1	0	0	5	2	0	2	1	0
31325867	Speech_translation	201105	5	0	0	0	3	2	0	0	10	4	0	5	3	0
31325867	Speech_translation	201106	2	0	0	0	2	2	0	0	12	6	0	7	5	0
31325867	Speech_translation	201107	24	0	0	0	1	1	0	0	36	7	0	31	6	0
31325867	Speech_translation	201108	2	0	0	0	1	1	0	0	38	8	0	33	7	0
31325867	Speech_translation	201111	2	0	0	0	2	2	0	0	40	10	0	35	9	0
31325867	Speech_translation	201202	1	1	0	0	1	1	1	0	41	10	1	36	9	1
31325867	Speech_translation	201206	9	0	0	0	3	3	0	0	50	13	1	45	12	1
31325867	Speech_translation	201209	2	1	0	0	2	1	1	0	52	15	2	46	13	1
31325867	Speech_translation	201211	1	0	0	0	1	1	0	0	53	16	2	47	14	1
31325867	Speech_translation	201212	1	1	0	0	1	1	1	0	54	17	3	48	15	2
31325867	Speech_translation	201301	2	0	0	0	2	2	0	0	56	19	3	50	17	2
31325867	Speech_translation	201303	1	0	0	0	1	1	0	0	57	20	3	51	18	2
31325867	Speech_translation	201304	1	0	0	0	1	1	0	0	58	21	3	52	19	2
31325867	Speech_translation	201305	3	0	0	0	2	2	0	0	61	22	3	55	20	2
31325867	Speech_translation	201308	1	0	0	0	1	1	0	0	62	23	3	56	21	2
31325867	Speech_translation	201309	3	0	0	0	2	2	0	0	65	24	3	59	22	2
31325867	Speech_translation	201412	1	0	0	0	1	0	0	0	66	25	3	59	22	2
31325867	Speech_translation	201505	1	0	0	0	1	0	0	0	67	26	3	59	22	2
31325867	Speech_translation	201602	7	0	0	0	1	0	0	0	74	27	3	59	22	2
31325867	Speech_translation	201603	3	1	0	0	2	1	1	0	77	29	4	60	23	2
31325867	Speech_translation	201605	2	0	0	0	2	1	0	0	79	31	4	61	24	2
31325867	Speech_translation	201607	2	0	0	0	1	1	0	0	81	32	4	63	25	2
31325867	Speech_translation	201608	2	0	0	0	2	1	0	0	83	34	4	64	26	2
31325867	Speech_translation	201612	1	0	0	0	1	0	0	0	84	35	4	64	26	2
31325867	Speech_translation	201701	1	0	0	0	1	1	0	0	85	36	4	65	27	2
31325867	Speech_translation	201703	1	0	0	0	1	1	0	0	86	37	4	66	28	2
31325867	Speech_translation	201704	1	0	0	0	1	1	0	0	87	38	4	67	29	2
31325867	Speech_translation	201709	1	0	0	0	1	1	0	0	88	38	4	68	29	2
31325867	Speech_translation	201802	1	0	0	0	1	1	0	0	89	39	4	69	30	2
31325867	Speech_translation	201803	3	0	0	0	1	1	0	0	92	40	4	72	31	2
31325867	Speech_translation	201804	1	0	0	0	1	1	0	0	93	41	4	73	32	2
31325867	Speech_translation	201805	1	0	0	0	1	1	0	0	94	42	4	74	33	2
30876097	Stream_Control_Transmission_Protocol	200402	2	0	0	0	1	1	0	0	2	1	0	2	1	0
30876097	Stream_Control_Transmission_Protocol	200403	1	0	0	0	1	1	0	0	3	2	0	3	2	0
30876097	Stream_Control_Transmission_Protocol	200404	1	0	0	0	1	0	0	0	4	3	0	3	2	0
30876097	Stream_Control_Transmission_Protocol	200406	4	0	0	0	4	3	0	0	8	7	0	6	5	0
30876097	Stream_Control_Transmission_Protocol	200407	2	0	0	0	2	2	0	0	10	9	0	8	7	0
30876097	Stream_Control_Transmission_Protocol	200410	1	0	0	0	1	0	0	0	11	10	0	8	7	0
30876097	Stream_Control_Transmission_Protocol	200411	1	0	0	0	1	1	0	0	12	11	0	9	8	0
30876097	Stream_Control_Transmission_Protocol	200412	1	0	0	0	1	1	0	0	13	12	0	10	9	0
30876097	Stream_Control_Transmission_Protocol	200501	2	0	0	0	2	1	0	0	15	14	0	11	10	0
30876097	Stream_Control_Transmission_Protocol	200502	1	0	0	0	1	1	0	0	16	15	0	12	11	0
30876097	Stream_Control_Transmission_Protocol	200503	2	0	0	0	1	0	0	0	18	16	0	12	11	0
30876097	Stream_Control_Transmission_Protocol	200504	5	0	0	0	2	0	0	0	23	18	0	12	11	0
30876097	Stream_Control_Transmission_Protocol	200505	3	0	0	0	2	0	0	0	26	20	0	12	11	0
30876097	Stream_Control_Transmission_Protocol	200506	11	0	0	0	1	0	0	0	37	21	0	12	11	0
30876097	Stream_Control_Transmission_Protocol	200507	6	0	0	0	5	2	0	0	43	26	0	14	13	0
30876097	Stream_Control_Transmission_Protocol	200508	1	0	0	0	1	1	0	0	44	27	0	15	14	0
30876097	Stream_Control_Transmission_Protocol	200509	1	0	0	0	1	1	0	0	45	28	0	16	15	0
30876097	Stream_Control_Transmission_Protocol	200510	3	0	0	0	2	0	0	0	48	30	0	16	15	0
30876097	Stream_Control_Transmission_Protocol	200511	2	0	0	0	2	1	0	0	50	31	0	17	15	0
30876097	Stream_Control_Transmission_Protocol	200512	5	0	0	0	4	3	0	0	55	35	0	20	18	0
30876097	Stream_Control_Transmission_Protocol	200601	5	0	0	0	3	1	0	0	60	37	0	22	18	0
30876097	Stream_Control_Transmission_Protocol	200602	2	0	0	0	2	1	0	0	62	39	0	23	19	0
30876097	Stream_Control_Transmission_Protocol	200603	40	0	0	0	4	2	0	0	102	43	0	58	21	0
30876097	Stream_Control_Transmission_Protocol	200604	31	0	0	0	19	10	0	0	133	60	0	75	29	0
30876097	Stream_Control_Transmission_Protocol	200605	9	1	0	0	6	5	1	0	142	64	1	83	32	1
30876097	Stream_Control_Transmission_Protocol	200606	3	0	0	0	3	1	0	0	145	66	1	84	32	1
30876097	Stream_Control_Transmission_Protocol	200607	4	0	0	0	3	1	0	0	149	69	1	85	33	1
30876097	Stream_Control_Transmission_Protocol	200608	3	0	0	0	3	1	0	0	152	72	1	86	34	1
30876097	Stream_Control_Transmission_Protocol	200609	5	0	0	0	3	2	0	0	157	75	1	88	36	1
30876097	Stream_Control_Transmission_Protocol	200610	8	1	0	0	6	2	1	0	165	81	2	90	38	1
30876097	Stream_Control_Transmission_Protocol	200611	9	0	0	0	4	3	0	0	174	85	2	96	41	1
30876097	Stream_Control_Transmission_Protocol	200612	7	1	0	0	4	2	1	0	181	88	3	99	42	1
30876097	Stream_Control_Transmission_Protocol	200701	2	0	0	0	2	2	0	0	183	90	3	101	44	1
30876097	Stream_Control_Transmission_Protocol	200702	5	0	0	0	3	1	0	0	188	93	3	102	45	1
30876097	Stream_Control_Transmission_Protocol	200703	5	0	0	0	4	1	0	0	193	97	3	103	46	1
30876097	Stream_Control_Transmission_Protocol	200705	4	0	0	0	3	3	0	0	197	99	3	107	48	1
30876097	Stream_Control_Transmission_Protocol	200706	3	1	0	0	3	2	1	0	200	102	4	109	50	1
30876097	Stream_Control_Transmission_Protocol	200707	5	0	0	0	4	3	0	0	205	106	4	113	53	1
30876097	Stream_Control_Transmission_Protocol	200708	11	2	0	0	9	5	2	0	216	113	6	120	56	2
30876097	Stream_Control_Transmission_Protocol	200709	2	0	0	0	2	1	0	0	218	114	6	121	56	2
30876097	Stream_Control_Transmission_Protocol	200710	11	0	0	0	6	5	0	0	229	119	6	129	60	2
30876097	Stream_Control_Transmission_Protocol	200711	13	2	0	0	8	5	1	0	242	126	8	137	64	2
30876097	Stream_Control_Transmission_Protocol	200712	3	0	0	0	3	2	0	0	245	129	8	139	66	2
30876097	Stream_Control_Transmission_Protocol	200801	2	0	0	0	2	0	0	0	247	130	8	139	66	2
30876097	Stream_Control_Transmission_Protocol	200802	1	0	0	0	1	1	0	0	248	131	8	140	67	2
30876097	Stream_Control_Transmission_Protocol	200803	9	2	0	0	5	1	1	0	257	135	10	144	67	2
30876097	Stream_Control_Transmission_Protocol	200805	6	0	0	0	5	2	0	0	263	140	10	147	69	2
30876097	Stream_Control_Transmission_Protocol	200806	12	4	0	0	8	4	2	0	275	147	14	155	72	5
30876097	Stream_Control_Transmission_Protocol	200807	3	1	0	0	3	2	1	0	278	149	15	157	73	5
30876097	Stream_Control_Transmission_Protocol	200808	8	1	0	0	8	7	1	0	286	155	16	164	78	6
30876097	Stream_Control_Transmission_Protocol	200809	7	0	0	0	4	3	0	0	293	158	16	170	80	6
30876097	Stream_Control_Transmission_Protocol	200811	12	0	0	0	4	1	0	0	305	161	16	171	80	6
30876097	Stream_Control_Transmission_Protocol	200812	2	0	0	0	2	2	0	0	307	163	16	173	82	6
30876097	Stream_Control_Transmission_Protocol	200901	1	0	0	0	1	1	0	0	308	164	16	174	83	6
30876097	Stream_Control_Transmission_Protocol	200902	10	0	0	0	6	5	0	0	318	168	16	183	86	6
30876097	Stream_Control_Transmission_Protocol	200903	3	0	0	0	3	2	0	0	321	170	16	185	87	6
30876097	Stream_Control_Transmission_Protocol	200904	16	0	0	0	7	5	0	0	337	174	16	199	89	6
30876097	Stream_Control_Transmission_Protocol	200905	4	2	0	0	4	2	2	0	341	176	18	201	89	6
30876097	Stream_Control_Transmission_Protocol	200906	1	0	0	0	1	0	0	0	342	177	18	201	89	6
30876097	Stream_Control_Transmission_Protocol	200907	6	1	0	0	5	3	1	0	348	180	19	205	90	7
30876097	Stream_Control_Transmission_Protocol	200908	5	0	0	0	4	3	0	0	353	183	19	208	92	7
30876097	Stream_Control_Transmission_Protocol	200909	1	0	0	0	1	1	0	0	354	183	19	209	92	7
30876097	Stream_Control_Transmission_Protocol	200910	2	0	0	0	2	1	0	0	356	185	19	210	93	7
30876097	Stream_Control_Transmission_Protocol	200911	2	0	0	0	2	1	0	0	358	187	19	211	94	7
30876097	Stream_Control_Transmission_Protocol	200912	2	0	0	0	2	1	0	0	360	189	19	212	95	7
30876097	Stream_Control_Transmission_Protocol	201001	2	0	0	0	2	0	0	0	362	191	19	212	95	7
30876097	Stream_Control_Transmission_Protocol	201002	4	0	0	0	3	3	0	0	366	192	19	216	96	7
30876097	Stream_Control_Transmission_Protocol	201003	6	1	0	0	4	3	1	0	372	196	20	221	99	8
30876097	Stream_Control_Transmission_Protocol	201004	1	0	0	0	1	1	0	0	373	197	20	222	100	8
30876097	Stream_Control_Transmission_Protocol	201005	4	0	0	0	4	3	0	0	377	200	20	225	102	8
30876097	Stream_Control_Transmission_Protocol	201006	5	1	0	0	4	2	1	0	382	203	21	227	103	8
30876097	Stream_Control_Transmission_Protocol	201007	4	1	0	0	4	3	1	0	386	206	22	230	105	8
30876097	Stream_Control_Transmission_Protocol	201008	2	0	0	0	2	2	0	0	388	208	22	232	107	8
30876097	Stream_Control_Transmission_Protocol	201009	8	0	0	0	4	2	0	0	396	210	22	238	107	8
30876097	Stream_Control_Transmission_Protocol	201010	1	0	0	0	1	0	0	0	397	211	22	238	107	8
30876097	Stream_Control_Transmission_Protocol	201011	1	0	0	0	1	0	0	0	398	212	22	238	107	8
30876097	Stream_Control_Transmission_Protocol	201012	8	0	0	0	5	2	0	0	406	215	22	243	107	8
30876097	Stream_Control_Transmission_Protocol	201101	1	0	0	0	1	0	0	0	407	216	22	243	107	8
30876097	Stream_Control_Transmission_Protocol	201102	1	0	0	0	1	0	0	0	408	217	22	243	107	8
30876097	Stream_Control_Transmission_Protocol	201103	9	2	0	0	6	5	2	0	417	221	24	251	110	8
30876097	Stream_Control_Transmission_Protocol	201104	1	0	0	0	1	1	0	0	418	222	24	252	111	8
30876097	Stream_Control_Transmission_Protocol	201105	3	0	0	0	2	1	0	0	421	223	24	253	111	8
30876097	Stream_Control_Transmission_Protocol	201106	1	0	0	0	1	0	0	0	422	224	24	253	111	8
30876097	Stream_Control_Transmission_Protocol	201107	2	0	0	0	2	2	0	0	424	226	24	255	113	8
30876097	Stream_Control_Transmission_Protocol	201108	3	0	0	0	1	1	0	0	427	226	24	258	113	8
30876097	Stream_Control_Transmission_Protocol	201109	6	1	0	0	6	4	1	0	433	231	25	262	116	9
30876097	Stream_Control_Transmission_Protocol	201110	1	0	0	0	1	1	0	0	434	232	25	263	117	9
30876097	Stream_Control_Transmission_Protocol	201112	1	0	0	0	1	1	0	0	435	232	25	264	117	9
30876097	Stream_Control_Transmission_Protocol	201201	2	0	0	0	2	0	0	0	437	234	25	264	117	9
30876097	Stream_Control_Transmission_Protocol	201202	1	0	0	0	1	1	0	0	438	235	25	265	118	9
30876097	Stream_Control_Transmission_Protocol	201203	2	0	0	0	2	2	0	0	440	237	25	267	120	9
30876097	Stream_Control_Transmission_Protocol	201204	1	0	0	0	1	0	0	0	441	238	25	267	120	9
30876097	Stream_Control_Transmission_Protocol	201205	3	1	0	0	3	1	1	0	444	240	26	268	120	9
30876097	Stream_Control_Transmission_Protocol	201207	5	0	0	0	5	4	0	0	449	244	26	272	123	9
30876097	Stream_Control_Transmission_Protocol	201208	1	0	0	0	1	1	0	0	450	245	26	273	124	9
30876097	Stream_Control_Transmission_Protocol	201209	1	0	0	0	1	1	0	0	451	246	26	274	125	9
30876097	Stream_Control_Transmission_Protocol	201210	1	0	0	0	1	1	0	0	452	247	26	275	126	9
30876097	Stream_Control_Transmission_Protocol	201212	1	0	0	0	1	1	0	0	453	248	26	276	127	9
30876097	Stream_Control_Transmission_Protocol	201301	7	0	0	0	5	3	0	0	460	252	26	280	129	9
30876097	Stream_Control_Transmission_Protocol	201302	2	0	0	0	1	1	0	0	462	253	26	282	130	9
30876097	Stream_Control_Transmission_Protocol	201305	1	0	0	0	1	1	0	0	463	254	26	283	131	9
30876097	Stream_Control_Transmission_Protocol	201306	2	0	0	0	2	1	0	0	465	256	26	284	132	9
30876097	Stream_Control_Transmission_Protocol	201307	2	0	0	0	2	1	0	0	467	258	26	285	133	9
30876097	Stream_Control_Transmission_Protocol	201308	3	1	0	0	3	1	1	0	470	260	27	286	133	9
30876097	Stream_Control_Transmission_Protocol	201309	1	0	0	0	1	1	0	0	471	261	27	287	134	9
30876097	Stream_Control_Transmission_Protocol	201310	7	1	0	0	5	4	1	0	478	266	28	293	138	9
30876097	Stream_Control_Transmission_Protocol	201312	2	0	0	0	2	2	0	0	480	266	28	295	138	9
30876097	Stream_Control_Transmission_Protocol	201402	2	1	0	0	2	1	1	0	482	267	29	296	138	9
30876097	Stream_Control_Transmission_Protocol	201403	4	1	0	0	3	1	1	0	486	269	30	298	138	9
30876097	Stream_Control_Transmission_Protocol	201404	1	0	0	0	1	1	0	0	487	270	30	299	139	9
30876097	Stream_Control_Transmission_Protocol	201405	5	1	0	0	5	2	1	0	492	274	31	301	140	9
30876097	Stream_Control_Transmission_Protocol	201406	4	1	0	0	3	2	1	0	496	276	32	303	141	9
30876097	Stream_Control_Transmission_Protocol	201409	3	0	0	0	2	1	0	0	499	277	32	305	141	9
30876097	Stream_Control_Transmission_Protocol	201410	7	0	0	0	5	4	0	0	506	280	32	311	143	9
30876097	Stream_Control_Transmission_Protocol	201412	2	0	0	0	1	0	0	0	508	281	32	311	143	9
30876097	Stream_Control_Transmission_Protocol	201501	3	0	0	0	2	0	0	0	511	283	32	311	143	9
30876097	Stream_Control_Transmission_Protocol	201502	7	0	0	0	6	6	0	0	518	285	32	318	145	9
30876097	Stream_Control_Transmission_Protocol	201503	7	0	0	0	3	3	0	0	525	288	32	325	148	9
30876097	Stream_Control_Transmission_Protocol	201504	3	0	0	0	3	2	0	0	528	289	32	327	148	9
30876097	Stream_Control_Transmission_Protocol	201505	1	1	0	0	1	1	1	0	529	289	33	328	148	9
30876097	Stream_Control_Transmission_Protocol	201507	1	0	0	0	1	1	0	0	530	290	33	329	149	9
30876097	Stream_Control_Transmission_Protocol	201509	1	0	0	0	1	1	0	0	531	291	33	330	150	9
30876097	Stream_Control_Transmission_Protocol	201602	1	0	0	0	1	0	0	0	532	292	33	330	150	9
30876097	Stream_Control_Transmission_Protocol	201603	2	0	0	0	1	1	0	0	534	293	33	332	151	9
30876097	Stream_Control_Transmission_Protocol	201604	1	0	0	0	1	1	0	0	535	293	33	333	151	9
30876097	Stream_Control_Transmission_Protocol	201605	4	0	0	0	4	3	0	0	539	296	33	336	153	9
30876097	Stream_Control_Transmission_Protocol	201607	2	0	0	0	2	1	0	0	541	298	33	337	154	9
30876097	Stream_Control_Transmission_Protocol	201609	5	0	0	0	1	0	0	0	546	299	33	337	154	9
30876097	Stream_Control_Transmission_Protocol	201610	1	0	0	0	1	1	0	0	547	300	33	338	155	9
30876097	Stream_Control_Transmission_Protocol	201611	2	0	0	0	2	2	0	0	549	302	33	340	157	9
30876097	Stream_Control_Transmission_Protocol	201612	1	0	0	0	1	1	0	0	550	303	33	341	158	9
30876097	Stream_Control_Transmission_Protocol	201701	2	0	0	0	2	2	0	0	552	305	33	343	160	9
30876097	Stream_Control_Transmission_Protocol	201703	7	1	0	0	3	2	1	0	559	306	34	345	160	9
30876097	Stream_Control_Transmission_Protocol	201704	3	0	0	0	2	2	0	0	562	308	34	348	162	9
30876097	Stream_Control_Transmission_Protocol	201707	6	0	0	0	6	5	0	0	568	311	34	353	164	9
30876097	Stream_Control_Transmission_Protocol	201708	1	0	0	0	1	1	0	0	569	312	34	354	165	9
30876097	Stream_Control_Transmission_Protocol	201710	1	0	0	0	1	1	0	0	570	313	34	355	165	9
30876097	Stream_Control_Transmission_Protocol	201712	5	1	0	0	5	5	1	0	575	316	35	360	167	10
30876097	Stream_Control_Transmission_Protocol	201801	9	0	0	0	2	2	0	0	584	317	35	369	168	10
30876097	Stream_Control_Transmission_Protocol	201803	2	1	0	0	2	2	1	0	586	318	36	371	169	11
30876097	Stream_Control_Transmission_Protocol	201804	2	0	0	0	1	0	0	0	588	319	36	371	169	11
30876097	Stream_Control_Transmission_Protocol	201805	2	0	0	0	1	0	0	0	590	320	36	371	169	11
30876097	Stream_Control_Transmission_Protocol	201806	1	0	0	0	1	0	0	0	591	321	36	371	169	11
30876097	Stream_Control_Transmission_Protocol	201807	3	0	0	0	3	3	0	0	594	322	36	374	169	11
37153	Supercomputer	200202	11	0	0	0	6	6	0	0	11	6	0	11	5	0
37153	Supercomputer	200204	1	0	0	0	1	1	0	0	12	6	0	12	5	0
37153	Supercomputer	200206	23	0	0	0	9	1	0	0	35	15	0	13	6	0
37153	Supercomputer	200207	9	0	0	0	5	3	0	0	44	19	0	16	8	0
37153	Supercomputer	200208	6	0	0	0	4	2	0	0	50	21	0	20	9	0
37153	Supercomputer	200209	1	0	0	0	1	0	0	0	51	22	0	20	9	0
37153	Supercomputer	200210	1	0	0	0	1	1	0	0	52	23	0	21	10	0
37153	Supercomputer	200211	4	0	0	0	4	3	0	0	56	27	0	24	13	0
37153	Supercomputer	200212	1	0	0	0	1	0	0	0	57	28	0	24	13	0
37153	Supercomputer	200301	1	0	0	0	1	1	0	0	58	29	0	25	14	0
37153	Supercomputer	200302	1	0	0	0	1	0	0	0	59	30	0	25	14	0
37153	Supercomputer	200305	1	0	0	0	1	0	0	0	60	31	0	25	14	0
37153	Supercomputer	200306	1	0	0	0	1	1	0	0	61	32	0	26	15	0
37153	Supercomputer	200307	1	0	0	0	1	0	0	0	62	33	0	26	15	0
37153	Supercomputer	200308	23	0	0	0	8	2	0	0	85	40	0	31	16	0
37153	Supercomputer	200309	8	0	0	0	2	2	0	0	93	41	0	39	17	0
37153	Supercomputer	200310	3	0	0	0	2	1	0	0	96	43	0	40	18	0
37153	Supercomputer	200311	1	0	0	0	1	1	0	0	97	44	0	41	19	0
37153	Supercomputer	200312	4	0	0	0	2	2	0	0	101	45	0	45	20	0
37153	Supercomputer	200401	1	0	0	0	1	0	0	0	102	46	0	45	20	0
37153	Supercomputer	200402	4	0	0	0	2	2	0	0	106	48	0	49	22	0
37153	Supercomputer	200403	6	0	0	0	3	3	0	0	112	51	0	55	25	0
37153	Supercomputer	200404	6	0	0	0	3	3	0	0	118	54	0	61	28	0
37153	Supercomputer	200405	1	0	0	0	1	0	0	0	119	55	0	61	28	0
37153	Supercomputer	200406	21	0	0	0	12	11	0	0	140	66	0	79	38	0
37153	Supercomputer	200407	10	0	0	0	7	4	0	0	150	72	0	86	41	0
37153	Supercomputer	200408	17	0	0	0	5	4	0	0	167	75	0	102	43	0
37153	Supercomputer	200409	2	0	0	0	2	2	0	0	169	77	0	104	45	0
37153	Supercomputer	200410	7	0	0	0	6	3	0	0	176	81	0	108	46	0
37153	Supercomputer	200411	10	1	0	0	6	4	1	0	186	85	1	113	48	0
37153	Supercomputer	200412	44	1	0	0	16	10	1	0	230	96	2	148	53	0
37153	Supercomputer	200501	16	1	0	0	11	6	1	0	246	104	3	159	56	1
37153	Supercomputer	200502	40	0	0	0	9	6	0	0	286	111	3	196	60	1
37153	Supercomputer	200503	7	1	0	0	6	5	1	0	293	115	4	201	63	1
37153	Supercomputer	200504	17	3	0	0	13	9	3	0	310	124	7	214	68	1
37153	Supercomputer	200505	35	2	0	0	20	10	2	0	345	139	9	234	73	1
37153	Supercomputer	200506	26	8	2	1	16	8	6	2	371	153	17	248	79	4
37153	Supercomputer	200507	10	0	0	0	7	4	0	0	381	159	17	254	82	4
37153	Supercomputer	200508	34	0	0	0	15	10	0	0	415	172	17	281	90	4
37153	Supercomputer	200509	9	1	0	0	9	6	1	0	424	180	18	287	95	4
37153	Supercomputer	200510	29	1	0	0	16	10	1	0	453	190	19	303	99	4
37153	Supercomputer	200511	28	3	0	0	19	10	3	0	481	202	22	316	103	5
37153	Supercomputer	200512	27	5	0	0	17	8	4	0	508	217	27	329	109	5
37153	Supercomputer	200601	19	1	0	0	13	7	1	0	527	226	28	336	113	5
37153	Supercomputer	200602	22	4	0	0	16	9	3	0	549	237	32	351	117	5
37153	Supercomputer	200603	36	7	0	0	19	11	5	0	585	251	39	366	124	5
37153	Supercomputer	200604	26	2	0	0	21	11	2	0	611	267	41	377	131	5
37153	Supercomputer	200605	26	8	0	0	15	8	4	0	637	281	49	389	138	5
37153	Supercomputer	200606	30	7	0	0	25	15	6	0	667	303	56	406	150	5
37153	Supercomputer	200607	42	5	0	0	14	10	3	0	709	315	61	425	158	5
37153	Supercomputer	200608	30	5	0	0	19	10	3	0	739	330	66	444	165	6
37153	Supercomputer	200609	41	6	0	0	24	14	6	0	780	353	72	471	178	7
37153	Supercomputer	200610	25	7	0	0	17	10	5	0	805	367	79	485	185	7
37153	Supercomputer	200611	55	9	1	0	33	16	6	1	860	394	88	517	196	8
37153	Supercomputer	200612	44	9	0	0	31	20	6	0	904	417	97	542	208	10
37153	Supercomputer	200701	48	11	0	0	28	16	9	0	952	438	108	567	218	11
37153	Supercomputer	200702	29	4	0	0	21	9	4	0	981	457	112	582	225	12
37153	Supercomputer	200703	57	11	0	0	28	13	9	0	1038	483	123	605	236	14
37153	Supercomputer	200704	62	16	0	0	35	23	13	0	1100	513	139	635	254	14
37153	Supercomputer	200705	32	10	0	0	24	13	7	0	1132	534	149	651	264	16
37153	Supercomputer	200706	42	9	0	0	28	14	8	0	1174	556	158	673	272	16
37153	Supercomputer	200707	29	4	0	0	17	8	3	0	1203	569	162	693	276	16
37153	Supercomputer	200708	20	2	0	0	14	8	2	0	1223	579	164	704	280	16
37153	Supercomputer	200709	41	5	0	0	19	9	5	0	1264	595	169	734	286	17
37153	Supercomputer	200710	89	28	2	0	48	28	20	2	1353	638	197	776	309	19
37153	Supercomputer	200711	21	3	0	0	12	7	3	0	1374	644	200	789	310	19
37153	Supercomputer	200712	41	10	0	0	26	15	8	0	1415	664	210	809	319	21
37153	Supercomputer	200801	16	3	0	0	14	11	3	0	1431	675	213	821	327	24
37153	Supercomputer	200802	19	4	0	0	15	9	4	0	1450	690	217	831	336	25
37153	Supercomputer	200803	39	14	1	0	23	13	9	1	1489	708	231	851	344	27
37153	Supercomputer	200804	20	5	0	0	19	14	5	0	1509	721	236	866	352	29
37153	Supercomputer	200805	28	4	0	0	20	10	2	0	1537	738	240	881	359	29
37153	Supercomputer	200806	28	5	0	0	20	12	4	0	1565	752	245	900	366	30
37153	Supercomputer	200807	67	7	0	0	29	15	4	0	1632	773	252	946	373	31
37153	Supercomputer	200808	26	5	2	1	15	8	4	2	1658	785	257	962	378	33
37153	Supercomputer	200809	27	5	0	0	21	12	5	0	1685	803	262	976	387	34
37153	Supercomputer	200810	42	13	0	0	20	6	7	0	1727	819	275	990	389	35
37153	Supercomputer	200811	28	4	0	0	18	9	4	0	1755	832	279	1001	393	35
37153	Supercomputer	200812	55	8	0	0	25	12	6	0	1810	854	287	1029	402	36
37153	Supercomputer	200901	33	4	0	0	22	10	2	0	1843	873	291	1049	409	36
37153	Supercomputer	200902	7	2	0	0	6	4	2	0	1850	878	293	1053	412	37
37153	Supercomputer	200903	45	8	0	0	23	13	6	0	1895	895	301	1077	419	37
37153	Supercomputer	200904	32	16	8	5	21	13	8	3	1927	911	317	1095	427	44
37153	Supercomputer	200905	19	5	0	0	16	9	4	0	1946	924	322	1107	433	44
37153	Supercomputer	200906	45	5	0	0	20	12	4	0	1991	937	327	1135	438	46
37153	Supercomputer	200907	19	3	0	0	14	8	3	0	2010	948	330	1146	443	46
37153	Supercomputer	200908	21	1	0	0	17	8	1	0	2031	964	331	1157	450	46
37153	Supercomputer	200909	21	5	0	0	16	9	5	0	2052	979	336	1168	458	46
37153	Supercomputer	200910	54	15	0	0	32	14	11	0	2106	1007	351	1188	468	46
37153	Supercomputer	200911	33	6	0	0	27	12	6	0	2139	1029	357	1203	475	46
37153	Supercomputer	200912	27	6	0	0	20	11	5	0	2166	1046	363	1215	483	46
37153	Supercomputer	201001	32	4	0	0	25	11	4	0	2198	1068	367	1230	491	46
37153	Supercomputer	201002	9	3	0	0	9	7	3	0	2207	1075	370	1237	496	47
37153	Supercomputer	201003	7	1	0	0	6	4	1	0	2214	1080	371	1242	499	47
37153	Supercomputer	201004	18	5	0	0	12	6	4	0	2232	1090	376	1254	504	49
37153	Supercomputer	201005	20	3	0	0	9	3	1	0	2252	1097	379	1259	505	49
37153	Supercomputer	201006	3	0	0	0	3	0	0	0	2255	1100	379	1259	505	49
37153	Supercomputer	201007	14	1	0	0	12	6	1	0	2269	1112	380	1265	511	49
37153	Supercomputer	201008	6	1	0	0	5	3	1	0	2275	1115	381	1268	512	50
37153	Supercomputer	201009	10	2	0	0	8	2	2	0	2285	1122	383	1270	513	50
37153	Supercomputer	201010	22	6	0	0	19	8	6	0	2307	1139	389	1280	520	50
37153	Supercomputer	201011	45	8	0	0	29	17	8	0	2352	1164	397	1305	533	52
37153	Supercomputer	201012	19	3	0	0	15	6	2	0	2371	1178	400	1312	538	52
37153	Supercomputer	201101	10	2	0	0	9	5	2	0	2381	1185	402	1317	541	52
37153	Supercomputer	201102	13	3	0	0	10	3	1	0	2394	1193	405	1323	542	53
37153	Supercomputer	201103	30	5	0	0	18	8	3	0	2424	1209	410	1341	548	54
37153	Supercomputer	201104	12	2	0	0	11	6	2	0	2436	1216	412	1348	550	54
37153	Supercomputer	201105	10	2	0	0	9	3	2	0	2446	1223	414	1351	551	54
37153	Supercomputer	201106	43	5	0	0	14	9	3	0	2489	1234	419	1389	557	55
37153	Supercomputer	201107	42	12	0	0	27	16	7	0	2531	1258	431	1415	570	55
37153	Supercomputer	201108	99	9	3	2	19	12	5	2	2630	1274	440	1504	579	60
37153	Supercomputer	201109	41	1	0	0	14	7	1	0	2671	1285	441	1534	583	60
37153	Supercomputer	201110	25	7	0	0	20	11	5	0	2696	1302	448	1549	591	60
37153	Supercomputer	201111	9	1	0	0	6	5	1	0	2705	1307	449	1556	595	60
37153	Supercomputer	201112	12	2	0	0	11	6	2	0	2717	1315	451	1562	598	60
37153	Supercomputer	201201	5	1	0	0	4	3	1	0	2722	1318	452	1566	600	60
37153	Supercomputer	201202	16	2	0	0	14	9	2	0	2738	1328	454	1576	605	60
37153	Supercomputer	201203	148	5	0	0	18	10	3	0	2886	1343	459	1715	612	60
37153	Supercomputer	201204	16	4	0	0	9	7	1	0	2902	1351	463	1729	618	62
37153	Supercomputer	201205	7	2	0	0	6	3	2	0	2909	1355	465	1732	619	62
37153	Supercomputer	201206	20	3	0	0	12	8	2	0	2929	1365	468	1745	625	63
37153	Supercomputer	201207	30	7	0	0	19	12	4	0	2959	1380	475	1764	633	63
37153	Supercomputer	201208	16	7	0	0	10	6	4	0	2975	1386	482	1773	635	64
37153	Supercomputer	201209	9	2	0	0	9	6	2	0	2984	1390	484	1779	637	65
37153	Supercomputer	201210	18	7	0	0	11	2	2	0	3002	1399	491	1786	637	65
37153	Supercomputer	201211	21	2	0	0	10	4	2	0	3023	1406	493	1797	638	65
37153	Supercomputer	201212	43	11	0	0	21	8	4	0	3066	1423	504	1822	642	65
37153	Supercomputer	201301	15	4	0	0	13	6	3	0	3081	1434	508	1830	646	65
37153	Supercomputer	201302	17	6	0	0	14	8	5	0	3098	1445	514	1840	651	65
37153	Supercomputer	201303	18	5	0	0	14	9	5	0	3116	1456	519	1852	657	66
37153	Supercomputer	201304	22	8	0	0	13	7	6	0	3138	1464	527	1861	659	66
37153	Supercomputer	201305	12	3	0	0	7	4	3	0	3150	1469	530	1868	661	66
37153	Supercomputer	201306	15	5	0	0	10	5	4	0	3165	1476	535	1875	663	66
37153	Supercomputer	201307	41	10	0	0	20	11	7	0	3206	1491	545	1902	669	69
37153	Supercomputer	201308	2	0	0	0	1	1	0	0	3208	1491	545	1904	669	69
37153	Supercomputer	201309	4	1	0	0	3	2	1	0	3212	1493	546	1906	670	69
37153	Supercomputer	201310	10	4	0	0	9	3	3	0	3222	1501	550	1910	672	69
37153	Supercomputer	201311	15	7	2	1	10	4	4	2	3237	1509	557	1917	674	70
37153	Supercomputer	201312	19	7	4	3	9	5	4	2	3256	1516	564	1931	677	75
37153	Supercomputer	201401	7	2	0	0	7	6	2	0	3263	1521	566	1937	679	76
37153	Supercomputer	201402	25	4	0	0	18	9	4	0	3288	1537	570	1950	686	76
37153	Supercomputer	201403	11	1	0	0	9	7	1	0	3299	1545	571	1958	692	76
37153	Supercomputer	201404	10	3	0	0	8	5	3	0	3309	1552	574	1964	696	76
37153	Supercomputer	201405	17	5	0	0	11	7	4	0	3326	1560	579	1974	700	80
37153	Supercomputer	201406	9	2	0	0	8	5	2	0	3335	1567	581	1979	704	80
37153	Supercomputer	201407	13	2	0	0	10	5	2	0	3348	1576	583	1986	708	81
37153	Supercomputer	201408	2	0	0	0	2	2	0	0	3350	1578	583	1988	710	81
37153	Supercomputer	201409	6	2	0	0	5	3	2	0	3356	1582	585	1992	712	81
37153	Supercomputer	201410	14	5	1	0	9	5	4	1	3370	1588	590	1998	714	83
37153	Supercomputer	201411	18	10	1	0	13	7	6	1	3388	1599	600	2008	718	86
37153	Supercomputer	201412	16	2	0	0	10	7	2	0	3404	1608	602	2020	724	86
37153	Supercomputer	201501	14	1	0	0	5	4	1	0	3418	1613	603	2033	728	87
37153	Supercomputer	201502	12	2	0	0	9	6	2	0	3430	1619	605	2041	731	87
37153	Supercomputer	201503	17	5	0	0	9	5	5	0	3447	1625	610	2046	734	87
37153	Supercomputer	201504	9	1	0	0	8	7	1	0	3456	1631	611	2054	738	88
37153	Supercomputer	201505	9	2	0	0	4	2	2	0	3465	1633	613	2059	738	88
37153	Supercomputer	201506	23	5	0	0	15	7	4	0	3488	1646	618	2069	743	88
37153	Supercomputer	201507	16	3	0	0	9	5	3	0	3504	1652	621	2078	745	88
37153	Supercomputer	201508	21	5	0	0	12	6	2	0	3525	1662	626	2091	749	88
37153	Supercomputer	201509	18	2	0	0	7	4	2	0	3543	1667	628	2103	751	88
37153	Supercomputer	201510	12	5	0	0	9	7	4	0	3555	1674	633	2111	754	91
37153	Supercomputer	201511	9	3	0	0	7	6	3	0	3564	1677	636	2117	756	92
37153	Supercomputer	201512	8	1	0	0	7	3	1	0	3572	1683	637	2120	758	92
37153	Supercomputer	201601	6	1	0	0	6	5	1	0	3578	1688	638	2125	762	92
37153	Supercomputer	201602	10	2	0	0	8	5	1	0	3588	1694	640	2132	765	92
37153	Supercomputer	201603	18	7	2	1	12	9	5	2	3606	1702	647	2145	770	96
37153	Supercomputer	201604	14	4	0	0	13	9	3	0	3620	1712	651	2155	776	96
37153	Supercomputer	201605	4	0	0	0	4	4	0	0	3624	1715	651	2159	779	96
37153	Supercomputer	201606	2	1	0	0	2	2	1	0	3626	1716	652	2161	780	97
37153	Supercomputer	201607	6	1	0	0	6	4	1	0	3632	1720	653	2165	782	97
37153	Supercomputer	201608	8	1	0	0	7	6	1	0	3640	1723	654	2172	784	97
37153	Supercomputer	201609	13	3	0	0	10	5	2	0	3653	1730	657	2179	786	97
37153	Supercomputer	201610	10	4	0	0	7	5	3	0	3663	1734	661	2186	787	99
37153	Supercomputer	201611	10	3	0	0	9	4	3	0	3673	1741	664	2190	789	99
37153	Supercomputer	201612	11	3	0	0	10	5	3	0	3684	1749	667	2196	792	100
37153	Supercomputer	201701	6	2	0	0	6	4	2	0	3690	1753	669	2200	794	100
37153	Supercomputer	201702	14	2	0	0	11	6	2	0	3704	1762	671	2208	796	101
37153	Supercomputer	201703	17	5	0	0	11	7	4	0	3721	1770	676	2219	799	104
37153	Supercomputer	201704	7	1	0	0	7	5	1	0	3728	1774	677	2224	801	105
37153	Supercomputer	201705	3	0	0	0	2	1	0	0	3731	1776	677	2226	802	105
37153	Supercomputer	201706	10	1	0	0	8	5	1	0	3741	1783	678	2231	805	105
37153	Supercomputer	201707	6	1	0	0	5	4	1	0	3747	1787	679	2235	808	106
37153	Supercomputer	201708	21	0	0	0	8	7	0	0	3768	1792	679	2255	812	106
37153	Supercomputer	201709	20	7	0	0	14	7	5	0	3788	1804	686	2264	817	106
37153	Supercomputer	201710	12	3	0	0	8	5	2	0	3800	1810	689	2271	820	106
37153	Supercomputer	201711	9	1	0	0	6	5	1	0	3809	1815	690	2278	824	107
37153	Supercomputer	201712	22	8	0	0	17	12	5	0	3831	1828	698	2294	829	109
37153	Supercomputer	201801	16	2	0	0	8	6	2	0	3847	1833	700	2308	831	111
37153	Supercomputer	201802	14	3	0	0	14	9	3	0	3861	1844	703	2317	836	113
37153	Supercomputer	201803	6	1	0	0	6	2	1	0	3867	1849	704	2319	837	113
37153	Supercomputer	201804	7	1	0	0	6	5	1	0	3874	1851	705	2325	838	113
37153	Supercomputer	201805	15	7	1	0	10	8	7	1	3889	1857	712	2335	841	116
37153	Supercomputer	201806	16	6	0	0	12	8	3	0	3905	1865	718	2347	845	118
37153	Supercomputer	201807	19	2	0	0	13	10	2	0	3924	1875	720	2363	851	118
33094374	Telecommunication	200112	1	0	0	0	1	1	0	0	1	1	0	1	1	0
33094374	Telecommunication	200202	4	0	0	0	1	1	0	0	5	2	0	5	2	0
33094374	Telecommunication	200203	5	0	0	0	4	3	0	0	10	5	0	9	2	0
33094374	Telecommunication	200204	1	0	0	0	1	0	0	0	11	6	0	9	2	0
33094374	Telecommunication	200207	1	0	0	0	1	1	0	0	12	7	0	10	3	0
33094374	Telecommunication	200208	2	0	0	0	2	1	0	0	14	9	0	11	4	0
33094374	Telecommunication	200210	1	0	0	0	1	1	0	0	15	10	0	12	5	0
33094374	Telecommunication	200301	2	0	0	0	2	1	0	0	17	12	0	13	6	0
33094374	Telecommunication	200302	1	0	0	0	1	1	0	0	18	13	0	14	7	0
33094374	Telecommunication	200303	1	0	0	0	1	0	0	0	19	14	0	14	7	0
33094374	Telecommunication	200307	2	0	0	0	2	2	0	0	21	16	0	16	9	0
33094374	Telecommunication	200308	3	0	0	0	3	3	0	0	24	18	0	19	11	0
33094374	Telecommunication	200309	2	0	0	0	2	1	0	0	26	19	0	20	11	0
33094374	Telecommunication	200310	1	0	0	0	1	0	0	0	27	20	0	20	11	0
33094374	Telecommunication	200311	1	0	0	0	1	1	0	0	28	21	0	21	12	0
33094374	Telecommunication	200312	2	0	0	0	2	2	0	0	30	23	0	23	14	0
33094374	Telecommunication	200401	8	0	0	0	6	5	0	0	38	29	0	30	19	0
33094374	Telecommunication	200402	1	0	0	0	1	1	0	0	39	30	0	31	20	0
33094374	Telecommunication	200403	1	0	0	0	1	1	0	0	40	31	0	32	21	0
33094374	Telecommunication	200404	3	1	0	0	3	2	1	0	43	34	1	34	23	0
33094374	Telecommunication	200405	4	0	0	0	4	3	0	0	47	37	1	37	25	0
33094374	Telecommunication	200406	6	2	0	0	6	2	2	0	53	43	3	39	27	0
33094374	Telecommunication	200407	4	0	0	0	4	3	0	0	57	46	3	42	28	0
33094374	Telecommunication	200408	4	0	0	0	3	3	0	0	61	49	3	46	31	0
33094374	Telecommunication	200409	8	0	0	0	5	2	0	0	69	53	3	51	32	0
33094374	Telecommunication	200410	4	0	0	0	3	2	0	0	73	56	3	54	34	0
33094374	Telecommunication	200411	4	1	0	0	4	1	1	0	77	60	4	55	35	0
33094374	Telecommunication	200412	2	1	0	0	2	1	1	0	79	61	5	56	35	0
33094374	Telecommunication	200501	2	0	0	0	2	2	0	0	81	63	5	58	37	0
33094374	Telecommunication	200502	6	1	0	0	5	2	1	0	87	67	6	60	38	0
33094374	Telecommunication	200503	9	1	0	0	7	4	1	0	96	74	7	66	42	0
33094374	Telecommunication	200504	12	2	0	0	6	1	2	0	108	80	9	67	43	0
33094374	Telecommunication	200505	3	1	0	0	3	2	1	0	111	82	10	69	44	0
33094374	Telecommunication	200506	5	2	0	0	5	2	2	0	116	87	12	71	46	0
33094374	Telecommunication	200507	14	1	0	0	12	7	1	0	130	99	13	79	53	0
33094374	Telecommunication	200508	8	1	0	0	7	4	1	0	138	104	14	83	55	0
33094374	Telecommunication	200509	17	3	0	0	14	7	3	0	155	118	17	90	62	0
33094374	Telecommunication	200510	21	3	0	0	13	3	2	0	176	131	20	95	65	0
33094374	Telecommunication	200511	7	1	0	0	6	2	1	0	183	137	21	97	67	0
33094374	Telecommunication	200512	12	3	0	0	10	6	3	0	195	146	24	105	72	1
33094374	Telecommunication	200601	18	3	0	0	13	5	2	0	213	158	27	111	76	1
33094374	Telecommunication	200602	13	2	0	0	12	7	2	0	226	168	29	118	81	1
33094374	Telecommunication	200603	24	3	0	0	19	12	3	0	250	185	32	135	91	2
33094374	Telecommunication	200604	37	6	0	0	22	12	5	0	287	205	38	152	101	3
33094374	Telecommunication	200605	32	10	4	3	19	8	6	2	319	222	48	168	108	5
33094374	Telecommunication	200606	120	10	1	0	29	19	8	1	439	246	58	273	122	9
33094374	Telecommunication	200607	94	6	0	0	27	13	1	0	533	271	64	349	133	11
33094374	Telecommunication	200608	79	5	0	0	19	9	3	0	612	287	69	410	139	12
33094374	Telecommunication	200609	62	3	0	0	10	8	2	0	674	293	72	470	143	15
33094374	Telecommunication	200610	64	7	1	0	19	12	4	1	738	309	79	524	152	17
33094374	Telecommunication	200611	34	3	0	0	10	4	2	0	772	318	82	552	155	17
33094374	Telecommunication	200612	41	4	0	0	20	6	3	0	813	337	86	574	160	18
33094374	Telecommunication	200701	33	3	0	0	27	19	3	0	846	362	89	598	177	18
33094374	Telecommunication	200702	28	10	0	0	18	8	8	0	874	379	99	613	184	20
33094374	Telecommunication	200703	29	7	0	0	17	9	4	0	903	394	106	632	191	22
33094374	Telecommunication	200704	28	8	0	0	19	7	5	0	931	409	114	644	195	22
33094374	Telecommunication	200705	23	5	0	0	14	7	3	0	954	419	119	658	198	22
33094374	Telecommunication	200706	82	6	0	0	23	15	6	0	1036	436	125	732	208	23
33094374	Telecommunication	200707	147	4	0	0	16	9	3	0	1183	448	129	869	213	25
33094374	Telecommunication	200708	49	3	0	0	13	10	2	0	1232	458	132	915	220	26
33094374	Telecommunication	200709	20	8	1	0	17	11	8	1	1252	472	140	928	228	27
33094374	Telecommunication	200710	32	8	0	0	23	11	7	0	1284	492	148	943	236	29
33094374	Telecommunication	200711	48	6	0	0	22	14	5	0	1332	506	154	980	243	29
33094374	Telecommunication	200712	13	2	0	0	10	6	2	0	1345	513	156	989	246	29
33094374	Telecommunication	200801	41	5	0	0	21	13	4	0	1386	528	161	1020	253	30
33094374	Telecommunication	200802	23	4	0	0	17	11	3	0	1409	540	165	1035	260	30
33094374	Telecommunication	200803	17	5	0	0	17	9	5	0	1426	552	170	1044	264	32
33094374	Telecommunication	200804	10	3	0	0	8	5	3	0	1436	557	173	1050	266	32
33094374	Telecommunication	200805	19	6	0	0	16	8	5	0	1455	568	179	1059	269	32
33094374	Telecommunication	200806	23	8	0	0	16	8	5	0	1478	581	187	1071	274	32
33094374	Telecommunication	200807	17	4	0	0	15	10	4	0	1495	592	191	1083	280	32
33094374	Telecommunication	200808	24	6	0	0	19	9	5	0	1519	608	197	1094	286	33
33094374	Telecommunication	200809	54	6	0	0	13	8	3	0	1573	618	203	1137	291	36
33094374	Telecommunication	200810	78	7	0	0	34	19	6	0	1651	645	210	1196	304	36
33094374	Telecommunication	200811	18	1	0	0	11	5	1	0	1669	653	211	1207	306	36
33094374	Telecommunication	200812	18	3	0	0	17	9	3	0	1687	666	214	1216	312	36
33094374	Telecommunication	200901	30	7	2	1	17	10	5	2	1717	680	221	1237	320	38
33094374	Telecommunication	200902	29	11	3	1	21	11	8	2	1746	696	232	1251	326	41
33094374	Telecommunication	200903	32	7	0	0	17	14	6	0	1778	707	239	1277	334	45
33094374	Telecommunication	200904	45	13	2	1	22	12	8	2	1823	723	252	1306	340	48
33094374	Telecommunication	200905	21	7	1	0	17	10	5	1	1844	737	259	1318	347	49
33094374	Telecommunication	200906	29	10	4	2	16	10	6	2	1873	748	269	1334	352	51
33094374	Telecommunication	200907	25	3	1	1	12	8	3	1	1898	757	272	1353	357	53
33094374	Telecommunication	200908	27	2	0	0	15	7	1	0	1925	770	274	1367	362	53
33094374	Telecommunication	200909	19	0	0	0	11	8	0	0	1944	780	274	1383	369	53
33094374	Telecommunication	200910	29	6	0	0	13	7	4	0	1973	789	280	1401	372	54
33094374	Telecommunication	200911	15	4	0	0	13	6	4	0	1988	799	284	1408	375	54
33094374	Telecommunication	200912	14	6	0	0	12	7	6	0	2002	807	290	1415	378	54
33094374	Telecommunication	201001	28	6	0	0	21	14	6	0	2030	823	296	1435	387	55
33094374	Telecommunication	201002	14	6	0	0	12	6	4	0	2044	832	302	1443	390	55
33094374	Telecommunication	201003	37	14	0	0	25	13	9	0	2081	853	316	1466	399	59
33094374	Telecommunication	201004	72	7	0	0	28	14	6	0	2153	876	323	1484	408	60
33094374	Telecommunication	201005	33	7	0	0	23	16	7	0	2186	892	330	1501	417	61
33094374	Telecommunication	201006	26	9	0	0	21	11	6	0	2212	909	339	1516	424	61
33094374	Telecommunication	201007	15	3	0	0	11	9	1	0	2227	918	342	1529	431	62
33094374	Telecommunication	201008	18	6	0	0	15	7	4	0	2245	929	348	1538	434	63
33094374	Telecommunication	201009	35	7	1	0	16	7	3	1	2280	939	355	1553	435	64
33094374	Telecommunication	201010	18	6	0	0	15	9	5	0	2298	950	361	1565	440	67
33094374	Telecommunication	201011	12	3	0	0	10	5	3	0	2310	958	364	1570	443	67
33094374	Telecommunication	201012	16	7	0	0	13	6	5	0	2326	968	371	1578	446	67
33094374	Telecommunication	201101	37	6	0	0	18	11	4	0	2363	981	377	1593	452	67
33094374	Telecommunication	201102	54	21	0	0	27	16	12	0	2417	1005	398	1622	465	67
33094374	Telecommunication	201103	19	7	1	0	12	8	5	1	2436	1012	405	1635	469	68
33094374	Telecommunication	201104	9	3	0	0	7	3	2	0	2445	1017	408	1639	470	68
33094374	Telecommunication	201105	15	4	0	0	12	6	3	0	2460	1025	412	1646	472	68
33094374	Telecommunication	201106	36	23	5	2	25	10	16	2	2496	1047	435	1661	479	73
33094374	Telecommunication	201107	15	5	2	2	10	8	5	2	2511	1053	440	1674	484	77
33094374	Telecommunication	201108	12	1	0	0	8	6	1	0	2523	1057	441	1681	486	78
33094374	Telecommunication	201109	11	1	0	0	8	6	1	0	2534	1061	442	1689	488	78
33094374	Telecommunication	201110	20	3	0	0	11	7	2	0	2554	1071	445	1702	494	79
33094374	Telecommunication	201111	12	5	1	0	8	8	4	1	2566	1077	450	1714	500	84
33094374	Telecommunication	201112	13	3	0	0	12	6	3	0	2579	1085	453	1721	502	84
33094374	Telecommunication	201201	11	2	0	0	8	5	2	0	2590	1089	455	1727	503	84
33094374	Telecommunication	201202	23	9	0	0	16	9	7	0	2613	1101	464	1739	508	84
33094374	Telecommunication	201203	12	2	0	0	10	6	2	0	2625	1108	466	1745	511	84
33094374	Telecommunication	201204	16	4	0	0	12	10	4	0	2641	1116	470	1757	517	85
33094374	Telecommunication	201205	13	2	0	0	9	7	1	0	2654	1123	472	1768	522	85
33094374	Telecommunication	201206	10	1	0	0	8	4	1	0	2664	1129	473	1774	524	85
33094374	Telecommunication	201207	12	3	0	0	11	6	2	0	2676	1138	476	1781	528	85
33094374	Telecommunication	201208	7	2	0	0	4	3	1	0	2683	1142	478	1785	531	85
33094374	Telecommunication	201209	5	0	0	0	4	2	0	0	2688	1145	478	1787	532	85
33094374	Telecommunication	201210	22	3	0	0	12	5	2	0	2710	1155	481	1795	535	86
33094374	Telecommunication	201211	16	4	0	0	14	8	4	0	2726	1162	485	1804	536	86
33094374	Telecommunication	201212	20	6	1	0	11	5	5	1	2746	1169	491	1810	537	87
33094374	Telecommunication	201301	12	3	0	0	9	7	3	0	2758	1175	494	1820	541	88
33094374	Telecommunication	201302	5	1	0	0	4	3	1	0	2763	1177	495	1824	542	88
33094374	Telecommunication	201303	13	0	0	0	7	6	0	0	2776	1183	495	1836	547	88
33094374	Telecommunication	201304	9	2	0	0	9	5	2	0	2785	1189	497	1841	549	88
33094374	Telecommunication	201305	20	2	0	0	10	8	2	0	2805	1195	499	1859	553	88
33094374	Telecommunication	201306	10	4	0	0	10	3	4	0	2815	1204	503	1862	555	88
33094374	Telecommunication	201307	4	1	0	0	3	1	1	0	2819	1206	504	1863	555	88
33094374	Telecommunication	201308	6	2	0	0	3	2	1	0	2825	1208	506	1868	556	90
33094374	Telecommunication	201309	11	1	0	0	8	6	1	0	2836	1216	507	1877	562	90
33094374	Telecommunication	201310	6	1	0	0	5	2	1	0	2842	1221	508	1879	564	90
33094374	Telecommunication	201311	20	6	0	0	17	10	6	0	2862	1236	514	1892	572	90
33094374	Telecommunication	201312	8	3	0	0	8	4	3	0	2870	1243	517	1896	575	90
33094374	Telecommunication	201401	17	4	0	0	13	9	3	0	2887	1252	521	1909	580	90
33094374	Telecommunication	201402	6	2	0	0	6	3	2	0	2893	1256	523	1912	581	90
33094374	Telecommunication	201403	10	4	0	0	8	3	3	0	2903	1262	527	1916	582	90
33094374	Telecommunication	201404	12	4	2	1	7	4	3	2	2915	1267	531	1924	584	93
33094374	Telecommunication	201405	18	6	0	0	8	7	3	0	2933	1274	537	1941	590	99
33094374	Telecommunication	201406	6	2	0	0	6	3	2	0	2939	1279	539	1944	592	99
33094374	Telecommunication	201407	1	0	0	0	1	1	0	0	2940	1280	539	1945	593	99
33094374	Telecommunication	201408	10	4	0	0	7	3	1	0	2950	1286	543	1951	595	99
33094374	Telecommunication	201409	15	5	1	0	7	5	4	1	2965	1291	548	1959	598	102
33094374	Telecommunication	201410	7	2	0	0	6	5	2	0	2972	1296	550	1965	602	103
33094374	Telecommunication	201411	16	7	2	1	9	6	5	2	2988	1303	557	1973	606	104
33094374	Telecommunication	201412	8	2	0	0	5	4	2	0	2996	1307	559	1979	609	104
33094374	Telecommunication	201501	6	2	0	0	4	4	2	0	3002	1310	561	1985	612	106
33094374	Telecommunication	201502	10	2	0	0	8	4	2	0	3012	1315	563	1989	613	107
33094374	Telecommunication	201503	14	2	0	0	8	6	2	0	3026	1320	565	2001	616	108
33094374	Telecommunication	201504	6	1	0	0	4	4	1	0	3032	1324	566	2007	620	109
33094374	Telecommunication	201505	6	2	0	0	3	2	2	0	3038	1326	568	2009	621	109
33094374	Telecommunication	201506	15	5	0	0	13	10	5	0	3053	1336	573	2019	628	111
33094374	Telecommunication	201507	12	5	0	0	12	7	5	0	3065	1343	578	2026	630	112
33094374	Telecommunication	201508	4	0	0	0	3	1	0	0	3069	1346	578	2027	631	112
33094374	Telecommunication	201509	14	4	0	0	10	7	3	0	3083	1353	582	2036	635	113
33094374	Telecommunication	201510	6	1	0	0	6	2	1	0	3089	1359	583	2038	636	113
33094374	Telecommunication	201511	15	3	0	0	12	7	2	0	3104	1368	586	2047	640	113
33094374	Telecommunication	201512	13	2	0	0	7	5	2	0	3117	1373	588	2052	643	114
33094374	Telecommunication	201601	5	2	0	0	4	3	2	0	3122	1377	590	2055	646	114
33094374	Telecommunication	201602	9	2	0	0	8	5	2	0	3131	1384	592	2061	650	114
33094374	Telecommunication	201603	3	0	0	0	3	3	0	0	3134	1386	592	2064	652	114
33094374	Telecommunication	201604	9	3	0	0	8	4	3	0	3143	1392	595	2069	654	114
33094374	Telecommunication	201605	10	2	0	0	9	7	2	0	3153	1397	597	2077	656	115
33094374	Telecommunication	201606	9	3	0	0	9	5	3	0	3162	1404	600	2082	658	115
33094374	Telecommunication	201607	6	1	0	0	5	4	1	0	3168	1406	601	2087	659	115
33094374	Telecommunication	201608	15	5	0	0	11	7	5	0	3183	1415	606	2094	664	116
33094374	Telecommunication	201609	15	2	0	0	12	7	2	0	3198	1424	608	2104	667	116
33094374	Telecommunication	201610	2	1	0	0	2	1	1	0	3200	1425	609	2105	667	116
33094374	Telecommunication	201611	14	6	0	0	7	3	3	0	3214	1431	615	2111	669	116
33094374	Telecommunication	201612	6	2	0	0	6	4	2	0	3220	1435	617	2115	671	116
33094374	Telecommunication	201701	13	2	0	0	8	6	2	0	3233	1439	619	2126	673	117
33094374	Telecommunication	201702	7	4	0	0	7	5	4	0	3240	1442	623	2131	673	119
33094374	Telecommunication	201703	3	1	0	0	3	3	1	0	3243	1444	624	2134	675	120
33094374	Telecommunication	201704	5	2	0	0	5	4	2	0	3248	1447	626	2138	677	121
33094374	Telecommunication	201705	10	4	0	0	9	4	4	0	3258	1454	630	2142	679	121
33094374	Telecommunication	201706	7	1	0	0	5	2	1	0	3265	1458	631	2144	680	121
33094374	Telecommunication	201707	7	1	0	0	6	5	1	0	3272	1463	632	2150	684	121
33094374	Telecommunication	201708	5	2	0	0	5	4	2	0	3277	1466	634	2154	686	122
33094374	Telecommunication	201709	10	1	0	0	8	6	1	0	3287	1470	635	2161	687	123
33094374	Telecommunication	201710	4	1	0	0	4	4	1	0	3291	1473	636	2165	689	124
33094374	Telecommunication	201711	8	3	0	0	6	3	2	0	3299	1477	639	2169	689	125
33094374	Telecommunication	201712	2	1	0	0	2	1	1	0	3301	1479	640	2170	690	125
33094374	Telecommunication	201801	6	1	0	0	5	3	1	0	3307	1483	641	2174	692	125
33094374	Telecommunication	201802	6	3	0	0	6	4	3	0	3313	1488	644	2178	694	126
33094374	Telecommunication	201803	5	2	0	0	3	2	1	0	3318	1490	646	2181	695	126
33094374	Telecommunication	201804	42	16	0	0	6	4	3	0	3360	1495	662	2199	698	127
33094374	Telecommunication	201805	16	2	0	0	9	7	2	0	3376	1499	664	2212	700	127
33094374	Telecommunication	201806	7	1	0	0	7	7	1	0	3383	1504	665	2219	703	128
33094374	Telecommunication	201807	7	1	0	0	5	4	1	0	3390	1508	666	2225	706	128
46545	Telecommunications_network	200211	4	0	0	0	1	0	0	0	4	1	0	0	0	0
46545	Telecommunications_network	200311	1	0	0	0	1	1	0	0	5	2	0	1	1	0
46545	Telecommunications_network	200404	1	0	0	0	1	1	0	0	6	3	0	2	2	0
46545	Telecommunications_network	200406	3	0	0	0	1	0	0	0	9	4	0	2	2	0
46545	Telecommunications_network	200503	1	0	0	0	1	1	0	0	10	5	0	3	3	0
46545	Telecommunications_network	200506	1	0	0	0	1	1	0	0	11	6	0	4	4	0
46545	Telecommunications_network	200509	1	0	0	0	1	1	0	0	12	7	0	5	5	0
46545	Telecommunications_network	200510	1	0	0	0	1	1	0	0	13	8	0	6	6	0
46545	Telecommunications_network	200511	1	0	0	0	1	1	0	0	14	9	0	7	7	0
46545	Telecommunications_network	200604	2	0	0	0	2	2	0	0	16	11	0	9	9	0
46545	Telecommunications_network	200605	1	0	0	0	1	1	0	0	17	12	0	10	10	0
46545	Telecommunications_network	200608	3	0	0	0	2	2	0	0	20	14	0	13	12	0
46545	Telecommunications_network	200609	2	1	0	0	2	1	1	0	22	16	1	14	13	0
46545	Telecommunications_network	200611	4	1	0	0	3	1	1	0	26	18	2	15	13	0
46545	Telecommunications_network	200612	2	0	0	0	1	0	0	0	28	19	2	15	13	0
46545	Telecommunications_network	200704	3	0	0	0	2	2	0	0	31	21	2	18	15	0
46545	Telecommunications_network	200705	3	1	0	0	2	1	1	0	34	23	3	19	16	0
46545	Telecommunications_network	200708	2	0	0	0	2	1	0	0	36	25	3	20	17	0
46545	Telecommunications_network	200709	1	0	0	0	1	1	0	0	37	26	3	21	18	0
46545	Telecommunications_network	200710	1	0	0	0	1	1	0	0	38	27	3	22	19	0
46545	Telecommunications_network	200712	1	0	0	0	1	1	0	0	39	28	3	23	20	0
46545	Telecommunications_network	200801	1	0	0	0	1	1	0	0	40	29	3	24	21	0
46545	Telecommunications_network	200802	1	1	0	0	1	1	1	0	41	30	4	25	22	1
46545	Telecommunications_network	200808	1	0	0	0	1	1	0	0	42	31	4	26	23	1
46545	Telecommunications_network	200809	2	1	0	0	2	1	1	0	44	32	5	27	23	1
46545	Telecommunications_network	200812	4	0	0	0	4	4	0	0	48	35	5	31	26	1
46545	Telecommunications_network	200902	2	1	0	0	2	1	1	0	50	37	6	32	27	1
46545	Telecommunications_network	200903	1	0	0	0	1	1	0	0	51	38	6	33	28	1
46545	Telecommunications_network	200904	7	0	0	0	6	6	0	0	58	43	6	40	33	1
46545	Telecommunications_network	200905	5	0	0	0	4	4	0	0	63	45	6	45	35	1
46545	Telecommunications_network	200906	20	8	0	0	13	9	7	0	83	56	14	58	42	3
46545	Telecommunications_network	200907	5	1	0	0	3	2	1	0	88	59	15	61	44	3
46545	Telecommunications_network	200908	12	2	0	0	4	3	2	0	100	61	17	72	45	4
46545	Telecommunications_network	200909	5	1	0	0	4	2	1	0	105	64	18	74	46	4
46545	Telecommunications_network	200911	3	1	0	0	2	1	1	0	108	66	19	75	47	4
46545	Telecommunications_network	200912	3	1	0	0	3	2	1	0	111	68	20	77	48	4
46545	Telecommunications_network	201003	2	0	0	0	2	0	0	0	113	70	20	77	48	4
46545	Telecommunications_network	201004	23	2	0	0	8	4	2	0	136	77	22	95	51	4
46545	Telecommunications_network	201005	9	2	0	0	7	3	1	0	145	81	24	99	51	4
46545	Telecommunications_network	201006	1	0	0	0	1	1	0	0	146	82	24	100	52	4
46545	Telecommunications_network	201008	7	2	0	0	4	2	1	0	153	86	26	104	54	4
46545	Telecommunications_network	201009	4	1	0	0	4	2	1	0	157	90	27	106	56	5
46545	Telecommunications_network	201011	3	1	0	0	3	2	1	0	160	92	28	108	57	5
46545	Telecommunications_network	201012	1	0	0	0	1	1	0	0	161	93	28	109	58	5
46545	Telecommunications_network	201101	2	0	0	0	2	1	0	0	163	95	28	110	59	5
46545	Telecommunications_network	201102	6	0	0	0	3	2	0	0	169	97	28	112	60	5
46545	Telecommunications_network	201103	2	0	0	0	2	2	0	0	171	99	28	114	62	5
46545	Telecommunications_network	201105	2	0	0	0	2	2	0	0	173	101	28	116	64	5
46545	Telecommunications_network	201106	1	0	0	0	1	1	0	0	174	102	28	117	65	5
46545	Telecommunications_network	201107	4	1	0	0	3	1	1	0	178	105	29	118	66	5
46545	Telecommunications_network	201108	4	0	0	0	3	3	0	0	182	108	29	122	69	5
46545	Telecommunications_network	201110	9	1	0	0	7	5	1	0	191	114	30	128	73	5
46545	Telecommunications_network	201111	2	0	0	0	2	1	0	0	193	115	30	129	73	5
46545	Telecommunications_network	201112	6	3	1	0	4	3	3	1	199	117	33	133	74	6
46545	Telecommunications_network	201201	3	0	0	0	3	2	0	0	202	120	33	135	76	6
46545	Telecommunications_network	201202	4	1	0	0	4	2	1	0	206	122	34	137	76	6
46545	Telecommunications_network	201204	1	0	0	0	1	0	0	0	207	123	34	137	76	6
46545	Telecommunications_network	201205	6	0	0	0	3	2	0	0	213	126	34	142	78	6
46545	Telecommunications_network	201207	4	0	0	0	3	2	0	0	217	129	34	145	80	6
46545	Telecommunications_network	201208	3	1	0	0	3	2	1	0	220	132	35	147	82	6
46545	Telecommunications_network	201209	3	1	0	0	2	1	1	0	223	133	36	149	82	6
46545	Telecommunications_network	201210	1	0	0	0	1	1	0	0	224	133	36	150	82	6
46545	Telecommunications_network	201302	4	1	0	0	2	1	1	0	228	135	37	151	83	6
46545	Telecommunications_network	201304	4	1	0	0	4	3	1	0	232	139	38	154	86	6
46545	Telecommunications_network	201306	10	0	0	0	1	1	0	0	242	140	38	164	87	6
46545	Telecommunications_network	201308	1	0	0	0	1	1	0	0	243	141	38	165	88	6
46545	Telecommunications_network	201310	1	0	0	0	1	0	0	0	244	142	38	165	88	6
46545	Telecommunications_network	201312	11	1	0	0	2	1	1	0	255	143	39	166	88	6
46545	Telecommunications_network	201401	4	1	0	0	4	2	1	0	259	147	40	168	90	6
46545	Telecommunications_network	201407	2	0	0	0	2	0	0	0	261	149	40	168	90	6
46545	Telecommunications_network	201408	5	0	0	0	1	1	0	0	266	150	40	173	91	6
46545	Telecommunications_network	201409	5	0	0	0	2	1	0	0	271	152	40	175	92	6
46545	Telecommunications_network	201411	2	1	0	0	2	1	1	0	273	153	41	176	92	6
46545	Telecommunications_network	201412	1	0	0	0	1	1	0	0	274	154	41	177	93	6
46545	Telecommunications_network	201502	5	0	0	0	3	2	0	0	279	157	41	181	95	6
46545	Telecommunications_network	201504	1	0	0	0	1	1	0	0	280	158	41	182	96	6
46545	Telecommunications_network	201505	2	1	0	0	2	2	1	0	282	160	42	184	98	7
46545	Telecommunications_network	201508	1	0	0	0	1	1	0	0	283	161	42	185	99	7
46545	Telecommunications_network	201509	8	2	0	0	8	3	2	0	291	169	44	188	102	8
46545	Telecommunications_network	201512	3	0	0	0	3	1	0	0	294	172	44	189	103	8
46545	Telecommunications_network	201602	4	0	0	0	4	3	0	0	298	176	44	192	106	8
46545	Telecommunications_network	201603	3	0	0	0	1	0	0	0	301	177	44	192	106	8
46545	Telecommunications_network	201604	3	0	0	0	2	2	0	0	304	178	44	195	107	8
46545	Telecommunications_network	201608	5	1	0	0	3	2	1	0	309	181	45	199	108	9
46545	Telecommunications_network	201610	8	3	0	0	8	3	3	0	317	188	48	202	110	9
46545	Telecommunications_network	201611	1	0	0	0	1	0	0	0	318	189	48	202	110	9
46545	Telecommunications_network	201612	4	2	0	0	4	2	2	0	322	192	50	204	111	9
46545	Telecommunications_network	201701	4	2	0	0	4	3	2	0	326	195	52	207	112	10
46545	Telecommunications_network	201702	7	2	0	0	7	3	2	0	333	202	54	210	115	10
46545	Telecommunications_network	201704	7	0	0	0	5	3	0	0	340	207	54	213	118	10
46545	Telecommunications_network	201705	3	1	0	0	3	2	1	0	343	209	55	215	118	10
46545	Telecommunications_network	201706	5	0	0	0	4	2	0	0	348	213	55	218	120	10
46545	Telecommunications_network	201707	2	0	0	0	2	1	0	0	350	215	55	219	121	10
46545	Telecommunications_network	201708	4	1	0	0	4	2	1	0	354	219	56	221	122	11
46545	Telecommunications_network	201709	4	1	0	0	4	4	1	0	358	223	57	225	124	12
46545	Telecommunications_network	201710	3	0	0	0	2	1	0	0	361	225	57	226	125	12
46545	Telecommunications_network	201711	5	3	0	0	5	4	3	0	366	228	60	230	126	13
46545	Telecommunications_network	201712	3	1	0	0	3	2	1	0	369	231	61	232	127	14
46545	Telecommunications_network	201801	2	0	0	0	2	0	0	0	371	233	61	232	127	14
46545	Telecommunications_network	201802	2	0	0	0	2	2	0	0	373	235	61	234	128	14
46545	Telecommunications_network	201803	7	0	0	0	2	1	0	0	380	237	61	239	129	14
46545	Telecommunications_network	201805	2	1	0	0	2	1	1	0	382	238	62	240	129	14
46545	Telecommunications_network	201806	10	4	0	0	10	7	4	0	392	247	66	247	134	15
46545	Telecommunications_network	201807	1	1	0	0	1	0	1	0	393	248	67	247	134	16
242669	Traffic_shaping	200403	23	0	0	0	5	4	0	0	23	5	0	21	4	0
242669	Traffic_shaping	200406	1	0	0	0	1	1	0	0	24	5	0	22	4	0
242669	Traffic_shaping	200408	1	0	0	0	1	1	0	0	25	6	0	23	5	0
242669	Traffic_shaping	200409	1	0	0	0	1	0	0	0	26	7	0	23	5	0
242669	Traffic_shaping	200410	1	0	0	0	1	0	0	0	27	8	0	23	5	0
242669	Traffic_shaping	200411	1	0	0	0	1	1	0	0	28	9	0	24	6	0
242669	Traffic_shaping	200412	2	0	0	0	2	2	0	0	30	11	0	26	8	0
242669	Traffic_shaping	200501	1	0	0	0	1	1	0	0	31	12	0	27	9	0
242669	Traffic_shaping	200503	1	0	0	0	1	0	0	0	32	13	0	27	9	0
242669	Traffic_shaping	200504	4	0	0	0	2	2	0	0	36	15	0	31	11	0
242669	Traffic_shaping	200505	1	0	0	0	1	0	0	0	37	16	0	31	11	0
242669	Traffic_shaping	200506	6	0	0	0	3	2	0	0	43	19	0	34	13	0
242669	Traffic_shaping	200508	2	0	0	0	1	1	0	0	45	20	0	36	14	0
242669	Traffic_shaping	200509	6	0	0	0	5	2	0	0	51	24	0	38	15	0
242669	Traffic_shaping	200510	1	0	0	0	1	0	0	0	52	25	0	38	15	0
242669	Traffic_shaping	200511	2	0	0	0	1	1	0	0	54	26	0	40	16	0
242669	Traffic_shaping	200512	3	1	0	0	3	1	1	0	57	29	1	41	17	0
242669	Traffic_shaping	200601	2	0	0	0	2	1	0	0	59	31	1	42	18	0
242669	Traffic_shaping	200602	1	0	0	0	1	0	0	0	60	32	1	42	18	0
242669	Traffic_shaping	200603	2	0	0	0	2	2	0	0	62	34	1	44	20	0
242669	Traffic_shaping	200604	3	0	0	0	3	0	0	0	65	37	1	44	20	0
242669	Traffic_shaping	200605	4	0	0	0	4	4	0	0	69	41	1	48	24	0
242669	Traffic_shaping	200606	5	1	0	0	5	4	1	0	74	46	2	52	28	1
242669	Traffic_shaping	200607	1	0	0	0	1	1	0	0	75	46	2	53	28	1
242669	Traffic_shaping	200608	17	2	0	0	10	5	2	0	92	55	4	59	32	2
242669	Traffic_shaping	200609	4	1	0	0	3	2	1	0	96	56	5	62	32	3
242669	Traffic_shaping	200610	3	0	0	0	3	2	0	0	99	59	5	64	34	3
242669	Traffic_shaping	200611	5	0	0	0	4	3	0	0	104	63	5	68	37	3
242669	Traffic_shaping	200612	7	0	0	0	4	1	0	0	111	67	5	69	38	3
242669	Traffic_shaping	200701	10	0	0	0	7	5	0	0	121	74	5	75	43	3
242669	Traffic_shaping	200702	24	2	0	0	12	8	2	0	145	84	7	95	49	4
242669	Traffic_shaping	200703	22	3	0	0	14	7	2	0	167	95	10	105	53	4
242669	Traffic_shaping	200704	12	0	0	0	10	1	0	0	179	105	10	106	54	4
242669	Traffic_shaping	200705	21	1	0	0	15	6	1	0	200	119	11	116	59	4
242669	Traffic_shaping	200706	15	2	0	0	14	3	2	0	215	133	13	119	62	4
242669	Traffic_shaping	200707	35	0	0	0	18	7	0	0	250	150	13	137	68	4
242669	Traffic_shaping	200708	6	0	0	0	6	3	0	0	256	156	13	140	71	4
242669	Traffic_shaping	200709	10	2	0	0	8	2	1	0	266	163	15	143	72	4
242669	Traffic_shaping	200710	10	1	0	0	10	3	1	0	276	173	16	146	75	4
242669	Traffic_shaping	200711	30	5	0	0	19	6	4	0	306	191	21	157	80	6
242669	Traffic_shaping	200712	21	3	2	1	14	6	2	2	327	204	24	169	85	9
242669	Traffic_shaping	200801	49	0	0	0	11	5	0	0	376	214	24	211	89	9
242669	Traffic_shaping	200802	28	2	0	0	6	4	2	0	404	218	26	237	91	11
242669	Traffic_shaping	200803	3	0	0	0	3	2	0	0	407	221	26	239	93	11
242669	Traffic_shaping	200804	17	1	0	0	10	7	1	0	424	231	27	250	100	12
242669	Traffic_shaping	200805	6	1	0	0	3	1	1	0	430	233	28	251	100	12
242669	Traffic_shaping	200806	5	2	0	0	4	1	1	0	435	236	30	253	100	12
242669	Traffic_shaping	200807	11	0	0	0	5	2	0	0	446	240	30	259	101	12
242669	Traffic_shaping	200808	3	0	0	0	1	1	0	0	449	241	30	262	102	12
242669	Traffic_shaping	200809	12	1	0	0	6	2	1	0	461	245	31	270	103	12
242669	Traffic_shaping	200810	3	1	0	0	3	2	1	0	464	248	32	272	105	12
242669	Traffic_shaping	200811	1	0	0	0	1	0	0	0	465	249	32	272	105	12
242669	Traffic_shaping	200812	10	1	0	0	8	5	1	0	475	256	33	279	109	13
242669	Traffic_shaping	200901	4	0	0	0	4	2	0	0	479	260	33	281	111	13
242669	Traffic_shaping	200902	5	0	0	0	5	1	0	0	484	265	33	282	112	13
242669	Traffic_shaping	200904	4	1	0	0	4	2	1	0	488	267	34	284	112	13
242669	Traffic_shaping	200905	5	1	0	0	3	1	1	0	493	270	35	286	113	13
242669	Traffic_shaping	200906	8	0	0	0	5	2	0	0	501	275	35	288	115	13
242669	Traffic_shaping	200907	1	0	0	0	1	0	0	0	502	276	35	288	115	13
242669	Traffic_shaping	200908	3	1	0	0	3	2	1	0	505	279	36	290	117	14
242669	Traffic_shaping	200909	4	0	0	0	4	3	0	0	509	281	36	293	118	14
242669	Traffic_shaping	200910	1	0	0	0	1	0	0	0	510	282	36	293	118	14
242669	Traffic_shaping	200911	4	0	0	0	4	3	0	0	514	286	36	296	121	14
242669	Traffic_shaping	200912	9	0	0	0	3	2	0	0	523	289	36	299	123	14
242669	Traffic_shaping	201001	8	1	0	0	6	4	1	0	531	294	37	304	126	15
242669	Traffic_shaping	201002	1	0	0	0	1	1	0	0	532	295	37	305	127	15
242669	Traffic_shaping	201003	2	1	0	0	2	1	1	0	534	296	38	306	127	15
242669	Traffic_shaping	201004	4	0	0	0	3	0	0	0	538	299	38	306	127	15
242669	Traffic_shaping	201005	3	0	0	0	3	2	0	0	541	301	38	308	128	15
242669	Traffic_shaping	201006	3	1	0	0	3	1	1	0	544	304	39	309	129	15
242669	Traffic_shaping	201008	5	0	0	0	3	3	0	0	549	307	39	314	132	15
242669	Traffic_shaping	201009	5	1	0	0	3	2	1	0	554	309	40	318	133	15
242669	Traffic_shaping	201010	2	0	0	0	2	2	0	0	556	311	40	320	135	15
242669	Traffic_shaping	201011	3	0	0	0	1	1	0	0	559	312	40	323	136	15
242669	Traffic_shaping	201012	4	0	0	0	4	1	0	0	563	316	40	324	137	15
242669	Traffic_shaping	201101	2	0	0	0	2	1	0	0	565	318	40	325	138	15
242669	Traffic_shaping	201102	4	0	0	0	3	1	0	0	569	321	40	326	139	15
242669	Traffic_shaping	201103	2	0	0	0	2	0	0	0	571	323	40	326	139	15
242669	Traffic_shaping	201104	3	0	0	0	3	1	0	0	574	326	40	327	140	15
242669	Traffic_shaping	201105	2	0	0	0	1	1	0	0	576	327	40	329	141	15
242669	Traffic_shaping	201108	2	1	0	0	2	2	1	0	578	329	41	331	143	16
242669	Traffic_shaping	201110	1	0	0	0	1	0	0	0	579	330	41	331	143	16
242669	Traffic_shaping	201111	2	0	0	0	2	2	0	0	581	332	41	333	145	16
242669	Traffic_shaping	201112	2	0	0	0	2	2	0	0	583	334	41	335	147	16
242669	Traffic_shaping	201201	13	1	0	0	5	4	1	0	596	337	42	347	149	16
242669	Traffic_shaping	201202	12	0	0	0	2	2	0	0	608	338	42	359	150	16
242669	Traffic_shaping	201203	2	0	0	0	2	2	0	0	610	340	42	361	152	16
242669	Traffic_shaping	201205	5	0	0	0	4	2	0	0	615	343	42	364	153	16
242669	Traffic_shaping	201206	3	1	0	0	2	1	1	0	618	344	43	365	153	16
242669	Traffic_shaping	201207	2	0	0	0	1	0	0	0	620	345	43	365	153	16
242669	Traffic_shaping	201209	1	0	0	0	1	1	0	0	621	345	43	366	153	16
242669	Traffic_shaping	201211	2	0	0	0	2	2	0	0	623	347	43	368	155	16
242669	Traffic_shaping	201212	1	0	0	0	1	1	0	0	624	348	43	369	156	16
242669	Traffic_shaping	201301	5	0	0	0	3	3	0	0	629	350	43	374	158	16
242669	Traffic_shaping	201302	1	0	0	0	1	1	0	0	630	351	43	375	159	16
242669	Traffic_shaping	201310	2	0	0	0	2	1	0	0	632	353	43	376	160	16
242669	Traffic_shaping	201312	2	1	0	0	2	0	1	0	634	355	44	376	160	16
242669	Traffic_shaping	201401	2	1	0	0	2	1	1	0	636	356	45	377	160	16
242669	Traffic_shaping	201403	3	0	0	0	2	1	0	0	639	358	45	378	161	16
242669	Traffic_shaping	201404	4	0	0	0	2	2	0	0	643	359	45	382	162	16
242669	Traffic_shaping	201405	2	0	0	0	1	1	0	0	645	360	45	384	163	16
242669	Traffic_shaping	201409	1	0	0	0	1	1	0	0	646	361	45	385	164	16
242669	Traffic_shaping	201410	1	0	0	0	1	0	0	0	647	362	45	385	164	16
242669	Traffic_shaping	201501	7	0	0	0	3	3	0	0	654	364	45	392	166	16
242669	Traffic_shaping	201502	9	0	0	0	2	1	0	0	663	366	45	398	167	16
242669	Traffic_shaping	201504	3	0	0	0	2	1	0	0	666	368	45	399	168	16
242669	Traffic_shaping	201505	3	0	0	0	2	1	0	0	669	369	45	400	168	16
242669	Traffic_shaping	201506	3	1	0	0	3	2	1	0	672	370	46	402	168	16
242669	Traffic_shaping	201509	1	0	0	0	1	1	0	0	673	370	46	403	168	16
242669	Traffic_shaping	201511	1	0	0	0	1	1	0	0	674	371	46	404	169	16
242669	Traffic_shaping	201602	4	0	0	0	3	2	0	0	678	373	46	406	170	16
242669	Traffic_shaping	201603	2	0	0	0	2	2	0	0	680	375	46	408	172	16
242669	Traffic_shaping	201605	2	1	0	0	2	1	1	0	682	377	47	409	173	16
242669	Traffic_shaping	201606	6	0	0	0	3	3	0	0	688	378	47	415	174	16
242669	Traffic_shaping	201611	3	0	0	0	3	2	0	0	691	381	47	417	176	16
242669	Traffic_shaping	201703	2	0	0	0	2	2	0	0	693	382	47	419	177	16
242669	Traffic_shaping	201704	4	0	0	0	4	4	0	0	697	384	47	423	179	16
242669	Traffic_shaping	201705	1	0	0	0	1	1	0	0	698	385	47	424	180	16
242669	Traffic_shaping	201707	1	0	0	0	1	1	0	0	699	385	47	425	180	16
242669	Traffic_shaping	201711	4	0	0	0	4	3	0	0	703	387	47	428	181	16
242669	Traffic_shaping	201712	3	0	0	0	1	0	0	0	706	388	47	428	181	16
242669	Traffic_shaping	201801	5	0	0	0	4	1	0	0	711	391	47	429	181	16
242669	Traffic_shaping	201804	3	0	0	0	3	3	0	0	714	392	47	432	182	16
242669	Traffic_shaping	201805	2	0	0	0	2	2	0	0	716	393	47	434	183	16
242669	Traffic_shaping	201806	2	1	0	0	2	2	1	0	718	394	48	436	184	17
242669	Traffic_shaping	201807	2	1	1	0	2	1	1	1	720	395	49	437	184	18
30538	Transmission_Control_Protocol	200111	1	0	0	0	1	1	0	0	1	1	0	1	1	0
30538	Transmission_Control_Protocol	200202	1	0	0	0	1	1	0	0	2	2	0	2	2	0
30538	Transmission_Control_Protocol	200203	2	0	0	0	2	2	0	0	4	4	0	4	4	0
30538	Transmission_Control_Protocol	200204	1	0	0	0	1	1	0	0	5	5	0	5	5	0
30538	Transmission_Control_Protocol	200207	3	0	0	0	3	1	0	0	8	8	0	6	6	0
30538	Transmission_Control_Protocol	200209	1	0	0	0	1	1	0	0	9	9	0	7	7	0
30538	Transmission_Control_Protocol	200301	1	0	0	0	1	1	0	0	10	10	0	8	8	0
30538	Transmission_Control_Protocol	200302	3	0	0	0	2	1	0	0	13	12	0	9	9	0
30538	Transmission_Control_Protocol	200303	1	0	0	0	1	1	0	0	14	13	0	10	10	0
30538	Transmission_Control_Protocol	200305	1	0	0	0	1	1	0	0	15	14	0	11	11	0
30538	Transmission_Control_Protocol	200306	10	0	0	0	3	2	0	0	25	17	0	13	13	0
30538	Transmission_Control_Protocol	200308	5	0	0	0	3	1	0	0	30	20	0	16	14	0
30538	Transmission_Control_Protocol	200312	9	0	0	0	7	5	0	0	39	25	0	22	17	0
30538	Transmission_Control_Protocol	200401	2	0	0	0	2	2	0	0	41	27	0	24	19	0
30538	Transmission_Control_Protocol	200402	9	0	0	0	4	4	0	0	50	29	0	33	21	0
30538	Transmission_Control_Protocol	200403	6	0	0	0	5	4	0	0	56	34	0	38	25	0
30538	Transmission_Control_Protocol	200404	4	0	0	0	4	3	0	0	60	38	0	41	28	0
30538	Transmission_Control_Protocol	200405	2	0	0	0	2	1	0	0	62	40	0	42	29	0
30538	Transmission_Control_Protocol	200406	4	0	0	0	3	0	0	0	66	43	0	42	29	0
30538	Transmission_Control_Protocol	200407	12	1	0	0	10	7	1	0	78	53	1	51	35	0
30538	Transmission_Control_Protocol	200408	7	0	0	0	5	2	0	0	85	58	1	53	37	0
30538	Transmission_Control_Protocol	200409	4	0	0	0	4	3	0	0	89	62	1	56	40	0
30538	Transmission_Control_Protocol	200410	8	0	0	0	7	3	0	0	97	69	1	59	43	0
30538	Transmission_Control_Protocol	200411	7	1	0	0	6	4	1	0	104	74	2	64	46	0
30538	Transmission_Control_Protocol	200412	20	2	0	0	14	11	2	0	124	86	4	81	55	0
30538	Transmission_Control_Protocol	200501	3	0	0	0	2	0	0	0	127	88	4	81	55	0
30538	Transmission_Control_Protocol	200502	10	1	0	0	8	4	1	0	137	93	5	86	56	0
30538	Transmission_Control_Protocol	200503	10	1	0	0	8	2	1	0	147	101	6	88	58	0
30538	Transmission_Control_Protocol	200504	9	2	0	0	8	4	2	0	156	109	8	92	62	0
30538	Transmission_Control_Protocol	200505	17	3	0	0	15	9	3	0	173	123	11	102	70	0
30538	Transmission_Control_Protocol	200506	13	1	0	0	8	3	1	0	186	130	12	106	72	0
30538	Transmission_Control_Protocol	200507	21	0	0	0	12	6	0	0	207	142	12	119	78	0
30538	Transmission_Control_Protocol	200508	14	3	0	0	11	4	3	0	221	150	15	123	79	0
30538	Transmission_Control_Protocol	200509	24	1	0	0	15	6	1	0	245	162	16	131	82	0
30538	Transmission_Control_Protocol	200510	18	0	0	0	16	7	0	0	263	176	16	139	87	0
30538	Transmission_Control_Protocol	200511	21	3	0	0	19	11	3	0	284	194	19	152	97	0
30538	Transmission_Control_Protocol	200512	31	6	0	0	23	9	6	0	315	215	25	163	104	0
30538	Transmission_Control_Protocol	200601	30	5	0	0	25	7	5	0	345	239	30	172	110	0
30538	Transmission_Control_Protocol	200602	27	3	0	0	22	17	3	0	372	254	33	191	121	1
30538	Transmission_Control_Protocol	200603	36	2	0	0	20	10	2	0	408	271	35	215	128	1
30538	Transmission_Control_Protocol	200604	46	9	0	0	21	10	2	0	454	288	44	236	134	1
30538	Transmission_Control_Protocol	200605	17	3	0	0	13	7	2	0	471	300	47	246	140	1
30538	Transmission_Control_Protocol	200606	45	5	0	0	25	13	4	0	516	322	52	275	150	1
30538	Transmission_Control_Protocol	200607	23	3	0	0	19	12	3	0	539	338	55	288	159	2
30538	Transmission_Control_Protocol	200608	15	1	0	0	11	7	1	0	554	349	56	299	166	2
30538	Transmission_Control_Protocol	200609	17	5	0	0	12	6	4	0	571	359	61	306	170	2
30538	Transmission_Control_Protocol	200610	9	1	0	0	8	4	1	0	580	366	62	310	173	3
30538	Transmission_Control_Protocol	200611	32	8	0	0	20	11	4	0	612	382	70	330	180	3
30538	Transmission_Control_Protocol	200612	53	13	1	0	31	15	9	1	665	410	83	359	192	4
30538	Transmission_Control_Protocol	200701	34	0	0	0	18	8	0	0	699	426	83	377	198	4
30538	Transmission_Control_Protocol	200702	26	4	0	0	20	11	2	0	725	445	87	392	208	4
30538	Transmission_Control_Protocol	200703	21	1	0	0	13	9	1	0	746	458	88	402	217	4
30538	Transmission_Control_Protocol	200704	41	8	0	0	22	12	6	0	787	477	96	418	226	4
30538	Transmission_Control_Protocol	200705	26	6	0	0	20	7	4	0	813	495	102	427	231	4
30538	Transmission_Control_Protocol	200706	40	7	0	0	29	15	7	0	853	519	109	445	241	4
30538	Transmission_Control_Protocol	200707	29	7	0	0	23	11	6	0	882	539	116	458	249	4
30538	Transmission_Control_Protocol	200708	64	4	0	0	28	12	4	0	946	564	120	479	258	5
30538	Transmission_Control_Protocol	200709	25	1	0	0	16	7	1	0	971	578	121	488	263	5
30538	Transmission_Control_Protocol	200710	37	1	0	0	23	13	1	0	1008	598	122	513	273	5
30538	Transmission_Control_Protocol	200711	37	11	2	1	27	12	7	2	1045	622	133	533	282	6
30538	Transmission_Control_Protocol	200712	19	2	0	0	14	7	2	0	1064	634	135	545	287	6
30538	Transmission_Control_Protocol	200801	61	1	0	0	20	10	1	0	1125	651	136	596	294	6
30538	Transmission_Control_Protocol	200802	28	4	0	0	24	17	4	0	1153	670	140	616	306	6
30538	Transmission_Control_Protocol	200803	31	4	0	0	23	9	4	0	1184	692	144	628	314	6
30538	Transmission_Control_Protocol	200804	24	3	0	0	19	5	2	0	1208	706	147	634	314	6
30538	Transmission_Control_Protocol	200805	23	6	1	0	20	9	6	1	1231	721	153	645	318	9
30538	Transmission_Control_Protocol	200806	13	5	0	0	10	6	4	0	1244	730	158	653	323	11
30538	Transmission_Control_Protocol	200807	14	3	0	0	10	5	3	0	1258	738	161	658	326	11
30538	Transmission_Control_Protocol	200808	14	2	0	0	13	7	2	0	1272	749	163	665	331	11
30538	Transmission_Control_Protocol	200809	41	8	0	0	26	11	7	0	1313	772	171	682	339	11
30538	Transmission_Control_Protocol	200810	16	3	0	0	13	8	3	0	1329	783	174	692	345	11
30538	Transmission_Control_Protocol	200811	25	7	0	0	19	9	6	0	1354	798	181	704	351	12
30538	Transmission_Control_Protocol	200812	20	4	0	0	17	9	4	0	1374	813	185	714	358	12
30538	Transmission_Control_Protocol	200901	24	5	0	0	18	7	4	0	1398	828	190	723	362	12
30538	Transmission_Control_Protocol	200902	20	4	0	0	16	8	4	0	1418	842	194	734	368	13
30538	Transmission_Control_Protocol	200903	26	5	0	0	18	8	4	0	1444	855	199	747	371	13
30538	Transmission_Control_Protocol	200904	18	5	0	0	12	6	4	0	1462	864	204	758	375	13
30538	Transmission_Control_Protocol	200905	30	5	0	0	17	9	4	0	1492	877	209	777	380	13
30538	Transmission_Control_Protocol	200906	21	6	0	0	17	7	6	0	1513	893	215	785	386	13
30538	Transmission_Control_Protocol	200907	20	3	0	0	12	6	3	0	1533	903	218	796	390	14
30538	Transmission_Control_Protocol	200908	15	2	0	0	7	4	2	0	1548	908	220	802	392	15
30538	Transmission_Control_Protocol	200909	16	1	0	0	11	6	1	0	1564	916	221	812	395	15
30538	Transmission_Control_Protocol	200910	47	9	0	0	23	11	9	0	1611	936	230	834	404	16
30538	Transmission_Control_Protocol	200911	19	5	0	0	12	6	3	0	1630	944	235	845	406	16
30538	Transmission_Control_Protocol	200912	17	5	0	0	14	7	4	0	1647	956	240	853	411	17
30538	Transmission_Control_Protocol	201001	16	4	0	0	14	6	4	0	1663	967	244	859	415	18
30538	Transmission_Control_Protocol	201002	33	6	0	0	22	12	5	0	1696	982	250	875	420	18
30538	Transmission_Control_Protocol	201003	30	4	0	0	17	5	3	0	1726	997	254	890	423	18
30538	Transmission_Control_Protocol	201004	34	7	0	0	22	7	5	0	1760	1018	261	900	429	19
30538	Transmission_Control_Protocol	201005	33	10	0	0	25	9	7	0	1793	1041	271	912	436	19
30538	Transmission_Control_Protocol	201006	18	4	0	0	14	8	4	0	1811	1053	275	921	442	20
30538	Transmission_Control_Protocol	201007	14	4	0	0	12	7	3	0	1825	1063	279	929	447	20
30538	Transmission_Control_Protocol	201008	12	2	0	0	10	4	2	0	1837	1071	281	934	449	20
30538	Transmission_Control_Protocol	201009	31	9	2	1	21	11	6	2	1868	1089	290	951	457	22
30538	Transmission_Control_Protocol	201010	30	7	0	0	19	9	6	0	1898	1104	297	962	463	22
30538	Transmission_Control_Protocol	201011	28	5	0	0	19	8	4	0	1926	1120	302	976	468	22
30538	Transmission_Control_Protocol	201012	19	6	0	0	18	9	6	0	1945	1135	308	985	474	23
30538	Transmission_Control_Protocol	201101	27	4	0	0	18	9	3	0	1972	1151	312	1002	481	23
30538	Transmission_Control_Protocol	201102	16	3	0	0	15	8	2	0	1988	1163	315	1011	486	23
30538	Transmission_Control_Protocol	201103	46	12	0	0	23	15	7	0	2034	1185	327	1032	500	24
30538	Transmission_Control_Protocol	201104	22	2	0	0	12	6	2	0	2056	1193	329	1047	502	24
30538	Transmission_Control_Protocol	201105	19	3	0	0	16	5	3	0	2075	1206	332	1052	504	24
30538	Transmission_Control_Protocol	201106	14	2	0	0	12	6	2	0	2089	1216	334	1059	508	24
30538	Transmission_Control_Protocol	201107	27	3	0	0	15	7	2	0	2116	1229	337	1075	513	24
30538	Transmission_Control_Protocol	201108	30	4	1	0	19	11	3	1	2146	1244	341	1094	520	25
30538	Transmission_Control_Protocol	201109	11	1	0	0	8	3	1	0	2157	1251	342	1098	522	25
30538	Transmission_Control_Protocol	201110	2	0	0	0	2	0	0	0	2159	1253	342	1098	522	25
30538	Transmission_Control_Protocol	201111	16	0	0	0	10	7	0	0	2175	1262	342	1110	528	25
30538	Transmission_Control_Protocol	201201	33	5	0	0	20	8	5	0	2208	1281	347	1126	535	26
30538	Transmission_Control_Protocol	201202	19	6	0	0	14	6	5	0	2227	1291	353	1133	537	27
30538	Transmission_Control_Protocol	201203	23	5	0	0	19	8	4	0	2250	1306	358	1142	542	28
30538	Transmission_Control_Protocol	201204	7	0	0	0	6	3	0	0	2257	1312	358	1146	545	28
30538	Transmission_Control_Protocol	201205	9	1	0	0	9	5	1	0	2266	1318	359	1151	547	28
30538	Transmission_Control_Protocol	201206	9	1	0	0	7	4	1	0	2275	1324	360	1156	550	28
30538	Transmission_Control_Protocol	201207	12	1	0	0	10	8	1	0	2287	1333	361	1166	557	28
30538	Transmission_Control_Protocol	201208	12	2	0	0	11	8	2	0	2299	1342	363	1175	563	29
30538	Transmission_Control_Protocol	201209	20	5	0	0	15	9	5	0	2319	1352	368	1189	567	30
30538	Transmission_Control_Protocol	201210	11	2	0	0	10	6	2	0	2330	1360	370	1196	570	30
30538	Transmission_Control_Protocol	201211	9	3	0	0	7	3	2	0	2339	1366	373	1200	572	30
30538	Transmission_Control_Protocol	201212	7	0	0	0	4	3	0	0	2346	1368	373	1205	573	30
30538	Transmission_Control_Protocol	201301	14	4	0	0	13	9	4	0	2360	1378	377	1215	579	30
30538	Transmission_Control_Protocol	201302	9	1	0	0	7	6	1	0	2369	1382	378	1223	581	31
30538	Transmission_Control_Protocol	201303	16	4	0	0	12	7	4	0	2385	1390	382	1230	584	32
30538	Transmission_Control_Protocol	201304	26	6	0	0	17	8	5	0	2411	1401	388	1241	587	32
30538	Transmission_Control_Protocol	201305	17	3	0	0	15	7	3	0	2428	1412	391	1249	590	32
30538	Transmission_Control_Protocol	201306	14	1	0	0	9	3	1	0	2442	1420	392	1255	591	32
30538	Transmission_Control_Protocol	201307	16	2	0	0	11	8	2	0	2458	1428	394	1268	596	32
30538	Transmission_Control_Protocol	201308	7	0	0	0	6	5	0	0	2465	1434	394	1274	601	32
30538	Transmission_Control_Protocol	201309	16	1	0	0	12	9	1	0	2481	1442	395	1286	606	32
30538	Transmission_Control_Protocol	201310	8	4	0	0	8	5	4	0	2489	1448	399	1291	609	32
30538	Transmission_Control_Protocol	201311	13	1	0	0	8	4	1	0	2502	1455	400	1295	612	32
30538	Transmission_Control_Protocol	201312	12	5	0	0	11	6	4	0	2514	1464	405	1302	616	33
30538	Transmission_Control_Protocol	201401	12	4	1	0	8	2	3	1	2526	1471	409	1305	617	34
30538	Transmission_Control_Protocol	201402	16	4	0	0	15	9	4	0	2542	1484	413	1314	624	35
30538	Transmission_Control_Protocol	201403	23	7	0	0	15	8	5	0	2565	1497	420	1328	630	37
30538	Transmission_Control_Protocol	201404	8	2	0	0	6	2	2	0	2573	1501	422	1332	630	37
30538	Transmission_Control_Protocol	201405	5	1	0	0	3	2	1	0	2578	1503	423	1335	631	37
30538	Transmission_Control_Protocol	201406	3	0	0	0	3	0	0	0	2581	1506	423	1335	631	37
30538	Transmission_Control_Protocol	201407	6	1	0	0	6	3	1	0	2587	1510	424	1338	632	37
30538	Transmission_Control_Protocol	201408	7	3	0	0	6	4	2	0	2594	1513	427	1343	633	37
30538	Transmission_Control_Protocol	201409	14	5	0	0	10	6	5	0	2608	1519	432	1349	635	37
30538	Transmission_Control_Protocol	201410	1	0	0	0	1	1	0	0	2609	1520	432	1350	636	37
30538	Transmission_Control_Protocol	201411	6	2	0	0	5	3	2	0	2615	1524	434	1354	638	37
30538	Transmission_Control_Protocol	201412	8	2	0	0	6	5	2	0	2623	1528	436	1361	640	38
30538	Transmission_Control_Protocol	201501	9	3	0	0	7	4	2	0	2632	1534	439	1366	643	38
30538	Transmission_Control_Protocol	201502	5	2	0	0	5	3	2	0	2637	1537	441	1369	644	39
30538	Transmission_Control_Protocol	201503	26	2	0	0	13	10	2	0	2663	1546	443	1392	650	40
30538	Transmission_Control_Protocol	201504	12	4	0	0	7	5	4	0	2675	1552	447	1397	654	40
30538	Transmission_Control_Protocol	201505	11	4	0	0	9	7	3	0	2686	1559	451	1405	658	42
30538	Transmission_Control_Protocol	201506	6	2	0	0	6	4	2	0	2692	1563	453	1409	660	42
30538	Transmission_Control_Protocol	201507	7	2	0	0	6	3	2	0	2699	1568	455	1412	662	42
30538	Transmission_Control_Protocol	201508	1	0	0	0	1	0	0	0	2700	1569	455	1412	662	42
30538	Transmission_Control_Protocol	201509	4	1	0	0	4	3	1	0	2704	1571	456	1415	663	42
30538	Transmission_Control_Protocol	201510	11	3	0	0	9	4	3	0	2715	1578	459	1419	665	42
30538	Transmission_Control_Protocol	201511	6	0	0	0	5	5	0	0	2721	1582	459	1425	669	42
30538	Transmission_Control_Protocol	201512	13	3	0	0	10	6	2	0	2734	1589	462	1432	671	43
30538	Transmission_Control_Protocol	201601	4	1	0	0	4	3	1	0	2738	1592	463	1435	673	43
30538	Transmission_Control_Protocol	201602	11	2	0	0	8	5	1	0	2749	1599	465	1441	677	44
30538	Transmission_Control_Protocol	201603	17	6	0	0	13	9	4	0	2766	1609	471	1452	683	45
30538	Transmission_Control_Protocol	201604	7	2	0	0	6	4	2	0	2773	1613	473	1457	685	46
30538	Transmission_Control_Protocol	201605	13	2	0	0	10	6	2	0	2786	1619	475	1466	687	46
30538	Transmission_Control_Protocol	201606	10	3	0	0	8	7	2	0	2796	1626	478	1475	691	48
30538	Transmission_Control_Protocol	201607	2	0	0	0	2	2	0	0	2798	1626	478	1477	691	48
30538	Transmission_Control_Protocol	201608	7	1	0	0	6	4	1	0	2805	1631	479	1481	694	48
30538	Transmission_Control_Protocol	201609	8	2	0	0	7	5	2	0	2813	1635	481	1486	696	49
30538	Transmission_Control_Protocol	201610	14	1	0	0	9	4	1	0	2827	1643	482	1494	699	49
30538	Transmission_Control_Protocol	201611	17	4	0	0	12	6	3	0	2844	1653	486	1502	703	50
30538	Transmission_Control_Protocol	201612	2	0	0	0	2	2	0	0	2846	1654	486	1504	704	50
30538	Transmission_Control_Protocol	201701	4	1	0	0	4	3	1	0	2850	1656	487	1507	705	50
30538	Transmission_Control_Protocol	201702	22	7	1	0	17	10	7	1	2872	1667	494	1519	707	51
30538	Transmission_Control_Protocol	201703	8	2	0	0	6	3	1	0	2880	1672	496	1523	709	52
30538	Transmission_Control_Protocol	201704	5	1	0	0	5	4	1	0	2885	1676	497	1527	712	52
30538	Transmission_Control_Protocol	201705	6	2	0	0	6	4	2	0	2891	1681	499	1531	714	53
30538	Transmission_Control_Protocol	201706	3	1	0	0	3	2	1	0	2894	1682	500	1533	714	53
30538	Transmission_Control_Protocol	201707	2	0	0	0	2	1	0	0	2896	1684	500	1534	715	53
30538	Transmission_Control_Protocol	201708	3	1	0	0	3	2	1	0	2899	1686	501	1536	716	53
30538	Transmission_Control_Protocol	201709	12	5	0	0	10	6	5	0	2911	1692	506	1542	718	53
30538	Transmission_Control_Protocol	201710	24	4	0	0	13	9	4	0	2935	1704	510	1562	726	56
30538	Transmission_Control_Protocol	201711	4	0	0	0	3	2	0	0	2939	1707	510	1565	728	56
30538	Transmission_Control_Protocol	201712	6	1	0	0	5	4	1	0	2945	1712	511	1569	732	57
30538	Transmission_Control_Protocol	201801	6	1	0	0	6	3	1	0	2951	1716	512	1572	733	57
30538	Transmission_Control_Protocol	201802	17	2	0	0	4	1	2	0	2968	1719	514	1573	733	57
30538	Transmission_Control_Protocol	201803	5	1	0	0	4	2	1	0	2973	1723	515	1576	735	57
30538	Transmission_Control_Protocol	201804	17	5	0	0	11	7	2	0	2990	1732	520	1586	737	61
30538	Transmission_Control_Protocol	201805	9	3	0	0	7	4	2	0	2999	1737	523	1591	739	61
30538	Transmission_Control_Protocol	201806	3	1	0	0	3	3	1	0	3002	1738	524	1594	739	62
30538	Transmission_Control_Protocol	201807	1	0	0	0	1	1	0	0	3003	1738	524	1595	739	62
2729873	Transparent_Network_Substrate	200510	1	0	0	0	1	0	0	0	1	1	0	0	0	0
2729873	Transparent_Network_Substrate	200511	2	0	0	0	1	1	0	0	3	2	0	2	1	0
2729873	Transparent_Network_Substrate	200601	2	0	0	0	2	1	0	0	5	3	0	3	1	0
2729873	Transparent_Network_Substrate	200602	3	0	0	0	2	2	0	0	8	5	0	6	3	0
2729873	Transparent_Network_Substrate	200603	2	0	0	0	1	1	0	0	10	6	0	8	4	0
2729873	Transparent_Network_Substrate	200604	1	0	0	0	1	1	0	0	11	7	0	9	5	0
2729873	Transparent_Network_Substrate	200607	1	0	0	0	1	1	0	0	12	8	0	10	6	0
2729873	Transparent_Network_Substrate	200703	1	0	0	0	1	1	0	0	13	8	0	11	6	0
2729873	Transparent_Network_Substrate	200704	1	0	0	0	1	0	0	0	14	9	0	11	6	0
2729873	Transparent_Network_Substrate	200712	4	1	0	0	2	1	1	0	18	11	1	13	7	0
2729873	Transparent_Network_Substrate	201010	1	0	0	0	1	1	0	0	19	11	1	14	7	0
2729873	Transparent_Network_Substrate	201106	1	0	0	0	1	1	0	0	20	12	1	15	8	0
2729873	Transparent_Network_Substrate	201107	1	0	0	0	1	1	0	0	21	13	1	16	9	0
2729873	Transparent_Network_Substrate	201108	1	0	0	0	1	0	0	0	22	14	1	16	9	0
2729873	Transparent_Network_Substrate	201110	1	0	0	0	1	0	0	0	23	15	1	16	9	0
2729873	Transparent_Network_Substrate	201201	1	1	0	0	1	0	1	0	24	16	2	16	9	0
2729873	Transparent_Network_Substrate	201205	1	0	0	0	1	1	0	0	25	17	2	17	10	0
2729873	Transparent_Network_Substrate	201210	2	0	0	0	1	0	0	0	27	18	2	17	10	0
2729873	Transparent_Network_Substrate	201301	1	0	0	0	1	1	0	0	28	19	2	18	11	0
2729873	Transparent_Network_Substrate	201302	1	0	0	0	1	1	0	0	29	20	2	19	12	0
2729873	Transparent_Network_Substrate	201303	1	0	0	0	1	1	0	0	30	21	2	20	13	0
2729873	Transparent_Network_Substrate	201310	1	0	0	0	1	1	0	0	31	22	2	21	14	0
2729873	Transparent_Network_Substrate	201312	1	0	0	0	1	1	0	0	32	23	2	22	15	0
2729873	Transparent_Network_Substrate	201604	1	0	0	0	1	0	0	0	33	24	2	22	15	0
2729873	Transparent_Network_Substrate	201609	1	0	0	0	1	1	0	0	34	25	2	23	16	0
2729873	Transparent_Network_Substrate	201610	1	0	0	0	1	0	0	0	35	26	2	23	16	0
2729873	Transparent_Network_Substrate	201801	1	1	0	0	1	0	1	0	36	27	3	23	16	0
2729873	Transparent_Network_Substrate	201807	1	0	0	0	1	1	0	0	37	28	3	24	17	0
187813	Transport_Layer_Security	200202	3	0	0	0	2	2	0	0	3	2	0	3	2	0
187813	Transport_Layer_Security	200208	1	0	0	0	1	1	0	0	4	3	0	4	3	0
187813	Transport_Layer_Security	200212	2	0	0	0	2	2	0	0	6	5	0	6	5	0
187813	Transport_Layer_Security	200301	1	0	0	0	1	0	0	0	7	6	0	6	5	0
187813	Transport_Layer_Security	200302	2	0	0	0	2	1	0	0	9	8	0	7	6	0
187813	Transport_Layer_Security	200305	26	0	0	0	3	2	0	0	35	11	0	23	8	0
187813	Transport_Layer_Security	200307	1	0	0	0	1	1	0	0	36	12	0	24	9	0
187813	Transport_Layer_Security	200308	1	0	0	0	1	0	0	0	37	13	0	24	9	0
187813	Transport_Layer_Security	200309	1	0	0	0	1	0	0	0	38	14	0	24	9	0
187813	Transport_Layer_Security	200310	2	0	0	0	1	1	0	0	40	15	0	26	10	0
187813	Transport_Layer_Security	200312	3	0	0	0	3	1	0	0	43	18	0	27	11	0
187813	Transport_Layer_Security	200401	2	0	0	0	2	1	0	0	45	20	0	28	12	0
187813	Transport_Layer_Security	200403	1	0	0	0	1	0	0	0	46	21	0	28	12	0
187813	Transport_Layer_Security	200404	1	0	0	0	1	1	0	0	47	22	0	29	13	0
187813	Transport_Layer_Security	200405	5	0	0	0	3	2	0	0	52	25	0	32	15	0
187813	Transport_Layer_Security	200406	9	1	0	0	5	3	1	0	61	29	1	39	17	0
187813	Transport_Layer_Security	200407	9	0	0	0	6	4	0	0	70	35	1	45	21	0
187813	Transport_Layer_Security	200408	5	0	0	0	5	4	0	0	75	38	1	49	23	0
187813	Transport_Layer_Security	200409	5	0	0	0	5	3	0	0	80	43	1	52	26	0
187813	Transport_Layer_Security	200410	5	0	0	0	4	2	0	0	85	46	1	54	27	0
187813	Transport_Layer_Security	200411	4	0	0	0	3	2	0	0	89	49	1	56	29	0
187813	Transport_Layer_Security	200412	8	0	0	0	7	4	0	0	97	56	1	61	33	0
187813	Transport_Layer_Security	200501	4	0	0	0	4	4	0	0	101	59	1	65	36	0
187813	Transport_Layer_Security	200502	1	0	0	0	1	0	0	0	102	60	1	65	36	0
187813	Transport_Layer_Security	200503	21	3	0	0	13	8	3	0	123	70	4	79	41	0
187813	Transport_Layer_Security	200504	12	0	0	0	9	2	0	0	135	77	4	83	42	0
187813	Transport_Layer_Security	200505	12	0	0	0	10	1	0	0	147	86	4	84	43	0
187813	Transport_Layer_Security	200506	12	3	0	0	10	7	3	0	159	94	7	93	48	0
187813	Transport_Layer_Security	200507	12	3	0	0	11	5	2	0	171	104	10	99	52	1
187813	Transport_Layer_Security	200508	12	0	0	0	10	8	0	0	183	114	10	108	60	1
187813	Transport_Layer_Security	200509	9	0	0	0	9	4	0	0	192	122	10	112	63	1
187813	Transport_Layer_Security	200510	9	0	0	0	6	4	0	0	201	125	10	118	64	1
187813	Transport_Layer_Security	200511	9	1	0	0	7	3	1	0	210	130	11	122	65	1
187813	Transport_Layer_Security	200512	17	2	0	0	11	4	2	0	227	139	13	127	67	1
187813	Transport_Layer_Security	200601	15	4	0	0	12	4	3	0	242	150	17	133	70	1
187813	Transport_Layer_Security	200602	11	0	0	0	6	3	0	0	253	155	17	138	72	1
187813	Transport_Layer_Security	200603	12	1	0	0	7	3	1	0	265	161	18	143	74	1
187813	Transport_Layer_Security	200604	19	5	0	0	13	6	2	0	284	168	23	154	76	1
187813	Transport_Layer_Security	200605	23	3	0	0	18	7	3	0	307	185	26	163	82	2
187813	Transport_Layer_Security	200606	31	5	0	0	22	9	3	0	338	202	31	179	88	3
187813	Transport_Layer_Security	200607	12	0	0	0	11	7	0	0	350	212	31	186	94	3
187813	Transport_Layer_Security	200608	20	3	0	0	18	10	3	0	370	228	34	197	102	3
187813	Transport_Layer_Security	200609	12	2	0	0	11	7	2	0	382	237	36	204	108	3
187813	Transport_Layer_Security	200610	10	0	0	0	8	3	0	0	392	245	36	207	111	3
187813	Transport_Layer_Security	200611	32	4	0	0	24	10	4	0	424	268	40	219	121	3
187813	Transport_Layer_Security	200612	34	1	0	0	21	13	1	0	458	287	41	236	132	3
187813	Transport_Layer_Security	200701	40	4	0	0	27	12	3	0	498	309	45	254	140	4
187813	Transport_Layer_Security	200702	29	3	0	0	22	14	2	0	527	326	48	275	150	4
187813	Transport_Layer_Security	200703	35	3	0	0	19	7	3	0	562	343	51	287	155	4
187813	Transport_Layer_Security	200704	40	7	0	0	26	15	6	0	602	365	58	307	166	6
187813	Transport_Layer_Security	200705	38	1	0	0	15	6	1	0	640	377	59	332	170	6
187813	Transport_Layer_Security	200706	36	4	0	0	21	15	4	0	676	393	63	358	181	7
187813	Transport_Layer_Security	200707	17	4	0	0	14	6	4	0	693	406	67	364	186	7
187813	Transport_Layer_Security	200708	46	4	0	0	19	10	2	0	739	422	71	391	193	9
187813	Transport_Layer_Security	200709	12	0	0	0	9	6	0	0	751	430	71	400	198	9
187813	Transport_Layer_Security	200710	8	2	0	0	8	3	2	0	759	436	73	403	199	9
187813	Transport_Layer_Security	200711	21	3	0	0	19	9	3	0	780	454	76	412	207	9
187813	Transport_Layer_Security	200712	23	2	0	0	13	11	1	0	803	466	78	433	217	11
187813	Transport_Layer_Security	200801	18	5	1	0	12	8	4	1	821	477	83	444	224	15
187813	Transport_Layer_Security	200802	19	5	0	0	15	7	4	0	840	489	88	453	228	17
187813	Transport_Layer_Security	200803	11	0	0	0	10	4	0	0	851	497	88	458	230	17
187813	Transport_Layer_Security	200804	7	0	0	0	6	3	0	0	858	502	88	462	232	17
187813	Transport_Layer_Security	200805	11	2	0	0	10	5	1	0	869	509	90	468	234	17
187813	Transport_Layer_Security	200806	21	2	0	0	12	4	2	0	890	520	92	476	237	17
187813	Transport_Layer_Security	200807	21	6	0	0	17	12	5	0	911	535	98	490	247	17
187813	Transport_Layer_Security	200808	2	1	0	0	2	2	1	0	913	537	99	492	249	18
187813	Transport_Layer_Security	200809	20	1	0	0	16	6	1	0	933	552	100	498	254	18
187813	Transport_Layer_Security	200810	10	1	0	0	9	3	1	0	943	560	101	502	256	18
187813	Transport_Layer_Security	200811	34	2	0	0	18	10	2	0	977	576	103	519	264	18
187813	Transport_Layer_Security	200812	10	0	0	0	7	5	0	0	987	581	103	526	267	18
187813	Transport_Layer_Security	200901	22	4	0	0	18	6	4	0	1009	597	107	532	271	18
187813	Transport_Layer_Security	200902	27	4	0	0	17	9	3	0	1036	610	111	549	277	19
187813	Transport_Layer_Security	200903	17	2	0	0	15	9	2	0	1053	621	113	559	282	19
187813	Transport_Layer_Security	200904	22	4	0	0	16	9	4	0	1075	631	117	570	285	19
187813	Transport_Layer_Security	200905	58	2	0	0	17	8	2	0	1133	644	119	616	289	19
187813	Transport_Layer_Security	200906	18	1	0	0	12	4	1	0	1151	656	120	622	293	19
187813	Transport_Layer_Security	200907	22	4	0	0	14	6	3	0	1173	666	124	632	295	21
187813	Transport_Layer_Security	200908	11	2	0	0	9	6	1	0	1184	672	126	640	298	21
187813	Transport_Layer_Security	200909	17	3	0	0	12	6	2	0	1201	681	129	648	301	23
187813	Transport_Layer_Security	200910	15	4	0	0	14	6	4	0	1216	693	133	654	305	23
187813	Transport_Layer_Security	200911	31	7	0	0	25	14	6	0	1247	712	140	670	313	25
187813	Transport_Layer_Security	200912	63	0	0	0	20	15	0	0	1310	726	140	723	322	25
187813	Transport_Layer_Security	201001	16	3	0	0	12	6	2	0	1326	734	143	732	324	25
187813	Transport_Layer_Security	201002	8	0	0	0	8	3	0	0	1334	741	143	735	326	25
187813	Transport_Layer_Security	201003	9	2	0	0	8	5	2	0	1343	746	145	741	328	25
187813	Transport_Layer_Security	201004	24	9	2	1	17	8	5	2	1367	758	154	753	331	26
187813	Transport_Layer_Security	201005	14	3	0	0	10	6	2	0	1381	765	157	760	334	26
187813	Transport_Layer_Security	201006	16	3	0	0	15	9	3	0	1397	778	160	769	341	26
187813	Transport_Layer_Security	201007	10	2	0	0	8	4	2	0	1407	785	162	775	344	26
187813	Transport_Layer_Security	201008	24	5	0	0	17	10	4	0	1431	797	167	787	350	29
187813	Transport_Layer_Security	201009	9	2	0	0	9	7	2	0	1440	801	169	794	352	30
187813	Transport_Layer_Security	201010	9	1	0	0	7	4	1	0	1449	807	170	799	355	30
187813	Transport_Layer_Security	201011	22	4	0	0	16	11	4	0	1471	818	174	815	361	32
187813	Transport_Layer_Security	201012	30	3	0	0	19	8	3	0	1501	833	177	831	365	32
187813	Transport_Layer_Security	201101	14	1	0	0	8	4	1	0	1515	840	178	835	368	32
187813	Transport_Layer_Security	201102	24	6	0	0	14	7	4	0	1539	850	184	848	371	33
187813	Transport_Layer_Security	201103	27	4	0	0	18	7	4	0	1566	863	188	856	373	33
187813	Transport_Layer_Security	201104	23	6	0	0	17	11	4	0	1589	877	194	873	381	34
187813	Transport_Layer_Security	201105	13	5	0	0	12	9	5	0	1602	886	199	883	387	38
187813	Transport_Layer_Security	201106	17	2	0	0	12	7	2	0	1619	896	201	894	392	38
187813	Transport_Layer_Security	201107	8	0	0	0	6	2	0	0	1627	902	201	898	394	38
187813	Transport_Layer_Security	201108	10	1	0	0	7	2	1	0	1637	908	202	901	395	38
187813	Transport_Layer_Security	201109	13	2	0	0	11	5	2	0	1650	917	204	907	398	38
187813	Transport_Layer_Security	201110	52	2	0	0	26	16	2	0	1702	940	206	942	412	38
187813	Transport_Layer_Security	201111	18	2	0	0	15	6	2	0	1720	952	208	951	415	38
187813	Transport_Layer_Security	201112	15	1	0	0	11	5	1	0	1735	961	209	957	418	38
187813	Transport_Layer_Security	201201	20	5	0	0	13	8	4	0	1755	970	214	966	422	39
187813	Transport_Layer_Security	201202	21	3	0	0	14	8	2	0	1776	980	217	978	426	39
187813	Transport_Layer_Security	201203	16	6	0	0	13	7	6	0	1792	990	223	988	430	39
187813	Transport_Layer_Security	201204	24	5	0	0	14	8	5	0	1816	1003	228	1005	437	40
187813	Transport_Layer_Security	201205	9	1	0	0	9	5	1	0	1825	1012	229	1010	442	40
187813	Transport_Layer_Security	201206	13	2	0	0	9	6	2	0	1838	1020	231	1019	447	40
187813	Transport_Layer_Security	201207	13	2	0	0	11	4	2	0	1851	1031	233	1023	451	40
187813	Transport_Layer_Security	201208	13	2	0	0	8	5	2	0	1864	1037	235	1032	454	40
187813	Transport_Layer_Security	201209	14	2	0	0	12	8	2	0	1878	1046	237	1042	459	40
187813	Transport_Layer_Security	201210	10	1	0	0	7	5	1	0	1888	1050	238	1049	461	40
187813	Transport_Layer_Security	201211	14	3	0	0	11	5	3	0	1902	1059	241	1055	464	40
187813	Transport_Layer_Security	201212	25	4	0	0	12	8	3	0	1927	1064	245	1076	466	42
187813	Transport_Layer_Security	201301	14	2	0	0	13	8	2	0	1941	1074	247	1085	471	42
187813	Transport_Layer_Security	201302	13	1	0	0	12	9	1	0	1954	1085	248	1095	479	42
187813	Transport_Layer_Security	201303	18	4	0	0	10	7	3	0	1972	1092	252	1109	483	43
187813	Transport_Layer_Security	201304	63	6	0	0	28	16	6	0	2035	1110	258	1146	489	43
187813	Transport_Layer_Security	201305	26	1	0	0	14	7	1	0	2061	1121	259	1160	494	43
187813	Transport_Layer_Security	201306	16	5	0	0	16	7	5	0	2077	1131	264	1167	496	43
187813	Transport_Layer_Security	201307	21	2	0	0	14	8	2	0	2098	1141	266	1179	501	43
187813	Transport_Layer_Security	201308	99	2	0	0	22	17	2	0	2197	1156	268	1272	510	45
187813	Transport_Layer_Security	201309	82	5	0	0	25	11	4	0	2279	1174	273	1334	514	45
187813	Transport_Layer_Security	201310	72	2	0	0	21	12	2	0	2351	1189	275	1391	521	46
187813	Transport_Layer_Security	201311	35	3	0	0	24	11	3	0	2386	1206	278	1407	527	46
187813	Transport_Layer_Security	201312	60	5	0	0	29	10	5	0	2446	1225	283	1421	529	48
187813	Transport_Layer_Security	201401	28	0	0	0	13	9	0	0	2474	1235	283	1445	533	48
187813	Transport_Layer_Security	201402	41	5	0	0	25	17	3	0	2515	1255	288	1476	544	49
187813	Transport_Layer_Security	201403	38	3	0	0	19	9	3	0	2553	1270	291	1498	548	49
187813	Transport_Layer_Security	201404	26	6	0	0	18	12	3	0	2579	1283	297	1518	554	49
187813	Transport_Layer_Security	201405	41	2	0	0	23	16	1	0	2620	1297	299	1546	561	50
187813	Transport_Layer_Security	201406	32	6	0	0	16	10	4	0	2652	1306	305	1572	565	51
187813	Transport_Layer_Security	201407	41	3	0	0	16	5	3	0	2693	1318	308	1597	566	51
187813	Transport_Layer_Security	201408	61	2	0	0	17	8	2	0	2754	1330	310	1632	568	52
187813	Transport_Layer_Security	201409	19	6	0	0	14	8	3	0	2773	1342	316	1644	574	54
187813	Transport_Layer_Security	201410	68	1	0	0	21	7	1	0	2841	1358	317	1678	576	54
187813	Transport_Layer_Security	201411	85	1	0	0	27	14	1	0	2926	1377	318	1736	583	54
187813	Transport_Layer_Security	201412	37	2	0	0	13	8	2	0	2963	1385	320	1765	586	55
187813	Transport_Layer_Security	201501	27	0	0	0	13	7	0	0	2990	1393	320	1784	588	55
187813	Transport_Layer_Security	201502	43	1	0	0	16	10	1	0	3033	1401	321	1819	591	55
187813	Transport_Layer_Security	201503	81	10	1	0	20	9	4	1	3114	1415	331	1871	594	59
187813	Transport_Layer_Security	201504	31	5	1	0	18	10	5	1	3145	1428	336	1891	600	60
187813	Transport_Layer_Security	201505	40	4	0	0	21	12	4	0	3185	1445	340	1916	603	61
187813	Transport_Layer_Security	201506	50	4	0	0	16	13	3	0	3235	1453	344	1957	607	63
187813	Transport_Layer_Security	201507	24	2	0	0	16	10	2	0	3259	1462	346	1975	608	63
187813	Transport_Layer_Security	201508	21	2	0	0	16	10	2	0	3280	1473	348	1989	612	63
187813	Transport_Layer_Security	201509	11	0	0	0	10	9	0	0	3291	1480	348	1999	615	63
187813	Transport_Layer_Security	201510	36	1	0	0	18	15	1	0	3327	1493	349	2029	620	63
187813	Transport_Layer_Security	201511	48	3	0	0	18	10	1	0	3375	1504	352	2067	623	63
187813	Transport_Layer_Security	201512	16	0	0	0	14	9	0	0	3391	1514	352	2077	628	63
187813	Transport_Layer_Security	201601	19	5	0	0	16	11	3	0	3410	1527	357	2091	635	64
187813	Transport_Layer_Security	201602	17	0	0	0	10	6	0	0	3427	1534	357	2103	638	64
187813	Transport_Layer_Security	201603	21	4	0	0	13	8	3	0	3448	1544	361	2116	642	66
187813	Transport_Layer_Security	201604	27	2	0	0	13	7	2	0	3475	1553	363	2137	645	66
187813	Transport_Layer_Security	201605	13	3	0	0	9	6	3	0	3488	1559	366	2146	647	66
187813	Transport_Layer_Security	201606	18	3	0	0	10	5	3	0	3506	1564	369	2158	648	66
187813	Transport_Layer_Security	201607	11	2	0	0	8	5	2	0	3517	1568	371	2165	649	66
187813	Transport_Layer_Security	201608	13	3	0	0	11	7	3	0	3530	1575	374	2173	652	66
187813	Transport_Layer_Security	201609	20	2	0	0	12	8	2	0	3550	1585	376	2188	658	66
187813	Transport_Layer_Security	201610	9	3	0	0	8	4	2	0	3559	1590	379	2193	659	66
187813	Transport_Layer_Security	201611	13	1	0	0	11	9	1	0	3572	1597	380	2204	663	67
187813	Transport_Layer_Security	201612	12	3	0	0	10	8	3	0	3584	1605	383	2213	668	68
187813	Transport_Layer_Security	201701	20	4	0	0	15	11	3	0	3604	1615	387	2229	671	69
187813	Transport_Layer_Security	201702	3	0	0	0	1	0	0	0	3607	1616	387	2229	671	69
187813	Transport_Layer_Security	201703	18	1	0	0	13	8	1	0	3625	1626	388	2240	676	70
187813	Transport_Layer_Security	201704	23	3	0	0	22	14	3	0	3648	1642	391	2254	681	70
187813	Transport_Layer_Security	201705	28	2	0	0	19	15	2	0	3676	1660	393	2276	688	70
187813	Transport_Layer_Security	201706	13	0	0	0	9	7	0	0	3689	1667	393	2287	691	70
187813	Transport_Layer_Security	201707	18	2	0	0	15	11	2	0	3707	1679	395	2299	697	71
187813	Transport_Layer_Security	201708	26	4	0	0	19	10	4	0	3733	1693	399	2314	700	73
187813	Transport_Layer_Security	201709	15	0	0	0	8	4	0	0	3748	1700	399	2325	704	73
187813	Transport_Layer_Security	201710	30	4	0	0	23	11	3	0	3778	1718	403	2342	710	73
187813	Transport_Layer_Security	201711	16	0	0	0	13	9	0	0	3794	1730	403	2353	715	73
187813	Transport_Layer_Security	201712	28	2	0	0	23	9	2	0	3822	1751	405	2365	722	73
187813	Transport_Layer_Security	201801	25	0	0	0	12	9	0	0	3847	1757	405	2387	725	73
187813	Transport_Layer_Security	201802	29	0	0	0	20	16	0	0	3876	1771	405	2412	730	73
187813	Transport_Layer_Security	201803	12	2	0	0	9	6	2	0	3888	1778	407	2420	732	73
187813	Transport_Layer_Security	201804	27	6	0	0	20	15	6	0	3915	1796	413	2442	739	76
187813	Transport_Layer_Security	201805	29	3	0	0	19	11	3	0	3944	1812	416	2462	744	76
187813	Transport_Layer_Security	201806	26	7	0	0	23	16	6	0	3970	1831	423	2478	752	77
187813	Transport_Layer_Security	201807	27	1	0	0	18	14	1	0	3997	1843	424	2501	757	77
146145	Transport_layer	200301	1	0	0	0	1	0	0	0	1	1	0	0	0	0
146145	Transport_layer	200305	4	0	0	0	2	1	0	0	5	3	0	3	1	0
146145	Transport_layer	200308	3	0	0	0	3	2	0	0	8	6	0	5	3	0
146145	Transport_layer	200309	1	0	0	0	1	1	0	0	9	7	0	6	4	0
146145	Transport_layer	200402	1	0	0	0	1	1	0	0	10	8	0	7	5	0
146145	Transport_layer	200403	2	0	0	0	2	1	0	0	12	10	0	8	6	0
146145	Transport_layer	200406	4	0	0	0	3	2	0	0	16	13	0	10	8	0
146145	Transport_layer	200408	4	0	0	0	4	3	0	0	20	17	0	13	11	0
146145	Transport_layer	200409	2	0	0	0	1	0	0	0	22	18	0	13	11	0
146145	Transport_layer	200410	3	0	0	0	3	2	0	0	25	21	0	15	13	0
146145	Transport_layer	200412	6	1	0	0	5	3	1	0	31	25	1	18	15	0
146145	Transport_layer	200501	1	0	0	0	1	1	0	0	32	26	1	19	16	0
146145	Transport_layer	200502	2	0	0	0	2	1	0	0	34	28	1	20	17	0
146145	Transport_layer	200503	4	0	0	0	3	1	0	0	38	31	1	21	18	0
146145	Transport_layer	200504	1	0	0	0	1	1	0	0	39	32	1	22	19	0
146145	Transport_layer	200505	3	0	0	0	3	0	0	0	42	35	1	22	19	0
146145	Transport_layer	200506	1	0	0	0	1	1	0	0	43	36	1	23	20	0
146145	Transport_layer	200507	3	0	0	0	3	0	0	0	46	39	1	23	20	0
146145	Transport_layer	200508	2	0	0	0	2	2	0	0	48	41	1	25	22	0
146145	Transport_layer	200509	1	0	0	0	1	1	0	0	49	42	1	26	23	0
146145	Transport_layer	200510	4	0	0	0	4	1	0	0	53	46	1	27	24	0
146145	Transport_layer	200511	3	0	0	0	3	2	0	0	56	49	1	29	26	0
146145	Transport_layer	200512	4	0	0	0	3	3	0	0	60	52	1	33	29	0
146145	Transport_layer	200602	2	0	0	0	2	2	0	0	62	54	1	35	31	0
146145	Transport_layer	200603	7	3	0	0	6	4	3	0	69	59	4	40	34	1
146145	Transport_layer	200604	8	2	0	0	6	3	2	0	77	63	6	43	35	1
146145	Transport_layer	200605	3	0	0	0	3	1	0	0	80	65	6	44	35	1
146145	Transport_layer	200606	2	0	0	0	2	2	0	0	82	67	6	46	37	1
146145	Transport_layer	200607	2	1	0	0	2	1	1	0	84	69	7	47	38	1
146145	Transport_layer	200610	3	0	0	0	2	2	0	0	87	70	7	50	39	1
146145	Transport_layer	200611	5	1	0	0	3	2	1	0	92	72	8	54	40	1
146145	Transport_layer	200612	15	1	0	0	6	4	1	0	107	76	9	67	42	1
146145	Transport_layer	200701	5	0	0	0	3	2	0	0	112	79	9	69	44	1
146145	Transport_layer	200702	10	2	0	0	7	3	2	0	122	83	11	72	45	1
146145	Transport_layer	200703	4	0	0	0	3	1	0	0	126	86	11	73	46	1
146145	Transport_layer	200705	3	1	0	0	3	1	1	0	129	89	12	74	47	1
146145	Transport_layer	200706	2	0	0	0	2	2	0	0	131	91	12	76	49	1
146145	Transport_layer	200707	7	0	0	0	5	3	0	0	138	96	12	79	52	1
146145	Transport_layer	200708	12	2	0	0	9	3	2	0	150	103	14	85	53	1
146145	Transport_layer	200709	1	0	0	0	1	0	0	0	151	104	14	85	53	1
146145	Transport_layer	200710	2	0	0	0	2	1	0	0	153	106	14	86	54	1
146145	Transport_layer	200711	1	0	0	0	1	1	0	0	154	107	14	87	55	1
146145	Transport_layer	200712	3	0	0	0	2	2	0	0	157	109	14	90	57	1
146145	Transport_layer	200801	3	0	0	0	3	1	0	0	160	112	14	91	58	1
146145	Transport_layer	200803	6	0	0	0	5	3	0	0	166	115	14	95	59	1
146145	Transport_layer	200804	2	0	0	0	2	2	0	0	168	117	14	97	61	1
146145	Transport_layer	200805	4	0	0	0	3	0	0	0	172	120	14	97	61	1
146145	Transport_layer	200806	4	0	0	0	4	3	0	0	176	123	14	100	63	1
146145	Transport_layer	200807	3	0	0	0	3	3	0	0	179	126	14	103	66	1
146145	Transport_layer	200808	7	0	0	0	2	1	0	0	186	128	14	109	67	1
146145	Transport_layer	200809	10	1	0	0	6	6	1	0	196	133	15	119	72	2
146145	Transport_layer	200810	3	1	0	0	3	2	1	0	199	135	16	121	73	3
146145	Transport_layer	200811	1	0	0	0	1	1	0	0	200	136	16	122	74	3
146145	Transport_layer	200812	8	0	0	0	5	4	0	0	208	141	16	129	78	3
146145	Transport_layer	200901	10	4	0	0	7	4	3	0	218	147	20	134	81	3
146145	Transport_layer	200902	6	2	0	0	4	2	2	0	224	150	22	136	82	3
146145	Transport_layer	200903	5	1	0	0	5	4	1	0	229	154	23	140	85	3
146145	Transport_layer	200904	1	0	0	0	1	1	0	0	230	155	23	141	86	3
146145	Transport_layer	200905	8	2	0	0	6	4	2	0	238	159	25	147	88	3
146145	Transport_layer	200906	1	0	0	0	1	1	0	0	239	160	25	148	89	3
146145	Transport_layer	200907	6	3	0	0	3	2	1	0	245	162	28	153	90	5
146145	Transport_layer	200908	6	2	0	0	4	2	2	0	251	165	30	155	91	5
146145	Transport_layer	200909	1	0	0	0	1	0	0	0	252	166	30	155	91	5
146145	Transport_layer	200911	7	2	0	0	7	4	2	0	259	173	32	159	95	5
146145	Transport_layer	201001	3	1	0	0	3	1	1	0	262	176	33	160	96	5
146145	Transport_layer	201002	5	1	0	0	4	2	1	0	267	180	34	162	98	5
146145	Transport_layer	201003	4	0	0	0	3	0	0	0	271	183	34	162	98	5
146145	Transport_layer	201004	1	1	0	0	1	0	1	0	272	184	35	162	98	5
146145	Transport_layer	201005	4	1	0	0	4	2	1	0	276	187	36	164	99	5
146145	Transport_layer	201006	4	2	0	0	4	3	2	0	280	191	38	167	102	6
146145	Transport_layer	201007	18	0	0	0	2	2	0	0	298	193	38	185	104	6
146145	Transport_layer	201008	6	1	0	0	3	2	1	0	304	194	39	188	104	6
146145	Transport_layer	201009	3	0	0	0	2	2	0	0	307	194	39	191	104	6
146145	Transport_layer	201010	9	0	0	0	4	3	0	0	316	195	39	198	104	6
146145	Transport_layer	201011	5	2	0	0	5	3	2	0	321	198	41	201	105	6
146145	Transport_layer	201012	2	0	0	0	2	1	0	0	323	200	41	202	106	6
146145	Transport_layer	201101	3	1	0	0	3	2	1	0	326	202	42	204	107	6
146145	Transport_layer	201103	2	1	0	0	2	1	1	0	328	203	43	205	107	6
146145	Transport_layer	201104	7	2	0	0	6	4	2	0	335	207	45	209	109	6
146145	Transport_layer	201107	2	1	0	0	2	1	1	0	337	209	46	210	110	6
146145	Transport_layer	201108	3	0	0	0	3	2	0	0	340	212	46	212	112	6
146145	Transport_layer	201109	7	2	0	0	6	3	2	0	347	217	48	215	114	6
146145	Transport_layer	201110	8	3	0	0	6	3	2	0	355	222	51	219	116	6
146145	Transport_layer	201111	7	2	0	0	6	4	2	0	362	226	53	223	118	6
146145	Transport_layer	201112	4	0	0	0	3	3	0	0	366	227	53	227	119	6
146145	Transport_layer	201201	2	1	0	0	2	1	1	0	368	228	54	228	119	6
146145	Transport_layer	201202	5	1	0	0	5	2	1	0	373	231	55	230	119	6
146145	Transport_layer	201205	4	2	0	0	4	2	2	0	377	233	57	232	119	6
146145	Transport_layer	201206	1	0	0	0	1	1	0	0	378	233	57	233	119	6
146145	Transport_layer	201207	1	0	0	0	1	1	0	0	379	234	57	234	120	6
146145	Transport_layer	201208	5	1	0	0	3	2	1	0	384	237	58	238	122	6
146145	Transport_layer	201209	2	1	0	0	2	1	1	0	386	238	59	239	122	6
146145	Transport_layer	201212	1	0	0	0	1	0	0	0	387	239	59	239	122	6
146145	Transport_layer	201301	3	1	0	0	3	3	1	0	390	241	60	242	124	7
146145	Transport_layer	201302	1	0	0	0	1	0	0	0	391	242	60	242	124	7
146145	Transport_layer	201303	11	0	0	0	4	4	0	0	402	244	60	253	126	7
146145	Transport_layer	201304	3	1	0	0	3	2	1	0	405	246	61	255	127	7
146145	Transport_layer	201306	2	1	0	0	2	1	1	0	407	248	62	256	128	7
146145	Transport_layer	201307	1	0	0	0	1	1	0	0	408	249	62	257	129	7
146145	Transport_layer	201309	4	1	0	0	4	2	1	0	412	252	63	259	130	7
146145	Transport_layer	201310	2	0	0	0	1	1	0	0	414	253	63	261	131	7
146145	Transport_layer	201311	4	1	0	0	4	3	1	0	418	257	64	264	134	7
146145	Transport_layer	201312	4	2	0	0	3	1	1	0	422	259	66	266	134	7
146145	Transport_layer	201401	8	3	0	0	5	3	3	0	430	261	69	270	134	7
146145	Transport_layer	201403	4	1	0	0	2	1	1	0	434	263	70	271	135	7
146145	Transport_layer	201404	11	1	0	0	5	2	1	0	445	266	71	278	135	7
146145	Transport_layer	201407	5	1	0	0	3	2	1	0	450	268	72	282	136	7
146145	Transport_layer	201410	1	0	0	0	1	1	0	0	451	269	72	283	137	7
146145	Transport_layer	201411	1	0	0	0	1	1	0	0	452	270	72	284	138	7
146145	Transport_layer	201501	2	0	0	0	2	1	0	0	454	271	72	285	138	7
146145	Transport_layer	201504	3	1	0	0	3	1	1	0	457	273	73	286	138	7
146145	Transport_layer	201505	3	1	0	0	3	2	1	0	460	275	74	288	139	7
146145	Transport_layer	201506	2	1	0	0	2	2	1	0	462	276	75	290	140	8
146145	Transport_layer	201509	2	1	0	0	2	1	1	0	464	277	76	291	140	8
146145	Transport_layer	201510	4	1	0	0	3	1	1	0	468	279	77	293	140	8
146145	Transport_layer	201511	3	0	0	0	1	1	0	0	471	280	77	296	141	8
146145	Transport_layer	201512	3	1	0	0	3	2	1	0	474	282	78	298	142	8
146145	Transport_layer	201603	2	1	0	0	2	1	1	0	476	283	79	299	142	8
146145	Transport_layer	201604	3	1	0	0	2	2	1	0	479	284	80	302	142	9
146145	Transport_layer	201609	3	0	0	0	2	1	0	0	482	285	80	304	142	9
146145	Transport_layer	201610	4	2	0	0	4	2	2	0	486	288	82	306	143	9
146145	Transport_layer	201611	10	2	0	0	6	3	2	0	496	293	84	312	145	9
146145	Transport_layer	201701	3	0	0	0	2	1	0	0	499	294	84	313	145	9
146145	Transport_layer	201702	5	1	0	0	4	3	1	0	504	297	85	317	147	9
146145	Transport_layer	201703	2	1	0	0	2	1	1	0	506	298	86	318	147	9
146145	Transport_layer	201706	1	0	0	0	1	1	0	0	507	299	86	319	148	9
146145	Transport_layer	201709	1	0	0	0	1	1	0	0	508	300	86	320	149	9
146145	Transport_layer	201711	1	0	0	0	1	1	0	0	509	301	86	321	150	9
146145	Transport_layer	201712	1	0	0	0	1	1	0	0	510	302	86	322	151	9
146145	Transport_layer	201801	1	0	0	0	1	1	0	0	511	303	86	323	152	9
146145	Transport_layer	201802	1	0	0	0	1	1	0	0	512	303	86	324	152	9
146145	Transport_layer	201803	12	2	0	0	6	5	2	0	524	307	88	330	155	9
146145	Transport_layer	201804	1	0	0	0	1	1	0	0	525	307	88	331	155	9
146145	Transport_layer	201806	4	2	0	0	4	4	2	0	529	309	90	335	156	11
146145	Transport_layer	201807	1	0	0	0	1	1	0	0	530	310	90	336	157	11
1272738	Tunneling_protocol	200501	14	0	0	0	1	1	0	0	14	1	0	14	1	0
1272738	Tunneling_protocol	200502	1	0	0	0	1	1	0	0	15	2	0	15	2	0
1272738	Tunneling_protocol	200503	2	0	0	0	2	2	0	0	17	4	0	17	4	0
1272738	Tunneling_protocol	200504	1	0	0	0	1	0	0	0	18	5	0	17	4	0
1272738	Tunneling_protocol	200505	4	0	0	0	3	2	0	0	22	8	0	20	6	0
1272738	Tunneling_protocol	200506	2	0	0	0	2	2	0	0	24	10	0	22	8	0
1272738	Tunneling_protocol	200507	3	0	0	0	2	1	0	0	27	11	0	24	8	0
1272738	Tunneling_protocol	200508	1	0	0	0	1	0	0	0	28	12	0	24	8	0
1272738	Tunneling_protocol	200509	1	0	0	0	1	1	0	0	29	13	0	25	9	0
1272738	Tunneling_protocol	200511	4	0	0	0	3	2	0	0	33	16	0	27	11	0
1272738	Tunneling_protocol	200512	1	0	0	0	1	1	0	0	34	17	0	28	12	0
1272738	Tunneling_protocol	200601	2	0	0	0	2	1	0	0	36	19	0	29	13	0
1272738	Tunneling_protocol	200602	3	0	0	0	3	1	0	0	39	21	0	30	13	0
1272738	Tunneling_protocol	200603	1	0	0	0	1	1	0	0	40	22	0	31	14	0
1272738	Tunneling_protocol	200604	4	0	0	0	4	2	0	0	44	26	0	33	16	0
1272738	Tunneling_protocol	200605	4	0	0	0	2	2	0	0	48	28	0	37	18	0
1272738	Tunneling_protocol	200606	5	1	0	0	5	2	1	0	53	33	1	39	20	0
1272738	Tunneling_protocol	200608	4	0	0	0	4	4	0	0	57	36	1	43	23	0
1272738	Tunneling_protocol	200609	1	0	0	0	1	0	0	0	58	37	1	43	23	0
1272738	Tunneling_protocol	200610	2	1	0	0	2	1	1	0	60	39	2	44	24	0
1272738	Tunneling_protocol	200612	2	0	0	0	2	2	0	0	62	41	2	46	26	0
1272738	Tunneling_protocol	200701	7	2	0	0	7	6	2	0	69	48	4	52	32	2
1272738	Tunneling_protocol	200702	3	0	0	0	3	1	0	0	72	50	4	53	32	2
1272738	Tunneling_protocol	200703	1	0	0	0	1	0	0	0	73	51	4	53	32	2
1272738	Tunneling_protocol	200705	4	1	0	0	4	3	1	0	77	54	5	56	34	2
1272738	Tunneling_protocol	200706	3	0	0	0	1	1	0	0	80	55	5	59	35	2
1272738	Tunneling_protocol	200707	6	1	0	0	5	4	1	0	86	59	6	64	38	3
1272738	Tunneling_protocol	200709	12	0	0	0	7	5	0	0	98	65	6	72	42	3
1272738	Tunneling_protocol	200711	3	0	0	0	2	0	0	0	101	67	6	72	42	3
1272738	Tunneling_protocol	200712	4	0	0	0	4	2	0	0	105	71	6	74	44	3
1272738	Tunneling_protocol	200801	4	0	0	0	2	2	0	0	109	72	6	78	45	3
1272738	Tunneling_protocol	200802	2	0	0	0	2	2	0	0	111	74	6	80	47	3
1272738	Tunneling_protocol	200803	5	0	0	0	5	3	0	0	116	78	6	83	49	3
1272738	Tunneling_protocol	200804	8	1	0	0	6	3	1	0	124	84	7	88	52	3
1272738	Tunneling_protocol	200805	6	1	0	0	5	2	1	0	130	88	8	91	53	4
1272738	Tunneling_protocol	200806	7	1	0	0	7	4	1	0	137	95	9	95	57	4
1272738	Tunneling_protocol	200807	2	0	0	0	2	1	0	0	139	97	9	96	58	4
1272738	Tunneling_protocol	200808	4	0	0	0	3	3	0	0	143	100	9	100	61	4
1272738	Tunneling_protocol	200809	2	0	0	0	2	1	0	0	145	102	9	101	62	4
1272738	Tunneling_protocol	200810	3	1	0	0	3	1	1	0	148	105	10	102	63	4
1272738	Tunneling_protocol	200811	2	0	0	0	1	0	0	0	150	106	10	102	63	4
1272738	Tunneling_protocol	200812	2	0	0	0	2	2	0	0	152	108	10	104	65	4
1272738	Tunneling_protocol	200901	3	0	0	0	2	2	0	0	155	109	10	107	66	4
1272738	Tunneling_protocol	200903	2	0	0	0	2	2	0	0	157	111	10	109	68	4
1272738	Tunneling_protocol	200904	5	0	0	0	4	3	0	0	162	115	10	113	71	4
1272738	Tunneling_protocol	200905	8	3	2	1	4	1	2	2	170	117	13	116	71	6
1272738	Tunneling_protocol	200906	6	0	0	0	5	3	0	0	176	121	13	119	73	6
1272738	Tunneling_protocol	200907	2	1	0	0	2	2	1	0	178	122	14	121	74	7
1272738	Tunneling_protocol	200908	1	0	0	0	1	1	0	0	179	123	14	122	75	7
1272738	Tunneling_protocol	200909	2	0	0	0	2	1	0	0	181	125	14	123	76	7
1272738	Tunneling_protocol	200910	4	0	0	0	3	1	0	0	185	128	14	124	77	7
1272738	Tunneling_protocol	201001	4	1	0	0	4	4	1	0	189	131	15	128	80	8
1272738	Tunneling_protocol	201002	3	1	0	0	3	0	1	0	192	134	16	128	80	8
1272738	Tunneling_protocol	201003	4	2	0	0	4	3	2	0	196	138	18	131	83	8
1272738	Tunneling_protocol	201004	7	0	0	0	4	3	0	0	203	142	18	135	86	8
1272738	Tunneling_protocol	201005	3	1	0	0	3	1	1	0	206	145	19	136	87	8
1272738	Tunneling_protocol	201007	4	1	0	0	4	1	1	0	210	149	20	137	88	8
1272738	Tunneling_protocol	201008	4	1	0	0	3	1	1	0	214	151	21	138	88	8
1272738	Tunneling_protocol	201009	2	0	0	0	1	0	0	0	216	152	21	138	88	8
1272738	Tunneling_protocol	201010	1	0	0	0	1	0	0	0	217	153	21	138	88	8
1272738	Tunneling_protocol	201011	3	0	0	0	3	2	0	0	220	156	21	140	90	8
1272738	Tunneling_protocol	201012	1	0	0	0	1	0	0	0	221	157	21	140	90	8
1272738	Tunneling_protocol	201101	3	0	0	0	3	1	0	0	224	160	21	141	91	8
1272738	Tunneling_protocol	201102	6	2	0	0	4	2	1	0	230	163	23	144	92	8
1272738	Tunneling_protocol	201106	3	0	0	0	3	1	0	0	233	166	23	145	93	8
1272738	Tunneling_protocol	201107	2	0	0	0	2	2	0	0	235	168	23	147	95	8
1272738	Tunneling_protocol	201109	2	0	0	0	2	1	0	0	237	170	23	148	96	8
1272738	Tunneling_protocol	201110	4	2	1	0	2	1	2	1	241	172	25	149	97	9
1272738	Tunneling_protocol	201111	3	1	0	0	3	3	1	0	244	174	26	152	99	10
1272738	Tunneling_protocol	201112	3	0	0	0	3	2	0	0	247	175	26	154	99	10
1272738	Tunneling_protocol	201201	2	1	0	0	2	1	1	0	249	177	27	155	100	10
1272738	Tunneling_protocol	201202	4	0	0	0	3	0	0	0	253	180	27	155	100	10
1272738	Tunneling_protocol	201203	1	0	0	0	1	1	0	0	254	181	27	156	101	10
1272738	Tunneling_protocol	201204	1	0	0	0	1	0	0	0	255	182	27	156	101	10
1272738	Tunneling_protocol	201205	3	1	0	0	3	1	1	0	258	185	28	157	102	10
1272738	Tunneling_protocol	201206	2	0	0	0	1	0	0	0	260	186	28	157	102	10
1272738	Tunneling_protocol	201207	6	0	0	0	3	2	0	0	266	189	28	162	104	10
1272738	Tunneling_protocol	201209	1	0	0	0	1	1	0	0	267	189	28	163	104	10
1272738	Tunneling_protocol	201210	2	1	0	0	2	2	1	0	269	191	29	165	106	11
1272738	Tunneling_protocol	201211	5	0	0	0	2	1	0	0	274	193	29	168	107	11
1272738	Tunneling_protocol	201301	4	1	0	0	3	2	1	0	278	195	30	170	108	11
1272738	Tunneling_protocol	201302	3	0	0	0	3	2	0	0	281	197	30	172	109	11
1272738	Tunneling_protocol	201303	3	0	0	0	3	3	0	0	284	199	30	175	111	11
1272738	Tunneling_protocol	201305	1	0	0	0	1	1	0	0	285	200	30	176	112	11
1272738	Tunneling_protocol	201306	1	0	0	0	1	0	0	0	286	201	30	176	112	11
1272738	Tunneling_protocol	201307	1	1	0	0	1	0	1	0	287	202	31	176	112	11
1272738	Tunneling_protocol	201308	3	0	0	0	3	2	0	0	290	205	31	178	114	11
1272738	Tunneling_protocol	201310	2	1	0	0	2	1	1	0	292	207	32	179	115	11
1272738	Tunneling_protocol	201312	5	0	0	0	3	2	0	0	297	210	32	182	117	11
1272738	Tunneling_protocol	201401	3	1	0	0	3	2	1	0	300	213	33	184	119	11
1272738	Tunneling_protocol	201402	5	0	0	0	3	2	0	0	305	216	33	188	120	11
1272738	Tunneling_protocol	201404	4	1	0	0	4	1	1	0	309	220	34	189	121	11
1272738	Tunneling_protocol	201405	2	0	0	0	2	1	0	0	311	222	34	190	122	11
1272738	Tunneling_protocol	201406	5	1	0	0	3	2	1	0	316	224	35	193	122	12
1272738	Tunneling_protocol	201407	1	0	0	0	1	1	0	0	317	225	35	194	122	12
1272738	Tunneling_protocol	201408	10	0	0	0	4	3	0	0	327	228	35	203	124	12
1272738	Tunneling_protocol	201409	3	0	0	0	1	1	0	0	330	228	35	206	124	12
1272738	Tunneling_protocol	201410	2	0	0	0	1	1	0	0	332	229	35	208	125	12
1272738	Tunneling_protocol	201411	3	1	0	0	3	2	1	0	335	231	36	210	126	12
1272738	Tunneling_protocol	201412	9	0	0	0	4	3	0	0	344	234	36	218	128	12
1272738	Tunneling_protocol	201501	3	1	0	0	3	3	1	0	347	235	37	221	129	13
1272738	Tunneling_protocol	201502	1	0	0	0	1	0	0	0	348	236	37	221	129	13
1272738	Tunneling_protocol	201504	2	0	0	0	1	0	0	0	350	237	37	221	129	13
1272738	Tunneling_protocol	201505	3	0	0	0	2	1	0	0	353	238	37	223	129	13
1272738	Tunneling_protocol	201506	2	1	0	0	2	2	1	0	355	239	38	225	130	14
1272738	Tunneling_protocol	201508	5	4	3	2	4	3	3	2	360	241	42	229	131	17
1272738	Tunneling_protocol	201509	1	0	0	0	1	1	0	0	361	242	42	230	132	17
1272738	Tunneling_protocol	201511	1	0	0	0	1	0	0	0	362	243	42	230	132	17
1272738	Tunneling_protocol	201601	2	0	0	0	2	0	0	0	364	245	42	230	132	17
1272738	Tunneling_protocol	201602	2	1	0	0	2	1	1	0	366	247	43	231	133	17
1272738	Tunneling_protocol	201603	1	0	0	0	1	1	0	0	367	248	43	232	134	17
1272738	Tunneling_protocol	201604	5	0	0	0	3	3	0	0	372	251	43	237	137	17
1272738	Tunneling_protocol	201605	3	0	0	0	1	1	0	0	375	251	43	240	137	17
1272738	Tunneling_protocol	201608	1	0	0	0	1	0	0	0	376	252	43	240	137	17
1272738	Tunneling_protocol	201609	4	1	0	0	2	2	1	0	380	254	44	244	138	18
1272738	Tunneling_protocol	201611	1	0	0	0	1	1	0	0	381	255	44	245	139	18
1272738	Tunneling_protocol	201612	3	1	0	0	3	2	1	0	384	257	45	247	140	18
1272738	Tunneling_protocol	201701	3	1	0	0	3	2	1	0	387	260	46	249	142	18
1272738	Tunneling_protocol	201702	2	0	0	0	2	1	0	0	389	262	46	250	143	18
1272738	Tunneling_protocol	201703	4	1	0	0	2	1	1	0	393	263	47	251	143	18
1272738	Tunneling_protocol	201706	2	0	0	0	1	1	0	0	395	264	47	253	144	18
1272738	Tunneling_protocol	201707	1	0	0	0	1	1	0	0	396	265	47	254	145	18
1272738	Tunneling_protocol	201710	2	1	0	0	2	1	1	0	398	266	48	255	145	18
1272738	Tunneling_protocol	201711	2	0	0	0	1	0	0	0	400	267	48	255	145	18
1272738	Tunneling_protocol	201803	1	0	0	0	1	1	0	0	401	267	48	256	145	18
1272738	Tunneling_protocol	201804	2	0	0	0	2	2	0	0	403	268	48	258	146	18
1272738	Tunneling_protocol	201805	7	0	0	0	3	1	0	0	410	271	48	260	147	18
1272738	Tunneling_protocol	201806	8	0	0	0	5	5	0	0	418	276	48	268	152	18
1272738	Tunneling_protocol	201807	1	0	0	0	1	1	0	0	419	277	48	269	153	18
9988187	Twitter	200703	4	0	0	0	3	3	0	0	4	3	0	4	3	0
9988187	Twitter	200704	56	1	0	0	39	22	1	0	60	42	1	41	25	1
9988187	Twitter	200705	49	1	0	0	33	15	1	0	109	73	2	65	38	1
9988187	Twitter	200706	31	2	0	0	27	16	2	0	140	96	4	85	52	1
9988187	Twitter	200707	24	1	0	0	20	8	1	0	164	115	5	96	59	2
9988187	Twitter	200708	23	2	0	0	19	12	2	0	187	132	7	111	70	2
9988187	Twitter	200709	21	1	0	0	17	9	1	0	208	148	8	122	78	2
9988187	Twitter	200710	12	1	0	0	9	5	1	0	220	155	9	127	81	2
9988187	Twitter	200711	19	4	0	0	10	6	1	0	239	165	13	138	87	3
9988187	Twitter	200712	7	1	0	0	7	6	1	0	246	170	14	144	91	3
9988187	Twitter	200801	20	1	0	0	15	6	1	0	266	184	15	152	96	3
9988187	Twitter	200802	16	3	0	0	11	6	2	0	282	191	18	162	98	5
9988187	Twitter	200803	8	0	0	0	6	5	0	0	290	196	18	169	102	5
9988187	Twitter	200804	22	1	0	0	16	8	1	0	312	212	19	182	110	5
9988187	Twitter	200805	42	2	0	0	36	18	2	0	354	248	21	204	128	5
9988187	Twitter	200806	56	7	0	0	41	22	7	0	410	285	28	238	147	6
9988187	Twitter	200807	75	7	0	0	53	26	7	0	485	336	35	274	171	8
9988187	Twitter	200808	84	4	0	0	56	33	4	0	569	390	39	325	203	9
9988187	Twitter	200809	33	9	1	0	28	17	7	1	602	413	48	346	215	14
9988187	Twitter	200810	43	5	0	0	33	16	5	0	645	440	53	370	225	17
9988187	Twitter	200811	61	11	0	0	42	23	8	0	706	478	64	403	245	17
9988187	Twitter	200812	87	7	0	0	48	24	7	0	793	522	71	453	265	20
9988187	Twitter	200901	102	14	0	0	75	38	12	0	895	591	85	505	297	24
9988187	Twitter	200902	116	12	0	0	77	42	8	0	1011	658	97	579	329	34
9988187	Twitter	200903	238	32	1	0	162	79	23	1	1249	810	129	716	398	41
9988187	Twitter	200904	396	66	0	0	249	110	40	0	1645	1042	195	942	491	60
9988187	Twitter	200905	293	62	5	1	165	92	33	5	1938	1186	257	1132	566	76
9988187	Twitter	200906	199	51	0	0	107	60	26	0	2137	1272	308	1262	607	86
9988187	Twitter	200907	161	12	1	0	45	45	6	1	2298	1306	320	1423	641	98
9988187	Twitter	200908	173	4	0	0	33	33	2	0	2471	1326	324	1596	661	102
9988187	Twitter	200909	71	4	0	0	36	36	3	0	2542	1350	328	1667	685	106
9988187	Twitter	200910	55	3	0	0	31	31	3	0	2597	1370	331	1722	705	109
9988187	Twitter	200911	80	4	0	0	30	30	3	0	2677	1387	335	1802	722	113
9988187	Twitter	200912	24	1	0	0	21	21	1	0	2701	1398	336	1826	733	114
9988187	Twitter	201001	27	1	0	0	20	20	1	0	2728	1416	337	1853	751	115
9988187	Twitter	201002	26	0	0	0	22	22	0	0	2754	1431	337	1879	766	115
9988187	Twitter	201003	19	0	0	0	13	13	0	0	2773	1441	337	1898	776	115
9988187	Twitter	201004	52	2	0	0	28	28	2	0	2825	1467	339	1950	802	117
9988187	Twitter	201005	47	1	0	0	25	25	1	0	2872	1486	340	1997	821	118
9988187	Twitter	201006	37	3	0	0	26	26	3	0	2909	1506	343	2034	841	121
9988187	Twitter	201007	79	13	0	0	53	43	11	0	2988	1554	356	2101	879	127
9988187	Twitter	201008	138	36	3	2	71	48	21	2	3126	1615	392	2213	917	145
9988187	Twitter	201009	86	24	1	0	60	39	18	1	3212	1663	416	2271	944	150
9988187	Twitter	201010	157	37	1	0	111	72	27	1	3369	1756	453	2384	998	165
9988187	Twitter	201011	120	35	0	0	92	53	27	0	3489	1825	488	2456	1028	174
9988187	Twitter	201012	95	30	1	0	71	45	21	1	3584	1880	518	2519	1057	180
9988187	Twitter	201101	99	31	0	0	76	45	22	0	3683	1939	549	2576	1086	188
9988187	Twitter	201102	136	41	0	0	90	55	23	0	3819	2008	590	2672	1121	201
9988187	Twitter	201103	143	43	5	1	81	51	27	5	3962	2067	633	2760	1152	216
9988187	Twitter	201104	135	42	0	0	89	54	29	0	4097	2136	675	2850	1187	225
9988187	Twitter	201105	132	36	1	0	85	56	26	1	4229	2201	711	2940	1224	238
9988187	Twitter	201106	82	13	0	0	46	38	11	0	4311	2234	724	3011	1249	243
9988187	Twitter	201107	38	4	2	1	26	26	3	2	4349	2249	728	3049	1264	247
9988187	Twitter	201108	29	2	0	0	19	19	2	0	4378	2264	730	3078	1279	249
9988187	Twitter	201109	36	4	1	0	22	22	3	1	4414	2282	734	3114	1297	253
9988187	Twitter	201110	21	0	0	0	14	14	0	0	4435	2287	734	3135	1302	253
9988187	Twitter	201111	16	0	0	0	11	11	0	0	4451	2295	734	3151	1310	253
9988187	Twitter	201112	16	0	0	0	12	12	0	0	4467	2300	734	3167	1315	253
9988187	Twitter	201201	48	7	0	0	23	23	3	0	4515	2311	741	3215	1326	260
9988187	Twitter	201202	26	0	0	0	18	18	0	0	4541	2321	741	3241	1336	260
9988187	Twitter	201203	37	6	0	0	26	23	4	0	4578	2337	747	3272	1349	263
9988187	Twitter	201204	53	11	0	0	29	22	7	0	4631	2356	758	3316	1361	265
9988187	Twitter	201205	25	2	0	0	17	17	2	0	4656	2362	760	3341	1367	267
9988187	Twitter	201206	26	2	0	0	17	17	1	0	4682	2370	762	3367	1375	269
9988187	Twitter	201207	57	5	0	0	28	28	1	0	4739	2390	767	3424	1395	274
9988187	Twitter	201208	29	2	0	0	19	19	1	0	4768	2400	769	3453	1405	276
9988187	Twitter	201209	17	1	0	0	14	14	1	0	4785	2407	770	3470	1412	277
9988187	Twitter	201210	23	3	0	0	16	16	2	0	4808	2414	773	3493	1419	280
9988187	Twitter	201211	31	0	0	0	18	18	0	0	4839	2426	773	3524	1431	280
9988187	Twitter	201212	13	1	0	0	11	11	1	0	4852	2432	774	3537	1437	281
9988187	Twitter	201301	32	3	0	0	20	20	2	0	4884	2446	777	3569	1451	284
9988187	Twitter	201302	20	2	0	0	15	15	1	0	4904	2453	779	3589	1458	286
9988187	Twitter	201303	36	0	0	0	19	19	0	0	4940	2466	779	3625	1471	286
9988187	Twitter	201304	20	1	0	0	14	14	1	0	4960	2472	780	3645	1477	287
9988187	Twitter	201305	37	4	0	0	24	24	2	0	4997	2487	784	3682	1492	291
9988187	Twitter	201306	22	1	0	0	15	15	1	0	5019	2499	785	3704	1504	292
9988187	Twitter	201307	9	1	0	0	8	8	1	0	5028	2502	786	3713	1507	293
9988187	Twitter	201308	18	0	0	0	13	13	0	0	5046	2511	786	3731	1516	293
9988187	Twitter	201309	42	1	0	0	19	19	1	0	5088	2524	787	3773	1529	294
9988187	Twitter	201310	40	2	0	0	19	19	1	0	5128	2535	789	3813	1540	296
9988187	Twitter	201311	39	3	0	0	18	18	1	0	5167	2545	792	3852	1550	299
9988187	Twitter	201312	43	1	0	0	22	22	1	0	5210	2558	793	3895	1563	300
9988187	Twitter	201401	19	3	0	0	13	13	2	0	5229	2564	796	3914	1569	303
9988187	Twitter	201402	16	3	0	0	10	10	2	0	5245	2571	799	3930	1576	306
9988187	Twitter	201403	19	1	0	0	13	13	1	0	5264	2577	800	3949	1582	307
9988187	Twitter	201404	37	4	1	0	22	22	2	1	5301	2590	804	3986	1595	311
9988187	Twitter	201405	27	1	0	0	23	23	1	0	5328	2604	805	4013	1609	312
9988187	Twitter	201406	18	3	0	0	15	15	1	0	5346	2614	808	4031	1619	315
9988187	Twitter	201407	41	1	0	0	16	16	1	0	5387	2622	809	4072	1627	316
9988187	Twitter	201408	35	6	2	1	17	17	3	2	5422	2632	815	4107	1637	322
9988187	Twitter	201409	33	8	3	2	19	19	3	2	5455	2641	823	4140	1646	330
9988187	Twitter	201410	18	3	0	0	11	11	3	0	5473	2645	826	4158	1650	333
9988187	Twitter	201411	22	1	0	0	18	18	1	0	5495	2653	827	4180	1658	334
9988187	Twitter	201412	10	2	0	0	7	7	1	0	5505	2658	829	4190	1663	336
9988187	Twitter	201501	11	1	0	0	6	6	1	0	5516	2660	830	4201	1665	337
9988187	Twitter	201502	26	5	0	0	16	16	3	0	5542	2670	835	4227	1675	342
9988187	Twitter	201503	27	2	0	0	13	13	1	0	5569	2679	837	4254	1684	344
9988187	Twitter	201504	12	1	0	0	7	7	1	0	5581	2682	838	4266	1687	345
9988187	Twitter	201505	24	4	0	0	14	14	2	0	5605	2689	842	4290	1694	349
9988187	Twitter	201506	22	1	0	0	17	17	1	0	5627	2700	843	4312	1705	350
9988187	Twitter	201507	16	0	0	0	16	16	0	0	5643	2711	843	4328	1716	350
9988187	Twitter	201508	18	0	0	0	16	16	0	0	5661	2719	843	4346	1724	350
9988187	Twitter	201509	11	0	0	0	10	10	0	0	5672	2724	843	4357	1729	350
9988187	Twitter	201510	10	2	0	0	10	10	2	0	5682	2728	845	4367	1733	352
9988187	Twitter	201511	23	0	0	0	15	15	0	0	5705	2737	845	4390	1742	352
9988187	Twitter	201512	14	0	0	0	14	14	0	0	5719	2745	845	4404	1750	352
9988187	Twitter	201601	18	1	0	0	12	12	1	0	5737	2753	846	4422	1758	353
9988187	Twitter	201602	23	1	0	0	16	16	1	0	5760	2763	847	4445	1768	354
9988187	Twitter	201603	13	1	0	0	8	8	1	0	5773	2770	848	4458	1775	355
9988187	Twitter	201604	16	0	0	0	13	13	0	0	5789	2778	848	4474	1783	355
9988187	Twitter	201605	17	1	0	0	12	12	1	0	5806	2787	849	4491	1792	356
9988187	Twitter	201606	22	3	2	1	13	13	2	2	5828	2794	852	4513	1799	359
9988187	Twitter	201607	26	0	0	0	19	19	0	0	5854	2808	852	4539	1813	359
9988187	Twitter	201608	11	1	0	0	10	10	1	0	5865	2817	853	4550	1822	360
9988187	Twitter	201609	27	1	0	0	19	19	1	0	5892	2827	854	4577	1832	361
9988187	Twitter	201610	25	2	0	0	14	14	1	0	5917	2834	856	4602	1839	363
9988187	Twitter	201611	19	1	0	0	14	14	1	0	5936	2842	857	4621	1847	364
9988187	Twitter	201612	45	8	1	0	20	20	8	1	5981	2854	865	4666	1859	372
9988187	Twitter	201701	24	2	0	0	13	13	2	0	6005	2863	867	4690	1868	374
9988187	Twitter	201702	28	0	0	0	17	17	0	0	6033	2869	867	4718	1874	374
9988187	Twitter	201703	24	1	0	0	18	18	1	0	6057	2882	868	4742	1887	375
9988187	Twitter	201704	14	1	0	0	10	10	1	0	6071	2887	869	4756	1892	376
9988187	Twitter	201705	13	0	0	0	10	10	0	0	6084	2894	869	4769	1899	376
9988187	Twitter	201706	24	1	0	0	14	14	1	0	6108	2899	870	4793	1904	377
9988187	Twitter	201707	16	0	0	0	12	12	0	0	6124	2907	870	4809	1912	377
9988187	Twitter	201708	17	3	0	0	11	11	2	0	6141	2912	873	4826	1917	380
9988187	Twitter	201709	12	0	0	0	10	10	0	0	6153	2918	873	4838	1923	380
9988187	Twitter	201710	17	2	0	0	11	11	2	0	6170	2927	875	4855	1932	382
9988187	Twitter	201711	16	0	0	0	4	4	0	0	6186	2930	875	4871	1935	382
9988187	Twitter	201712	50	3	0	0	29	29	2	0	6236	2946	878	4921	1951	385
9988187	Twitter	201801	26	0	0	0	15	15	0	0	6262	2954	878	4947	1959	385
9988187	Twitter	201802	8	1	0	0	8	8	1	0	6270	2958	879	4955	1963	386
9988187	Twitter	201803	21	0	0	0	10	10	0	0	6291	2964	879	4976	1969	386
9988187	Twitter	201804	18	0	0	0	13	13	0	0	6309	2972	879	4994	1977	386
9988187	Twitter	201805	15	0	0	0	13	13	0	0	6324	2978	879	5009	1983	386
9988187	Twitter	201806	6	1	0	0	6	6	1	0	6330	2984	880	5015	1989	387
9988187	Twitter	201807	14	2	0	0	13	13	2	0	6344	2991	882	5029	1996	389
333697	Uniform_Resource_Name	200312	2	0	0	0	2	1	0	0	2	2	0	1	1	0
333697	Uniform_Resource_Name	200402	2	0	0	0	2	1	0	0	4	4	0	2	2	0
333697	Uniform_Resource_Name	200404	1	0	0	0	1	1	0	0	5	5	0	3	3	0
333697	Uniform_Resource_Name	200407	1	0	0	0	1	1	0	0	6	6	0	4	4	0
333697	Uniform_Resource_Name	200408	1	0	0	0	1	1	0	0	7	7	0	5	5	0
333697	Uniform_Resource_Name	200410	2	0	0	0	1	1	0	0	9	8	0	7	6	0
333697	Uniform_Resource_Name	200411	3	0	0	0	3	2	0	0	12	11	0	9	8	0
333697	Uniform_Resource_Name	200412	2	0	0	0	2	2	0	0	14	13	0	11	10	0
333697	Uniform_Resource_Name	200501	2	1	0	0	2	1	1	0	16	14	1	12	10	0
333697	Uniform_Resource_Name	200502	2	0	0	0	2	1	0	0	18	16	1	13	11	0
333697	Uniform_Resource_Name	200503	2	0	0	0	2	2	0	0	20	18	1	15	13	0
333697	Uniform_Resource_Name	200504	1	0	0	0	1	1	0	0	21	19	1	16	14	0
333697	Uniform_Resource_Name	200507	1	0	0	0	1	0	0	0	22	20	1	16	14	0
333697	Uniform_Resource_Name	200509	2	0	0	0	2	1	0	0	24	22	1	17	15	0
333697	Uniform_Resource_Name	200511	2	0	0	0	1	1	0	0	26	23	1	19	16	0
333697	Uniform_Resource_Name	200512	2	0	0	0	2	1	0	0	28	25	1	20	17	0
333697	Uniform_Resource_Name	200601	3	0	0	0	2	0	0	0	31	27	1	20	17	0
333697	Uniform_Resource_Name	200602	3	0	0	0	1	0	0	0	34	28	1	20	17	0
333697	Uniform_Resource_Name	200606	2	0	0	0	2	1	0	0	36	30	1	21	18	0
333697	Uniform_Resource_Name	200607	2	0	0	0	1	1	0	0	38	31	1	23	19	0
333697	Uniform_Resource_Name	200608	4	0	0	0	2	0	0	0	42	33	1	23	19	0
333697	Uniform_Resource_Name	200609	10	0	0	0	2	1	0	0	52	35	1	32	20	0
333697	Uniform_Resource_Name	200610	5	0	0	0	4	3	0	0	57	39	1	36	23	0
333697	Uniform_Resource_Name	200611	4	0	0	0	3	3	0	0	61	42	1	40	26	0
333697	Uniform_Resource_Name	200612	7	0	0	0	5	5	0	0	68	47	1	47	31	0
333697	Uniform_Resource_Name	200701	2	0	0	0	2	1	0	0	70	49	1	48	32	0
333697	Uniform_Resource_Name	200702	7	0	0	0	3	2	0	0	77	52	1	51	34	0
333697	Uniform_Resource_Name	200703	4	0	0	0	4	3	0	0	81	56	1	54	37	0
333697	Uniform_Resource_Name	200704	6	0	0	0	5	4	0	0	87	60	1	59	40	0
333697	Uniform_Resource_Name	200705	6	2	0	0	3	2	1	0	93	63	3	62	42	0
333697	Uniform_Resource_Name	200707	7	0	0	0	3	1	0	0	100	65	3	65	42	0
333697	Uniform_Resource_Name	200708	4	0	0	0	3	3	0	0	104	67	3	69	44	0
333697	Uniform_Resource_Name	200709	3	1	0	0	2	1	1	0	107	68	4	70	44	0
333697	Uniform_Resource_Name	200711	1	0	0	0	1	1	0	0	108	69	4	71	45	0
333697	Uniform_Resource_Name	200802	1	0	0	0	1	1	0	0	109	70	4	72	46	0
333697	Uniform_Resource_Name	200803	6	0	0	0	2	1	0	0	115	71	4	74	46	0
333697	Uniform_Resource_Name	200807	1	0	0	0	1	0	0	0	116	72	4	74	46	0
333697	Uniform_Resource_Name	200808	1	0	0	0	1	1	0	0	117	73	4	75	47	0
333697	Uniform_Resource_Name	200812	1	0	0	0	1	1	0	0	118	74	4	76	48	0
333697	Uniform_Resource_Name	200901	7	0	0	0	4	2	0	0	125	78	4	79	50	0
333697	Uniform_Resource_Name	200902	1	0	0	0	1	1	0	0	126	79	4	80	51	0
333697	Uniform_Resource_Name	200903	3	1	0	0	2	2	1	0	129	80	5	83	52	1
333697	Uniform_Resource_Name	200904	1	0	0	0	1	1	0	0	130	81	5	84	53	1
333697	Uniform_Resource_Name	200906	2	0	0	0	2	0	0	0	132	83	5	84	53	1
333697	Uniform_Resource_Name	200907	3	1	0	0	3	2	1	0	135	86	6	86	55	1
333697	Uniform_Resource_Name	200908	3	1	0	0	3	1	1	0	138	89	7	87	56	1
333697	Uniform_Resource_Name	200909	1	0	0	0	1	1	0	0	139	90	7	88	57	1
333697	Uniform_Resource_Name	201004	2	0	0	0	2	0	0	0	141	92	7	88	57	1
333697	Uniform_Resource_Name	201005	1	0	0	0	1	1	0	0	142	93	7	89	58	1
333697	Uniform_Resource_Name	201006	2	1	0	0	2	1	1	0	144	95	8	90	59	1
333697	Uniform_Resource_Name	201007	1	0	0	0	1	1	0	0	145	96	8	91	60	1
333697	Uniform_Resource_Name	201008	9	2	0	0	6	3	2	0	154	102	10	94	63	2
333697	Uniform_Resource_Name	201012	1	0	0	0	1	0	0	0	155	103	10	94	63	2
333697	Uniform_Resource_Name	201101	1	0	0	0	1	1	0	0	156	104	10	95	64	2
333697	Uniform_Resource_Name	201102	2	1	0	0	2	1	1	0	158	106	11	96	65	2
333697	Uniform_Resource_Name	201103	1	0	0	0	1	1	0	0	159	107	11	97	66	2
333697	Uniform_Resource_Name	201104	2	0	0	0	2	2	0	0	161	109	11	99	68	2
333697	Uniform_Resource_Name	201105	1	0	0	0	1	1	0	0	162	110	11	100	69	2
333697	Uniform_Resource_Name	201107	2	0	0	0	2	2	0	0	164	112	11	102	71	2
333697	Uniform_Resource_Name	201108	1	0	0	0	1	1	0	0	165	113	11	103	72	2
333697	Uniform_Resource_Name	201110	1	0	0	0	1	1	0	0	166	114	11	104	73	2
333697	Uniform_Resource_Name	201111	1	0	0	0	1	1	0	0	167	115	11	105	74	2
333697	Uniform_Resource_Name	201112	6	0	0	0	3	1	0	0	173	118	11	109	75	2
333697	Uniform_Resource_Name	201201	1	0	0	0	1	1	0	0	174	119	11	110	76	2
333697	Uniform_Resource_Name	201203	2	0	0	0	2	2	0	0	176	121	11	112	78	2
333697	Uniform_Resource_Name	201205	4	1	0	0	3	2	1	0	180	124	12	115	80	3
333697	Uniform_Resource_Name	201207	2	0	0	0	2	1	0	0	182	126	12	116	81	3
333697	Uniform_Resource_Name	201208	1	0	0	0	1	0	0	0	183	127	12	116	81	3
333697	Uniform_Resource_Name	201210	7	0	0	0	4	3	0	0	190	131	12	119	84	3
333697	Uniform_Resource_Name	201211	4	0	0	0	1	1	0	0	194	131	12	123	84	3
333697	Uniform_Resource_Name	201212	2	0	0	0	2	1	0	0	196	133	12	124	85	3
333697	Uniform_Resource_Name	201301	20	0	0	0	2	2	0	0	216	135	12	144	87	3
333697	Uniform_Resource_Name	201302	2	0	0	0	2	2	0	0	218	136	12	146	88	3
333697	Uniform_Resource_Name	201303	3	1	0	0	2	1	1	0	221	137	13	147	88	3
333697	Uniform_Resource_Name	201304	4	0	0	0	4	3	0	0	225	140	13	150	90	3
333697	Uniform_Resource_Name	201305	1	0	0	0	1	1	0	0	226	140	13	151	90	3
333697	Uniform_Resource_Name	201306	1	0	0	0	1	1	0	0	227	140	13	152	90	3
333697	Uniform_Resource_Name	201307	1	0	0	0	1	1	0	0	228	141	13	153	91	3
333697	Uniform_Resource_Name	201312	1	0	0	0	1	1	0	0	229	142	13	154	92	3
333697	Uniform_Resource_Name	201401	3	1	0	0	2	1	1	0	232	144	14	155	93	3
333697	Uniform_Resource_Name	201404	2	0	0	0	2	1	0	0	234	145	14	156	93	3
333697	Uniform_Resource_Name	201405	3	0	0	0	1	1	0	0	237	145	14	159	93	3
333697	Uniform_Resource_Name	201406	3	1	0	0	3	2	1	0	240	147	15	161	94	3
333697	Uniform_Resource_Name	201411	3	0	0	0	3	2	0	0	243	150	15	163	96	3
333697	Uniform_Resource_Name	201412	2	0	0	0	2	2	0	0	245	152	15	165	98	3
333697	Uniform_Resource_Name	201501	1	0	0	0	1	1	0	0	246	153	15	166	99	3
333697	Uniform_Resource_Name	201503	1	0	0	0	1	1	0	0	247	154	15	167	100	3
333697	Uniform_Resource_Name	201504	10	0	0	0	2	2	0	0	257	155	15	177	101	3
333697	Uniform_Resource_Name	201505	1	0	0	0	1	0	0	0	258	156	15	177	101	3
333697	Uniform_Resource_Name	201508	1	0	0	0	1	1	0	0	259	157	15	178	102	3
333697	Uniform_Resource_Name	201509	6	1	0	0	3	2	1	0	265	159	16	183	103	4
333697	Uniform_Resource_Name	201510	4	0	0	0	3	3	0	0	269	161	16	187	104	4
333697	Uniform_Resource_Name	201512	2	1	0	0	2	2	1	0	271	162	17	189	104	5
333697	Uniform_Resource_Name	201601	2	2	1	0	2	1	2	1	273	163	19	190	104	6
333697	Uniform_Resource_Name	201602	4	0	0	0	2	2	0	0	277	163	19	194	104	6
333697	Uniform_Resource_Name	201603	3	1	0	0	3	2	1	0	280	166	20	196	106	6
333697	Uniform_Resource_Name	201604	2	0	0	0	2	1	0	0	282	168	20	197	107	6
333697	Uniform_Resource_Name	201608	1	0	0	0	1	1	0	0	283	168	20	198	107	6
333697	Uniform_Resource_Name	201701	4	1	0	0	3	1	1	0	287	171	21	199	108	6
333697	Uniform_Resource_Name	201702	4	1	0	0	3	2	1	0	291	173	22	202	109	6
333697	Uniform_Resource_Name	201703	7	2	0	0	5	4	2	0	298	177	24	208	112	7
333697	Uniform_Resource_Name	201704	42	0	0	0	1	1	0	0	340	177	24	250	112	7
333697	Uniform_Resource_Name	201706	2	0	0	0	2	2	0	0	342	179	24	252	114	7
333697	Uniform_Resource_Name	201707	1	0	0	0	1	1	0	0	343	180	24	253	115	7
333697	Uniform_Resource_Name	201709	8	3	0	0	8	5	3	0	351	185	27	258	117	7
333697	Uniform_Resource_Name	201710	2	0	0	0	1	0	0	0	353	186	27	258	117	7
333697	Uniform_Resource_Name	201711	2	1	0	0	2	2	1	0	355	188	28	260	118	8
333697	Uniform_Resource_Name	201712	2	1	0	0	2	2	1	0	357	190	29	262	119	9
333697	Uniform_Resource_Name	201801	5	1	0	0	4	3	1	0	362	193	30	265	121	9
333697	Uniform_Resource_Name	201803	2	1	0	0	2	2	1	0	364	194	31	267	121	10
333697	Uniform_Resource_Name	201804	3	0	0	0	3	1	0	0	367	197	31	268	122	10
333697	Uniform_Resource_Name	201805	6	2	0	0	5	4	2	0	373	202	33	272	125	10
333697	Uniform_Resource_Name	201806	3	0	0	0	3	3	0	0	376	205	33	275	128	10
47674773	Unikernel	201509	50	0	0	0	9	5	0	0	50	9	0	39	5	0
47674773	Unikernel	201510	3	0	0	0	3	3	0	0	53	11	0	42	7	0
47674773	Unikernel	201511	1	0	0	0	1	1	0	0	54	12	0	43	8	0
47674773	Unikernel	201512	2	0	0	0	2	1	0	0	56	13	0	44	8	0
47674773	Unikernel	201601	3	0	0	0	3	2	0	0	59	15	0	46	9	0
47674773	Unikernel	201602	2	0	0	0	1	1	0	0	61	16	0	48	10	0
47674773	Unikernel	201603	3	0	0	0	3	2	0	0	64	19	0	50	12	0
47674773	Unikernel	201604	1	0	0	0	1	0	0	0	65	20	0	50	12	0
47674773	Unikernel	201605	1	0	0	0	1	0	0	0	66	21	0	50	12	0
47674773	Unikernel	201606	1	0	0	0	1	0	0	0	67	22	0	50	12	0
47674773	Unikernel	201607	8	0	0	0	3	2	0	0	75	25	0	56	14	0
47674773	Unikernel	201608	1	0	0	0	1	1	0	0	76	26	0	57	15	0
47674773	Unikernel	201610	2	0	0	0	2	2	0	0	78	28	0	59	17	0
47674773	Unikernel	201611	2	0	0	0	1	1	0	0	80	29	0	61	18	0
47674773	Unikernel	201701	6	0	0	0	5	3	0	0	86	34	0	65	20	0
47674773	Unikernel	201705	1	0	0	0	1	0	0	0	87	35	0	65	20	0
47674773	Unikernel	201707	2	0	0	0	2	1	0	0	89	37	0	66	21	0
47674773	Unikernel	201708	1	0	0	0	1	1	0	0	90	38	0	67	21	0
47674773	Unikernel	201711	5	0	0	0	2	2	0	0	95	40	0	72	23	0
47674773	Unikernel	201801	1	0	0	0	1	0	0	0	96	41	0	72	23	0
2261519	User_interface_design	200509	1	0	0	0	1	0	0	0	1	1	0	0	0	0
2261519	User_interface_design	200510	2	0	0	0	2	0	0	0	3	3	0	0	0	0
2261519	User_interface_design	200511	2	0	0	0	2	2	0	0	5	5	0	2	2	0
2261519	User_interface_design	200512	8	0	0	0	1	1	0	0	13	6	0	10	3	0
2261519	User_interface_design	200601	3	0	0	0	3	2	0	0	16	8	0	12	4	0
2261519	User_interface_design	200602	2	0	0	0	2	1	0	0	18	10	0	13	5	0
2261519	User_interface_design	200603	7	0	0	0	5	2	0	0	25	15	0	15	7	0
2261519	User_interface_design	200604	7	1	0	0	4	2	1	0	32	19	1	18	9	0
2261519	User_interface_design	200605	4	0	0	0	3	1	0	0	36	22	1	19	10	0
2261519	User_interface_design	200606	3	0	0	0	2	1	0	0	39	24	1	21	11	0
2261519	User_interface_design	200607	10	0	0	0	7	5	0	0	49	31	1	28	16	0
2261519	User_interface_design	200609	2	1	0	0	2	2	1	0	51	32	2	30	17	1
2261519	User_interface_design	200610	8	2	0	0	7	3	2	0	59	38	4	34	19	2
2261519	User_interface_design	200611	4	1	0	0	3	1	1	0	63	40	5	35	19	2
2261519	User_interface_design	200612	1	0	0	0	1	0	0	0	64	41	5	35	19	2
2261519	User_interface_design	200701	5	1	0	0	3	2	1	0	69	43	6	38	20	2
2261519	User_interface_design	200702	9	1	0	0	6	4	1	0	78	48	7	45	23	2
2261519	User_interface_design	200703	12	2	0	0	7	6	2	0	90	54	9	56	28	3
2261519	User_interface_design	200704	7	1	0	0	6	4	1	0	97	59	10	61	31	3
2261519	User_interface_design	200705	6	1	0	0	5	2	1	0	103	63	11	63	32	3
2261519	User_interface_design	200706	1	0	0	0	1	0	0	0	104	64	11	63	32	3
2261519	User_interface_design	200707	2	0	0	0	2	1	0	0	106	66	11	64	33	3
2261519	User_interface_design	200708	6	0	0	0	1	1	0	0	112	66	11	70	33	3
2261519	User_interface_design	200709	2	1	0	0	2	1	1	0	114	68	12	71	34	3
2261519	User_interface_design	200711	2	0	0	0	2	2	0	0	116	70	12	73	36	3
2261519	User_interface_design	200802	3	0	0	0	3	3	0	0	119	73	12	76	39	3
2261519	User_interface_design	200803	7	1	0	0	3	2	1	0	126	75	13	81	40	3
2261519	User_interface_design	200804	3	1	0	0	3	2	1	0	129	78	14	83	42	4
2261519	User_interface_design	200805	7	0	0	0	4	3	0	0	136	82	14	89	45	4
2261519	User_interface_design	200806	1	0	0	0	1	0	0	0	137	83	14	89	45	4
2261519	User_interface_design	200807	2	0	0	0	2	1	0	0	139	84	14	90	45	4
2261519	User_interface_design	200809	2	1	0	0	2	1	1	0	141	86	15	91	46	4
2261519	User_interface_design	200811	6	1	0	0	4	2	1	0	147	89	16	93	47	4
2261519	User_interface_design	200901	6	3	0	0	5	5	3	0	153	93	19	99	51	7
2261519	User_interface_design	200903	6	2	0	0	6	2	2	0	159	98	21	101	52	7
2261519	User_interface_design	200904	5	1	0	0	5	2	1	0	164	102	22	103	53	7
2261519	User_interface_design	200905	6	1	0	0	3	2	1	0	170	105	23	108	55	7
2261519	User_interface_design	200906	6	1	0	0	6	4	1	0	176	111	24	112	59	7
2261519	User_interface_design	200907	3	1	0	0	3	2	1	0	179	113	25	114	60	7
2261519	User_interface_design	200909	1	0	0	0	1	0	0	0	180	114	25	114	60	7
2261519	User_interface_design	200910	9	2	0	0	8	5	2	0	189	120	27	119	63	8
2261519	User_interface_design	200911	10	1	0	0	4	1	1	0	199	123	28	120	63	8
2261519	User_interface_design	200912	1	0	0	0	1	1	0	0	200	124	28	121	64	8
2261519	User_interface_design	201001	3	1	0	0	2	1	1	0	203	126	29	122	65	8
2261519	User_interface_design	201002	1	0	0	0	1	0	0	0	204	127	29	122	65	8
2261519	User_interface_design	201003	5	0	0	0	4	1	0	0	209	130	29	123	65	8
2261519	User_interface_design	201004	6	0	0	0	4	2	0	0	215	134	29	126	67	8
2261519	User_interface_design	201005	7	0	0	0	4	1	0	0	222	138	29	127	68	8
2261519	User_interface_design	201006	3	1	0	0	3	2	1	0	225	139	30	129	69	8
2261519	User_interface_design	201007	1	0	0	0	1	0	0	0	226	140	30	129	69	8
2261519	User_interface_design	201008	11	0	0	0	1	1	0	0	237	141	30	140	70	8
2261519	User_interface_design	201009	1	0	0	0	1	1	0	0	238	142	30	141	71	8
2261519	User_interface_design	201012	2	1	0	0	2	1	1	0	240	143	31	142	71	8
2261519	User_interface_design	201101	9	2	0	0	5	4	2	0	249	145	33	150	72	9
2261519	User_interface_design	201102	4	2	0	0	4	3	2	0	253	148	35	153	74	10
2261519	User_interface_design	201103	1	0	0	0	1	1	0	0	254	149	35	154	75	10
2261519	User_interface_design	201104	2	0	0	0	2	2	0	0	256	150	35	156	76	10
2261519	User_interface_design	201106	4	1	0	0	3	1	1	0	260	152	36	157	76	10
2261519	User_interface_design	201109	5	1	0	0	4	3	1	0	265	155	37	160	78	10
2261519	User_interface_design	201110	1	0	0	0	1	1	0	0	266	156	37	161	79	10
2261519	User_interface_design	201111	2	1	0	0	2	2	1	0	268	158	38	163	81	11
2261519	User_interface_design	201201	2	1	0	0	2	1	1	0	270	159	39	164	81	11
2261519	User_interface_design	201203	2	0	0	0	2	1	0	0	272	161	39	165	82	11
2261519	User_interface_design	201205	2	0	0	0	2	0	0	0	274	163	39	165	82	11
2261519	User_interface_design	201206	5	0	0	0	4	3	0	0	279	167	39	168	85	11
2261519	User_interface_design	201207	1	0	0	0	1	1	0	0	280	168	39	169	86	11
2261519	User_interface_design	201208	6	1	0	0	5	1	1	0	286	172	40	170	86	11
2261519	User_interface_design	201210	3	2	0	0	3	2	2	0	289	173	42	172	86	11
2261519	User_interface_design	201211	1	0	0	0	1	0	0	0	290	174	42	172	86	11
2261519	User_interface_design	201212	3	1	0	0	3	2	1	0	293	176	43	174	87	11
2261519	User_interface_design	201301	2	0	0	0	2	2	0	0	295	178	43	176	89	11
2261519	User_interface_design	201302	3	1	0	0	3	2	1	0	298	181	44	178	91	11
2261519	User_interface_design	201303	2	0	0	0	1	0	0	0	300	182	44	178	91	11
2261519	User_interface_design	201304	2	0	0	0	2	2	0	0	302	184	44	180	93	11
2261519	User_interface_design	201305	3	1	0	0	3	2	1	0	305	186	45	182	94	11
2261519	User_interface_design	201306	17	0	0	0	2	1	0	0	322	188	45	198	95	11
2261519	User_interface_design	201307	2	0	0	0	2	1	0	0	324	190	45	199	96	11
2261519	User_interface_design	201308	4	0	0	0	1	1	0	0	328	191	45	203	97	11
2261519	User_interface_design	201310	9	2	0	0	7	4	2	0	337	196	47	208	99	11
2261519	User_interface_design	201311	4	1	0	0	3	1	1	0	341	198	48	209	99	11
2261519	User_interface_design	201312	5	0	0	0	3	1	0	0	346	201	48	210	100	11
2261519	User_interface_design	201401	3	2	1	0	2	2	2	1	349	202	50	213	101	13
2261519	User_interface_design	201402	1	0	0	0	1	1	0	0	350	202	50	214	101	13
2261519	User_interface_design	201403	1	0	0	0	1	0	0	0	351	203	50	214	101	13
2261519	User_interface_design	201404	2	1	0	0	2	1	1	0	353	204	51	215	101	13
2261519	User_interface_design	201409	8	2	0	0	4	4	1	0	361	207	53	223	104	15
2261519	User_interface_design	201410	5	2	0	0	3	3	2	0	366	209	55	228	106	17
2261519	User_interface_design	201411	5	1	0	0	4	2	1	0	371	213	56	230	108	17
2261519	User_interface_design	201501	2	0	0	0	1	0	0	0	373	214	56	230	108	17
2261519	User_interface_design	201502	3	0	0	0	2	0	0	0	376	216	56	230	108	17
2261519	User_interface_design	201503	4	0	0	0	3	3	0	0	380	219	56	234	111	17
2261519	User_interface_design	201504	2	0	0	0	2	2	0	0	382	220	56	236	112	17
2261519	User_interface_design	201505	4	1	0	0	4	3	1	0	386	224	57	239	115	17
2261519	User_interface_design	201506	1	0	0	0	1	0	0	0	387	225	57	239	115	17
2261519	User_interface_design	201510	2	1	0	0	2	2	1	0	389	226	58	241	116	18
2261519	User_interface_design	201602	5	2	0	0	4	2	2	0	394	229	60	243	117	18
2261519	User_interface_design	201603	1	0	0	0	1	1	0	0	395	230	60	244	118	18
2261519	User_interface_design	201604	4	2	0	0	4	3	2	0	399	232	62	247	119	19
2261519	User_interface_design	201605	2	1	0	0	2	2	1	0	401	233	63	249	120	20
2261519	User_interface_design	201607	2	1	0	0	2	2	1	0	403	235	64	251	122	21
2261519	User_interface_design	201608	1	0	0	0	1	1	0	0	404	236	64	252	123	21
2261519	User_interface_design	201610	3	1	0	0	3	2	1	0	407	238	65	254	124	21
2261519	User_interface_design	201612	2	1	0	0	2	1	1	0	409	240	66	255	125	21
2261519	User_interface_design	201701	4	2	0	0	4	2	2	0	413	243	68	257	126	21
2261519	User_interface_design	201702	2	0	0	0	2	2	0	0	415	245	68	259	128	21
2261519	User_interface_design	201703	8	2	0	0	7	6	2	0	423	251	70	266	133	22
2261519	User_interface_design	201704	2	0	0	0	2	2	0	0	425	252	70	268	134	22
2261519	User_interface_design	201707	1	0	0	0	1	1	0	0	426	253	70	269	135	22
2261519	User_interface_design	201708	1	0	0	0	1	1	0	0	427	254	70	270	136	22
2261519	User_interface_design	201711	5	2	0	0	3	3	1	0	432	257	72	275	139	24
2261519	User_interface_design	201712	2	1	0	0	2	2	1	0	434	258	73	277	140	25
2261519	User_interface_design	201806	1	0	0	0	1	1	0	0	435	259	73	278	141	25
2261519	User_interface_design	201807	3	0	0	0	2	2	0	0	438	260	73	281	142	25
2389387	Value-added_service	200510	2	0	0	0	1	1	0	0	2	1	0	2	1	0
2389387	Value-added_service	200601	1	0	0	0	1	1	0	0	3	2	0	3	2	0
2389387	Value-added_service	200605	1	0	0	0	1	0	0	0	4	3	0	3	2	0
2389387	Value-added_service	200607	1	0	0	0	1	1	0	0	5	4	0	4	3	0
2389387	Value-added_service	200608	4	1	0	0	2	2	1	0	9	6	1	8	5	1
2389387	Value-added_service	200611	1	0	0	0	1	1	0	0	10	7	1	9	6	1
2389387	Value-added_service	200612	2	0	0	0	2	1	0	0	12	9	1	10	7	1
2389387	Value-added_service	200702	1	0	0	0	1	0	0	0	13	10	1	10	7	1
2389387	Value-added_service	200703	1	0	0	0	1	0	0	0	14	11	1	10	7	1
2389387	Value-added_service	200707	2	0	0	0	2	2	0	0	16	13	1	12	9	1
2389387	Value-added_service	200710	6	1	0	0	4	3	1	0	22	17	2	17	12	2
2389387	Value-added_service	200711	10	0	0	0	5	2	0	0	32	22	2	23	14	2
2389387	Value-added_service	200712	7	0	0	0	3	2	0	0	39	25	2	27	16	2
2389387	Value-added_service	200802	3	0	0	0	3	2	0	0	42	26	2	29	16	2
2389387	Value-added_service	200803	1	0	0	0	1	1	0	0	43	27	2	30	17	2
2389387	Value-added_service	200804	2	1	0	0	2	1	1	0	45	28	3	31	17	2
2389387	Value-added_service	200806	1	0	0	0	1	1	0	0	46	29	3	32	18	2
2389387	Value-added_service	200810	1	0	0	0	1	1	0	0	47	30	3	33	19	2
2389387	Value-added_service	200811	3	0	0	0	1	0	0	0	50	31	3	33	19	2
2389387	Value-added_service	200905	2	1	0	0	2	1	1	0	52	33	4	34	20	2
2389387	Value-added_service	200909	1	0	0	0	1	0	0	0	53	34	4	34	20	2
2389387	Value-added_service	200911	2	1	0	0	2	2	1	0	55	35	5	36	21	3
2389387	Value-added_service	201002	1	0	0	0	1	0	0	0	56	36	5	36	21	3
2389387	Value-added_service	201003	3	0	0	0	3	3	0	0	59	39	5	39	24	3
2389387	Value-added_service	201004	2	0	0	0	2	1	0	0	61	41	5	40	25	3
2389387	Value-added_service	201005	1	0	0	0	1	1	0	0	62	42	5	41	26	3
2389387	Value-added_service	201008	1	0	0	0	1	1	0	0	63	43	5	42	27	3
2389387	Value-added_service	201009	2	0	0	0	2	1	0	0	65	45	5	43	28	3
2389387	Value-added_service	201010	2	0	0	0	2	0	0	0	67	47	5	43	28	3
2389387	Value-added_service	201012	1	0	0	0	1	1	0	0	68	48	5	44	29	3
2389387	Value-added_service	201101	1	0	0	0	1	1	0	0	69	49	5	45	30	3
2389387	Value-added_service	201103	2	0	0	0	1	1	0	0	71	50	5	47	31	3
2389387	Value-added_service	201104	1	0	0	0	1	1	0	0	72	51	5	48	32	3
2389387	Value-added_service	201105	2	0	0	0	1	1	0	0	74	52	5	50	33	3
2389387	Value-added_service	201106	2	0	0	0	2	2	0	0	76	53	5	52	34	3
2389387	Value-added_service	201109	3	0	0	0	3	2	0	0	79	56	5	54	36	3
2389387	Value-added_service	201111	1	0	0	0	1	1	0	0	80	57	5	55	37	3
2389387	Value-added_service	201201	2	0	0	0	1	1	0	0	82	58	5	57	38	3
2389387	Value-added_service	201202	1	0	0	0	1	0	0	0	83	59	5	57	38	3
2389387	Value-added_service	201203	3	0	0	0	2	1	0	0	86	61	5	59	39	3
2389387	Value-added_service	201204	6	0	0	0	4	3	0	0	92	64	5	64	41	3
2389387	Value-added_service	201205	2	1	0	0	2	1	1	0	94	66	6	65	42	3
2389387	Value-added_service	201206	1	0	0	0	1	1	0	0	95	67	6	66	43	3
2389387	Value-added_service	201207	1	0	0	0	1	1	0	0	96	68	6	67	44	3
2389387	Value-added_service	201209	2	1	0	0	2	2	1	0	98	70	7	69	46	4
2389387	Value-added_service	201210	1	0	0	0	1	0	0	0	99	71	7	69	46	4
2389387	Value-added_service	201301	1	0	0	0	1	0	0	0	100	71	7	69	46	4
2389387	Value-added_service	201302	1	0	0	0	1	0	0	0	101	72	7	69	46	4
2389387	Value-added_service	201303	1	0	0	0	1	0	0	0	102	73	7	69	46	4
2389387	Value-added_service	201304	1	0	0	0	1	1	0	0	103	74	7	70	47	4
2389387	Value-added_service	201305	1	0	0	0	1	1	0	0	104	75	7	71	48	4
2389387	Value-added_service	201306	3	0	0	0	3	2	0	0	107	78	7	73	50	4
2389387	Value-added_service	201307	2	0	0	0	2	2	0	0	109	78	7	75	50	4
2389387	Value-added_service	201310	2	1	0	0	2	1	1	0	111	80	8	76	51	4
2389387	Value-added_service	201401	1	0	0	0	1	0	0	0	112	81	8	76	51	4
2389387	Value-added_service	201402	5	0	0	0	3	2	0	0	117	84	8	80	53	4
2389387	Value-added_service	201403	2	0	0	0	1	0	0	0	119	84	8	80	53	4
2389387	Value-added_service	201404	3	1	0	0	3	1	1	0	122	86	9	81	54	4
2389387	Value-added_service	201405	5	0	0	0	4	0	0	0	127	90	9	81	54	4
2389387	Value-added_service	201406	5	1	0	0	5	4	1	0	132	94	10	85	57	5
2389387	Value-added_service	201407	15	0	0	0	13	1	0	0	147	106	10	86	57	5
2389387	Value-added_service	201408	6	0	0	0	5	1	0	0	153	111	10	87	58	5
2389387	Value-added_service	201409	4	0	0	0	4	0	0	0	157	115	10	87	58	5
2389387	Value-added_service	201410	2	0	0	0	2	0	0	0	159	117	10	87	58	5
2389387	Value-added_service	201411	6	0	0	0	3	1	0	0	165	120	10	89	59	5
2389387	Value-added_service	201412	7	0	0	0	3	0	0	0	172	122	10	89	59	5
2389387	Value-added_service	201501	11	1	0	0	4	2	1	0	183	126	11	93	61	6
2389387	Value-added_service	201502	5	1	0	0	5	3	1	0	188	131	12	96	64	6
2389387	Value-added_service	201505	9	0	0	0	7	3	0	0	197	137	12	99	66	6
2389387	Value-added_service	201506	2	0	0	0	2	0	0	0	199	139	12	99	66	6
2389387	Value-added_service	201508	1	0	0	0	1	1	0	0	200	140	12	100	67	6
2389387	Value-added_service	201511	1	0	0	0	1	0	0	0	201	141	12	100	67	6
2389387	Value-added_service	201512	2	0	0	0	2	2	0	0	203	143	12	102	69	6
2389387	Value-added_service	201602	5	0	0	0	3	0	0	0	208	146	12	102	69	6
2389387	Value-added_service	201603	4	0	0	0	1	1	0	0	212	147	12	106	70	6
2389387	Value-added_service	201606	1	0	0	0	1	0	0	0	213	148	12	106	70	6
2389387	Value-added_service	201607	2	0	0	0	2	2	0	0	215	150	12	108	72	6
2389387	Value-added_service	201610	1	0	0	0	1	0	0	0	216	151	12	108	72	6
2389387	Value-added_service	201611	6	1	0	0	3	1	1	0	222	154	13	109	73	6
2389387	Value-added_service	201612	2	1	0	0	2	2	1	0	224	156	14	111	75	7
2389387	Value-added_service	201703	3	1	0	0	3	2	1	0	227	158	15	113	76	7
2389387	Value-added_service	201705	6	0	0	0	3	1	0	0	233	161	15	117	76	7
2389387	Value-added_service	201707	1	0	0	0	1	0	0	0	234	162	15	117	76	7
2389387	Value-added_service	201708	5	0	0	0	3	0	0	0	239	165	15	117	76	7
2389387	Value-added_service	201709	3	0	0	0	2	1	0	0	242	167	15	119	77	7
2389387	Value-added_service	201710	3	0	0	0	2	1	0	0	245	168	15	120	77	7
2389387	Value-added_service	201711	2	0	0	0	2	0	0	0	247	170	15	120	77	7
7710753	Vehicle-to-vehicle	200611	3	0	0	0	1	1	0	0	3	1	0	3	1	0
7710753	Vehicle-to-vehicle	200612	1	0	0	0	1	1	0	0	4	2	0	4	2	0
7710753	Vehicle-to-vehicle	200701	1	0	0	0	1	1	0	0	5	3	0	5	3	0
7710753	Vehicle-to-vehicle	200705	1	0	0	0	1	1	0	0	6	4	0	6	4	0
7710753	Vehicle-to-vehicle	200711	1	0	0	0	1	1	0	0	7	5	0	7	5	0
7710753	Vehicle-to-vehicle	200712	10	0	0	0	1	1	0	0	17	6	0	17	6	0
7710753	Vehicle-to-vehicle	200803	1	0	0	0	1	1	0	0	18	7	0	18	7	0
7710753	Vehicle-to-vehicle	200806	2	0	0	0	1	0	0	0	20	8	0	18	7	0
7710753	Vehicle-to-vehicle	200809	1	0	0	0	1	1	0	0	21	9	0	19	8	0
7710753	Vehicle-to-vehicle	200905	2	0	0	0	2	1	0	0	23	11	0	20	9	0
7710753	Vehicle-to-vehicle	200909	3	1	0	0	2	1	1	0	26	13	1	21	10	0
7710753	Vehicle-to-vehicle	200910	1	0	0	0	1	1	0	0	27	14	1	22	11	0
7710753	Vehicle-to-vehicle	201004	2	1	0	0	2	1	1	0	29	16	2	23	12	0
7710753	Vehicle-to-vehicle	201404	1	0	0	0	1	1	0	0	30	17	2	24	13	0
7710753	Vehicle-to-vehicle	201501	5	0	0	0	3	3	0	0	35	20	2	29	16	0
7710753	Vehicle-to-vehicle	201507	2	0	0	0	2	2	0	0	37	22	2	31	18	0
7710753	Vehicle-to-vehicle	201508	1	0	0	0	1	1	0	0	38	23	2	32	19	0
7710753	Vehicle-to-vehicle	201601	1	0	0	0	1	1	0	0	39	24	2	33	20	0
7710753	Vehicle-to-vehicle	201604	1	0	0	0	1	1	0	0	40	25	2	34	21	0
7710753	Vehicle-to-vehicle	201606	4	0	0	0	1	0	0	0	44	26	2	34	21	0
7710753	Vehicle-to-vehicle	201608	1	0	0	0	1	1	0	0	45	27	2	35	22	0
7710753	Vehicle-to-vehicle	201610	1	0	0	0	1	1	0	0	46	28	2	36	23	0
7710753	Vehicle-to-vehicle	201612	5	0	0	0	4	4	0	0	51	32	2	41	27	0
7710753	Vehicle-to-vehicle	201701	7	0	0	0	3	3	0	0	58	35	2	48	30	0
7710753	Vehicle-to-vehicle	201702	1	0	0	0	1	1	0	0	59	36	2	49	31	0
7710753	Vehicle-to-vehicle	201703	1	0	0	0	1	1	0	0	60	37	2	50	32	0
7710753	Vehicle-to-vehicle	201705	2	0	0	0	1	0	0	0	62	38	2	50	32	0
7710753	Vehicle-to-vehicle	201706	1	0	0	0	1	0	0	0	63	39	2	50	32	0
7710753	Vehicle-to-vehicle	201707	1	0	0	0	1	1	0	0	64	40	2	51	33	0
7710753	Vehicle-to-vehicle	201708	1	0	0	0	1	1	0	0	65	41	2	52	34	0
7710753	Vehicle-to-vehicle	201806	1	1	0	0	1	1	1	0	66	42	3	53	35	1
7710753	Vehicle-to-vehicle	201807	1	0	0	0	1	1	0	0	67	43	3	54	36	1
5071866	Vehicular_automation	200606	13	0	0	0	3	3	0	0	13	3	0	13	3	0
5071866	Vehicular_automation	200607	2	0	0	0	1	1	0	0	15	4	0	15	4	0
5071866	Vehicular_automation	200609	2	0	0	0	2	2	0	0	17	6	0	17	6	0
5071866	Vehicular_automation	200610	1	0	0	0	1	1	0	0	18	7	0	18	7	0
5071866	Vehicular_automation	200912	2	0	0	0	2	2	0	0	20	8	0	20	8	0
5071866	Vehicular_automation	201001	9	4	1	0	6	5	4	1	29	14	4	27	13	3
5071866	Vehicular_automation	201004	3	1	0	0	3	0	1	0	32	17	5	27	13	3
5071866	Vehicular_automation	201006	1	0	0	0	1	0	0	0	33	18	5	27	13	3
5071866	Vehicular_automation	201008	1	0	0	0	1	1	0	0	34	19	5	28	14	3
5071866	Vehicular_automation	201009	2	1	0	0	2	2	1	0	36	21	6	30	16	4
5071866	Vehicular_automation	201101	1	0	0	0	1	1	0	0	37	22	6	31	17	4
5071866	Vehicular_automation	201104	1	0	0	0	1	1	0	0	38	23	6	32	18	4
5071866	Vehicular_automation	201105	1	0	0	0	1	1	0	0	39	24	6	33	19	4
5071866	Vehicular_automation	201108	2	1	0	0	2	1	1	0	41	25	7	34	19	4
5071866	Vehicular_automation	201110	1	0	0	0	1	1	0	0	42	26	7	35	20	4
5071866	Vehicular_automation	201112	6	0	0	0	2	1	0	0	48	28	7	39	21	4
5071866	Vehicular_automation	201201	1	0	0	0	1	1	0	0	49	29	7	40	22	4
5071866	Vehicular_automation	201202	2	0	0	0	1	1	0	0	51	29	7	42	22	4
5071866	Vehicular_automation	201206	1	0	0	0	1	1	0	0	52	30	7	43	23	4
5071866	Vehicular_automation	201207	18	0	0	0	3	3	0	0	70	32	7	61	25	4
5071866	Vehicular_automation	201208	1	0	0	0	1	1	0	0	71	33	7	62	26	4
5071866	Vehicular_automation	201211	5	0	0	0	2	2	0	0	76	35	7	67	28	4
5071866	Vehicular_automation	201212	3	0	0	0	2	2	0	0	79	36	7	70	29	4
5071866	Vehicular_automation	201301	2	0	0	0	2	1	0	0	81	38	7	71	30	4
5071866	Vehicular_automation	201303	2	1	0	0	2	2	1	0	83	40	8	73	32	5
5071866	Vehicular_automation	201305	2	0	0	0	2	1	0	0	85	42	8	74	33	5
5071866	Vehicular_automation	201306	1	0	0	0	1	1	0	0	86	43	8	75	34	5
5071866	Vehicular_automation	201307	1	0	0	0	1	0	0	0	87	44	8	75	34	5
5071866	Vehicular_automation	201309	3	0	0	0	2	2	0	0	90	46	8	78	36	5
5071866	Vehicular_automation	201310	1	0	0	0	1	1	0	0	91	47	8	79	37	5
5071866	Vehicular_automation	201311	3	1	0	0	2	1	1	0	94	49	9	80	38	5
5071866	Vehicular_automation	201401	1	0	0	0	1	1	0	0	95	50	9	81	39	5
5071866	Vehicular_automation	201403	1	0	0	0	1	1	0	0	96	51	9	82	40	5
5071866	Vehicular_automation	201408	1	0	0	0	1	1	0	0	97	52	9	83	41	5
5071866	Vehicular_automation	201411	1	0	0	0	1	1	0	0	98	53	9	84	42	5
5071866	Vehicular_automation	201502	1	0	0	0	1	1	0	0	99	54	9	85	43	5
5071866	Vehicular_automation	201503	1	0	0	0	1	0	0	0	100	55	9	85	43	5
5071866	Vehicular_automation	201506	3	0	0	0	3	3	0	0	103	58	9	88	46	5
5071866	Vehicular_automation	201507	3	0	0	0	3	2	0	0	106	61	9	90	48	5
5071866	Vehicular_automation	201509	1	0	0	0	1	1	0	0	107	62	9	91	49	5
5071866	Vehicular_automation	201511	6	0	0	0	3	1	0	0	113	65	9	94	50	5
5071866	Vehicular_automation	201512	1	0	0	0	1	1	0	0	114	66	9	95	51	5
5071866	Vehicular_automation	201602	1	0	0	0	1	1	0	0	115	67	9	96	52	5
5071866	Vehicular_automation	201603	1	0	0	0	1	0	0	0	116	68	9	96	52	5
5071866	Vehicular_automation	201604	1	0	0	0	1	1	0	0	117	69	9	97	53	5
5071866	Vehicular_automation	201605	2	0	0	0	2	1	0	0	119	71	9	98	54	5
5071866	Vehicular_automation	201606	4	0	0	0	2	0	0	0	123	73	9	98	54	5
5071866	Vehicular_automation	201608	2	0	0	0	2	2	0	0	125	75	9	100	56	5
5071866	Vehicular_automation	201610	4	0	0	0	2	2	0	0	129	77	9	104	58	5
5071866	Vehicular_automation	201703	1	0	0	0	1	1	0	0	130	78	9	105	59	5
5071866	Vehicular_automation	201708	3	1	0	0	3	3	1	0	133	80	10	108	61	6
5071866	Vehicular_automation	201709	1	0	0	0	1	1	0	0	134	81	10	109	62	6
5071866	Vehicular_automation	201710	16	0	0	0	2	2	0	0	150	82	10	125	63	6
5071866	Vehicular_automation	201711	9	0	0	0	1	1	0	0	159	82	10	134	63	6
5071866	Vehicular_automation	201712	4	0	0	0	3	3	0	0	163	84	10	138	65	6
5071866	Vehicular_automation	201802	12	0	0	0	1	1	0	0	175	84	10	150	65	6
5071866	Vehicular_automation	201803	1	0	0	0	1	1	0	0	176	84	10	151	65	6
5071866	Vehicular_automation	201805	6	0	0	0	4	4	0	0	182	87	10	157	68	6
5071866	Vehicular_automation	201806	22	0	0	0	7	5	0	0	204	94	10	172	73	6
5071866	Vehicular_automation	201807	4	0	0	0	2	2	0	0	208	96	10	176	75	6
101416	Virtual_LAN	200304	7	0	0	0	2	2	0	0	7	2	0	7	2	0
101416	Virtual_LAN	200308	2	0	0	0	2	1	0	0	9	4	0	8	3	0
101416	Virtual_LAN	200309	1	0	0	0	1	0	0	0	10	5	0	8	3	0
101416	Virtual_LAN	200403	1	0	0	0	1	1	0	0	11	6	0	9	4	0
101416	Virtual_LAN	200404	1	0	0	0	1	0	0	0	12	7	0	9	4	0
101416	Virtual_LAN	200407	2	0	0	0	2	2	0	0	14	9	0	11	6	0
101416	Virtual_LAN	200409	1	0	0	0	1	1	0	0	15	10	0	12	7	0
101416	Virtual_LAN	200410	3	0	0	0	3	0	0	0	18	13	0	12	7	0
101416	Virtual_LAN	200411	3	0	0	0	3	3	0	0	21	16	0	15	10	0
101416	Virtual_LAN	200412	4	0	0	0	3	1	0	0	25	19	0	16	11	0
101416	Virtual_LAN	200501	2	0	0	0	2	2	0	0	27	21	0	18	13	0
101416	Virtual_LAN	200502	2	0	0	0	2	1	0	0	29	23	0	19	14	0
101416	Virtual_LAN	200503	1	0	0	0	1	0	0	0	30	24	0	19	14	0
101416	Virtual_LAN	200504	2	0	0	0	2	0	0	0	32	26	0	19	14	0
101416	Virtual_LAN	200505	1	0	0	0	1	0	0	0	33	27	0	19	14	0
101416	Virtual_LAN	200506	5	0	0	0	4	1	0	0	38	31	0	20	15	0
101416	Virtual_LAN	200507	4	0	0	0	3	2	0	0	42	34	0	23	17	0
101416	Virtual_LAN	200508	2	0	0	0	2	2	0	0	44	36	0	25	19	0
101416	Virtual_LAN	200509	1	0	0	0	1	1	0	0	45	36	0	26	19	0
101416	Virtual_LAN	200511	5	2	0	0	5	2	2	0	50	40	2	28	20	0
101416	Virtual_LAN	200512	1	0	0	0	1	0	0	0	51	41	2	28	20	0
101416	Virtual_LAN	200601	6	0	0	0	5	2	0	0	57	46	2	30	22	0
101416	Virtual_LAN	200602	11	1	0	0	8	3	1	0	68	54	3	35	25	0
101416	Virtual_LAN	200603	6	0	0	0	5	3	0	0	74	59	3	38	28	0
101416	Virtual_LAN	200604	7	1	0	0	5	2	1	0	81	64	4	40	30	0
101416	Virtual_LAN	200605	5	0	0	0	4	2	0	0	86	68	4	43	32	0
101416	Virtual_LAN	200606	12	2	0	0	10	5	2	0	98	77	6	50	36	0
101416	Virtual_LAN	200607	6	1	0	0	6	3	1	0	104	83	7	53	39	0
101416	Virtual_LAN	200608	6	0	0	0	4	1	0	0	110	86	7	54	39	0
101416	Virtual_LAN	200609	13	2	0	0	10	4	2	0	123	95	9	58	42	0
101416	Virtual_LAN	200610	14	0	0	0	7	1	0	0	137	102	9	63	43	0
101416	Virtual_LAN	200611	9	2	0	0	6	1	2	0	146	108	11	64	44	0
101416	Virtual_LAN	200612	9	3	0	0	8	2	3	0	155	115	14	66	45	0
101416	Virtual_LAN	200701	5	0	0	0	4	1	0	0	160	119	14	67	46	0
101416	Virtual_LAN	200702	4	1	0	0	2	0	1	0	164	121	15	67	46	0
101416	Virtual_LAN	200703	10	1	0	0	7	4	1	0	174	128	16	71	50	0
101416	Virtual_LAN	200704	9	2	1	0	5	2	2	1	183	132	18	73	51	1
101416	Virtual_LAN	200705	5	0	0	0	4	2	0	0	188	135	18	76	52	1
101416	Virtual_LAN	200706	11	2	0	0	7	4	2	0	199	140	20	81	54	1
101416	Virtual_LAN	200707	7	0	0	0	6	4	0	0	206	145	20	85	57	1
101416	Virtual_LAN	200708	9	1	0	0	6	3	1	0	215	151	21	90	60	1
101416	Virtual_LAN	200709	5	1	0	0	5	2	1	0	220	154	22	92	60	1
101416	Virtual_LAN	200710	16	3	0	0	13	6	2	0	236	165	25	99	64	1
101416	Virtual_LAN	200711	9	0	0	0	8	1	0	0	245	173	25	100	65	1
101416	Virtual_LAN	200712	5	0	0	0	4	1	0	0	250	177	25	102	66	1
101416	Virtual_LAN	200801	15	0	0	0	5	3	0	0	265	182	25	113	69	1
101416	Virtual_LAN	200802	9	1	0	0	6	3	1	0	274	188	26	119	72	1
101416	Virtual_LAN	200803	15	2	0	0	10	6	2	0	289	197	28	125	77	2
101416	Virtual_LAN	200804	7	1	0	0	5	2	1	0	296	200	29	127	78	2
101416	Virtual_LAN	200805	12	5	0	0	8	3	3	0	308	207	34	132	80	3
101416	Virtual_LAN	200806	8	2	0	0	7	3	2	0	316	214	36	135	83	4
101416	Virtual_LAN	200807	19	4	0	0	13	6	4	0	335	226	40	141	88	4
101416	Virtual_LAN	200808	35	6	0	0	18	11	5	0	370	243	46	157	98	5
101416	Virtual_LAN	200809	4	2	0	0	4	1	2	0	374	246	48	158	98	5
101416	Virtual_LAN	200810	7	3	0	0	6	3	3	0	381	251	51	161	100	5
101416	Virtual_LAN	200811	3	0	0	0	3	0	0	0	384	253	51	161	100	5
101416	Virtual_LAN	200812	8	2	0	0	6	2	2	0	392	259	53	163	102	5
101416	Virtual_LAN	200901	2	1	0	0	2	1	1	0	394	261	54	164	103	5
101416	Virtual_LAN	200902	8	0	0	0	6	2	0	0	402	267	54	166	105	5
101416	Virtual_LAN	200903	12	3	0	0	9	1	3	0	414	275	57	167	105	5
101416	Virtual_LAN	200904	5	1	0	0	4	1	1	0	419	278	58	168	105	5
101416	Virtual_LAN	200905	7	2	0	0	7	3	2	0	426	285	60	171	108	5
101416	Virtual_LAN	200906	10	3	0	0	9	5	2	0	436	292	63	177	111	6
101416	Virtual_LAN	200907	9	0	0	0	6	3	0	0	445	298	63	181	114	6
101416	Virtual_LAN	200908	4	0	0	0	3	0	0	0	449	301	63	181	114	6
101416	Virtual_LAN	200909	3	0	0	0	3	0	0	0	452	304	63	181	114	6
101416	Virtual_LAN	200910	3	0	0	0	3	1	0	0	455	307	63	182	115	6
101416	Virtual_LAN	200911	8	3	0	0	8	4	3	0	463	315	66	186	119	7
101416	Virtual_LAN	200912	1	0	0	0	1	1	0	0	464	316	66	187	120	7
101416	Virtual_LAN	201001	12	3	0	0	11	6	3	0	476	327	69	194	126	7
101416	Virtual_LAN	201002	10	2	0	0	8	6	2	0	486	332	71	201	129	7
101416	Virtual_LAN	201003	7	1	0	0	5	3	1	0	493	336	72	205	131	7
101416	Virtual_LAN	201004	14	1	0	0	6	4	1	0	507	341	73	209	134	7
101416	Virtual_LAN	201005	5	1	0	0	4	3	1	0	512	344	74	213	136	7
101416	Virtual_LAN	201006	10	2	0	0	7	4	1	0	522	350	76	219	139	9
101416	Virtual_LAN	201007	11	1	0	0	6	3	1	0	533	355	77	225	141	9
101416	Virtual_LAN	201008	6	1	0	0	6	4	1	0	539	360	78	229	144	9
101416	Virtual_LAN	201009	5	1	0	0	4	1	1	0	544	363	79	230	144	9
101416	Virtual_LAN	201010	6	0	0	0	5	5	0	0	550	368	79	236	149	9
101416	Virtual_LAN	201011	8	1	0	0	8	6	1	0	558	376	80	242	155	9
101416	Virtual_LAN	201012	12	4	0	0	10	5	4	0	570	385	84	247	159	9
101416	Virtual_LAN	201101	11	0	0	0	7	5	0	0	581	390	84	255	162	9
101416	Virtual_LAN	201102	5	1	0	0	5	3	1	0	586	394	85	258	164	9
101416	Virtual_LAN	201103	1	0	0	0	1	1	0	0	587	395	85	259	165	9
101416	Virtual_LAN	201104	12	3	0	0	10	5	3	0	599	404	88	264	169	9
101416	Virtual_LAN	201105	15	6	1	0	8	4	3	1	614	410	94	273	171	12
101416	Virtual_LAN	201106	5	2	0	0	5	3	2	0	619	413	96	276	172	12
101416	Virtual_LAN	201107	6	2	0	0	6	3	2	0	625	417	98	279	173	12
101416	Virtual_LAN	201108	7	1	0	0	7	6	1	0	632	423	99	285	178	12
101416	Virtual_LAN	201109	8	3	0	0	7	3	3	0	640	428	102	289	179	12
101416	Virtual_LAN	201110	4	2	0	0	4	2	2	0	644	431	104	291	180	12
101416	Virtual_LAN	201111	3	1	0	0	3	1	1	0	647	434	105	292	181	12
101416	Virtual_LAN	201112	4	0	0	0	3	1	0	0	651	437	105	293	182	12
101416	Virtual_LAN	201201	2	0	0	0	1	0	0	0	653	438	105	293	182	12
101416	Virtual_LAN	201202	14	3	0	0	6	4	2	0	667	443	108	303	185	12
101416	Virtual_LAN	201203	4	1	0	0	4	1	1	0	671	446	109	304	185	12
101416	Virtual_LAN	201204	13	3	0	0	6	2	2	0	684	451	112	310	186	13
101416	Virtual_LAN	201205	5	1	0	0	5	2	1	0	689	456	113	312	188	13
101416	Virtual_LAN	201206	6	1	0	0	4	2	1	0	695	458	114	314	188	13
101416	Virtual_LAN	201207	4	0	0	0	3	1	0	0	699	461	114	315	189	13
101416	Virtual_LAN	201208	26	6	2	1	12	8	5	2	725	469	120	336	193	18
101416	Virtual_LAN	201209	4	1	0	0	4	3	1	0	729	472	121	339	195	18
101416	Virtual_LAN	201210	6	1	0	0	5	4	1	0	735	474	122	344	196	18
101416	Virtual_LAN	201211	12	2	0	0	12	7	2	0	747	484	124	351	201	18
101416	Virtual_LAN	201212	25	7	0	0	12	7	4	0	772	493	131	364	205	19
101416	Virtual_LAN	201301	4	1	0	0	3	3	1	0	776	495	132	368	207	19
101416	Virtual_LAN	201302	3	1	0	0	3	2	1	0	779	497	133	370	208	19
101416	Virtual_LAN	201303	1	0	0	0	1	1	0	0	780	498	133	371	209	19
101416	Virtual_LAN	201304	5	1	0	0	4	2	1	0	785	501	134	373	210	19
101416	Virtual_LAN	201305	4	1	0	0	4	2	1	0	789	504	135	375	211	19
101416	Virtual_LAN	201306	3	1	0	0	3	1	1	0	792	506	136	376	211	19
101416	Virtual_LAN	201307	2	1	0	0	2	1	1	0	794	507	137	377	211	19
101416	Virtual_LAN	201309	12	3	0	0	7	4	2	0	806	511	140	383	212	19
101416	Virtual_LAN	201310	13	3	0	0	6	2	2	0	819	515	143	386	212	19
101416	Virtual_LAN	201311	8	2	0	0	7	5	2	0	827	519	145	392	214	20
101416	Virtual_LAN	201312	8	0	0	0	3	2	0	0	835	521	145	399	215	20
101416	Virtual_LAN	201401	5	1	0	0	5	3	1	0	840	524	146	402	216	20
101416	Virtual_LAN	201402	4	1	0	0	4	2	1	0	844	526	147	404	216	20
101416	Virtual_LAN	201403	4	1	0	0	3	2	1	0	848	528	148	407	217	20
101416	Virtual_LAN	201404	4	2	0	0	4	2	2	0	852	530	150	409	217	20
101416	Virtual_LAN	201405	6	1	0	0	5	3	1	0	858	534	151	412	219	20
101416	Virtual_LAN	201406	9	2	0	0	9	7	2	0	867	540	153	419	223	20
101416	Virtual_LAN	201407	3	1	0	0	3	1	1	0	870	543	154	420	224	20
101416	Virtual_LAN	201408	8	1	0	0	4	1	1	0	878	546	155	423	224	20
101416	Virtual_LAN	201409	3	1	0	0	3	2	1	0	881	548	156	425	225	20
101416	Virtual_LAN	201410	2	1	0	0	2	1	1	0	883	550	157	426	226	20
101416	Virtual_LAN	201411	2	1	0	0	2	1	1	0	885	551	158	427	226	20
101416	Virtual_LAN	201412	5	3	2	1	3	1	2	2	890	554	161	429	227	21
101416	Virtual_LAN	201501	7	1	0	0	4	2	1	0	897	556	162	434	227	21
101416	Virtual_LAN	201502	7	3	0	0	6	2	3	0	904	560	165	436	227	21
101416	Virtual_LAN	201503	1	0	0	0	1	0	0	0	905	561	165	436	227	21
101416	Virtual_LAN	201504	5	0	0	0	4	2	0	0	910	563	165	439	227	21
101416	Virtual_LAN	201506	3	2	0	0	3	2	2	0	913	565	167	441	228	21
101416	Virtual_LAN	201507	4	0	0	0	2	1	0	0	917	566	167	442	228	21
101416	Virtual_LAN	201508	1	0	0	0	1	1	0	0	918	567	167	443	229	21
101416	Virtual_LAN	201509	20	2	0	0	8	6	2	0	938	572	169	456	231	22
101416	Virtual_LAN	201510	2	0	0	0	1	1	0	0	940	573	169	458	232	22
101416	Virtual_LAN	201511	4	1	0	0	3	1	1	0	944	575	170	459	232	22
101416	Virtual_LAN	201512	1	0	0	0	1	0	0	0	945	576	170	459	232	22
101416	Virtual_LAN	201601	3	1	0	0	3	1	1	0	948	578	171	460	232	22
101416	Virtual_LAN	201603	1	0	0	0	1	0	0	0	949	579	171	460	232	22
101416	Virtual_LAN	201605	2	1	0	0	2	1	1	0	951	580	172	461	232	22
101416	Virtual_LAN	201606	3	1	0	0	3	3	1	0	954	583	173	464	235	23
101416	Virtual_LAN	201607	2	0	0	0	1	0	0	0	956	584	173	464	235	23
101416	Virtual_LAN	201608	10	3	0	0	9	8	3	0	966	590	176	473	240	25
101416	Virtual_LAN	201609	4	1	0	0	4	3	1	0	970	592	177	476	241	25
101416	Virtual_LAN	201610	14	1	0	0	7	5	1	0	984	596	178	488	243	25
101416	Virtual_LAN	201611	6	1	0	0	5	4	1	0	990	598	179	493	244	25
101416	Virtual_LAN	201612	1	0	0	0	1	1	0	0	991	599	179	494	245	25
101416	Virtual_LAN	201701	2	1	0	0	2	1	1	0	993	601	180	495	246	25
101416	Virtual_LAN	201702	8	2	0	0	7	6	2	0	1001	606	182	501	249	25
101416	Virtual_LAN	201703	5	1	0	0	4	2	1	0	1006	609	183	503	250	26
101416	Virtual_LAN	201704	4	1	0	0	3	1	1	0	1010	612	184	504	251	26
101416	Virtual_LAN	201705	7	0	0	0	3	3	0	0	1017	614	184	511	253	26
101416	Virtual_LAN	201706	5	0	0	0	4	2	0	0	1022	616	184	514	253	26
101416	Virtual_LAN	201707	5	1	0	0	4	4	1	0	1027	617	185	519	254	27
101416	Virtual_LAN	201708	5	1	0	0	4	2	1	0	1032	620	186	522	255	27
101416	Virtual_LAN	201709	1	0	0	0	1	1	0	0	1033	620	186	523	255	27
101416	Virtual_LAN	201710	1	0	0	0	1	1	0	0	1034	621	186	524	256	27
101416	Virtual_LAN	201711	4	0	0	0	2	1	0	0	1038	622	186	526	256	27
101416	Virtual_LAN	201712	5	0	0	0	3	2	0	0	1043	624	186	529	257	27
101416	Virtual_LAN	201801	4	1	0	0	4	3	1	0	1047	626	187	532	258	27
101416	Virtual_LAN	201802	7	2	0	0	6	3	2	0	1054	630	189	536	259	27
101416	Virtual_LAN	201803	1	0	0	0	1	0	0	0	1055	631	189	536	259	27
101416	Virtual_LAN	201804	2	0	0	0	2	2	0	0	1057	632	189	538	260	27
101416	Virtual_LAN	201805	7	2	0	0	4	2	2	0	1064	635	191	540	261	28
101416	Virtual_LAN	201806	2	0	0	0	2	2	0	0	1066	636	191	542	262	28
101416	Virtual_LAN	201807	5	1	0	0	4	3	1	0	1071	637	192	546	262	28
6796824	Virtual_currency	201005	1	0	0	0	1	1	0	0	1	1	0	1	1	0
6796824	Virtual_currency	201006	15	0	0	0	6	4	0	0	16	7	0	13	5	0
6796824	Virtual_currency	201007	3	0	0	0	3	2	0	0	19	9	0	15	7	0
6796824	Virtual_currency	201008	6	1	0	0	6	6	1	0	25	15	1	21	13	1
6796824	Virtual_currency	201009	3	0	0	0	2	1	0	0	28	17	1	23	14	1
6796824	Virtual_currency	201010	3	0	0	0	2	2	0	0	31	19	1	26	16	1
6796824	Virtual_currency	201012	2	0	0	0	2	2	0	0	33	20	1	28	17	1
6796824	Virtual_currency	201101	6	0	0	0	3	3	0	0	39	22	1	34	19	1
6796824	Virtual_currency	201102	2	0	0	0	1	0	0	0	41	23	1	34	19	1
6796824	Virtual_currency	201103	3	1	0	0	3	1	1	0	44	26	2	35	20	1
6796824	Virtual_currency	201104	2	0	0	0	2	2	0	0	46	28	2	37	22	1
6796824	Virtual_currency	201105	1	0	0	0	1	1	0	0	47	29	2	38	23	1
6796824	Virtual_currency	201106	2	0	0	0	2	2	0	0	49	29	2	40	23	1
6796824	Virtual_currency	201107	10	1	0	0	7	7	1	0	59	35	3	50	29	2
6796824	Virtual_currency	201109	9	1	0	0	7	3	1	0	68	41	4	54	31	3
6796824	Virtual_currency	201110	3	0	0	0	3	2	0	0	71	43	4	56	32	3
6796824	Virtual_currency	201111	4	0	0	0	4	1	0	0	75	47	4	57	33	3
6796824	Virtual_currency	201202	1	0	0	0	1	1	0	0	76	48	4	58	34	3
6796824	Virtual_currency	201204	3	0	0	0	1	1	0	0	79	48	4	61	34	3
6796824	Virtual_currency	201205	1	0	0	0	1	1	0	0	80	48	4	62	34	3
6796824	Virtual_currency	201206	3	0	0	0	2	0	0	0	83	50	4	62	34	3
6796824	Virtual_currency	201208	1	0	0	0	1	1	0	0	84	50	4	63	34	3
6796824	Virtual_currency	201209	5	0	0	0	3	2	0	0	89	52	4	67	35	3
6796824	Virtual_currency	201210	1	0	0	0	1	0	0	0	90	53	4	67	35	3
6796824	Virtual_currency	201212	3	0	0	0	2	2	0	0	93	55	4	70	37	3
6796824	Virtual_currency	201301	1	1	0	0	1	1	1	0	94	56	5	71	38	4
6796824	Virtual_currency	201302	2	0	0	0	1	1	0	0	96	56	5	73	38	4
6796824	Virtual_currency	201306	16	3	1	0	3	3	3	1	112	59	8	89	41	7
6796824	Virtual_currency	201311	1	1	0	0	1	1	1	0	113	60	9	90	42	8
6796824	Virtual_currency	201312	1	0	0	0	1	0	0	0	114	61	9	90	42	8
6796824	Virtual_currency	201401	7	0	0	0	3	3	0	0	121	64	9	97	45	8
6796824	Virtual_currency	201402	3	0	0	0	3	2	0	0	124	66	9	99	46	8
6796824	Virtual_currency	201403	1	1	0	0	1	1	1	0	125	67	10	100	47	9
6796824	Virtual_currency	201404	24	0	0	0	4	2	0	0	149	71	10	120	49	9
6796824	Virtual_currency	201405	16	1	0	0	7	5	1	0	165	77	11	132	53	9
6796824	Virtual_currency	201406	24	1	0	0	7	7	1	0	189	82	12	156	58	10
6796824	Virtual_currency	201407	1	0	0	0	1	1	0	0	190	83	12	157	59	10
6796824	Virtual_currency	201408	14	0	0	0	3	1	0	0	204	85	12	166	59	10
6796824	Virtual_currency	201409	49	0	0	0	3	3	0	0	253	86	12	215	60	10
6796824	Virtual_currency	201410	11	0	0	0	4	2	0	0	264	89	12	222	61	10
6796824	Virtual_currency	201411	25	2	0	0	4	4	1	0	289	91	14	247	63	12
6796824	Virtual_currency	201412	5	0	0	0	3	3	0	0	294	91	14	252	63	12
6796824	Virtual_currency	201502	40	3	0	0	9	6	2	0	334	98	17	289	67	13
6796824	Virtual_currency	201503	20	0	0	0	3	3	0	0	354	99	17	309	68	13
6796824	Virtual_currency	201504	2	0	0	0	2	1	0	0	356	100	17	310	68	13
6796824	Virtual_currency	201505	3	0	0	0	3	2	0	0	359	101	17	312	68	13
6796824	Virtual_currency	201506	3	1	0	0	3	3	1	0	362	103	18	315	70	14
6796824	Virtual_currency	201507	1	0	0	0	1	0	0	0	363	104	18	315	70	14
6796824	Virtual_currency	201508	2	0	0	0	1	0	0	0	365	105	18	315	70	14
6796824	Virtual_currency	201509	2	0	0	0	2	2	0	0	367	107	18	317	72	14
6796824	Virtual_currency	201510	1	0	0	0	1	1	0	0	368	108	18	318	73	14
6796824	Virtual_currency	201601	3	0	0	0	1	1	0	0	371	109	18	321	74	14
6796824	Virtual_currency	201604	2	0	0	0	2	0	0	0	373	111	18	321	74	14
6796824	Virtual_currency	201605	6	0	0	0	4	2	0	0	379	113	18	325	74	14
6796824	Virtual_currency	201606	1	0	0	0	1	1	0	0	380	114	18	326	75	14
6796824	Virtual_currency	201607	2	0	0	0	2	2	0	0	382	115	18	328	76	14
6796824	Virtual_currency	201608	1	0	0	0	1	1	0	0	383	115	18	329	76	14
6796824	Virtual_currency	201609	1	0	0	0	1	1	0	0	384	116	18	330	77	14
6796824	Virtual_currency	201610	1	0	0	0	1	0	0	0	385	116	18	330	77	14
6796824	Virtual_currency	201612	1	0	0	0	1	1	0	0	386	116	18	331	77	14
6796824	Virtual_currency	201701	1	0	0	0	1	1	0	0	387	116	18	332	77	14
6796824	Virtual_currency	201703	10	2	0	0	5	5	2	0	397	119	20	342	80	16
6796824	Virtual_currency	201704	3	0	0	0	2	2	0	0	400	120	20	345	81	16
6796824	Virtual_currency	201707	3	1	0	0	3	3	1	0	403	122	21	348	83	17
6796824	Virtual_currency	201708	3	1	0	0	2	2	1	0	406	124	22	351	85	18
6796824	Virtual_currency	201709	2	0	0	0	2	1	0	0	408	125	22	352	85	18
6796824	Virtual_currency	201710	3	1	0	0	3	3	1	0	411	127	23	355	86	19
6796824	Virtual_currency	201711	8	0	0	0	3	3	0	0	419	129	23	363	88	19
6796824	Virtual_currency	201712	1	0	0	0	1	1	0	0	420	130	23	364	89	19
6796824	Virtual_currency	201801	7	1	0	0	6	3	1	0	427	136	24	368	92	19
6796824	Virtual_currency	201802	5	0	0	0	3	3	0	0	432	138	24	373	94	19
6796824	Virtual_currency	201805	5	2	0	0	5	3	2	0	437	143	26	376	96	20
6796824	Virtual_currency	201807	1	0	0	0	1	1	0	0	438	144	26	377	97	20
423777	Virtual_device	200402	4	0	0	0	4	3	0	0	4	4	0	3	3	0
423777	Virtual_device	200406	1	0	0	0	1	1	0	0	5	5	0	4	4	0
423777	Virtual_device	200408	1	0	0	0	1	1	0	0	6	6	0	5	5	0
423777	Virtual_device	200409	1	0	0	0	1	1	0	0	7	7	0	6	6	0
423777	Virtual_device	200411	1	0	0	0	1	1	0	0	8	8	0	7	7	0
423777	Virtual_device	200505	4	0	0	0	3	3	0	0	12	11	0	11	10	0
423777	Virtual_device	200506	1	0	0	0	1	1	0	0	13	12	0	12	11	0
423777	Virtual_device	200611	1	1	0	0	1	1	1	0	14	13	1	13	12	1
423777	Virtual_device	200701	2	0	0	0	2	2	0	0	16	15	1	15	14	1
423777	Virtual_device	200709	1	0	0	0	1	1	0	0	17	16	1	16	15	1
423777	Virtual_device	200711	1	0	0	0	1	1	0	0	18	17	1	17	16	1
423777	Virtual_device	200809	1	0	0	0	1	1	0	0	19	18	1	18	17	1
423777	Virtual_device	200907	1	0	0	0	1	1	0	0	20	19	1	19	18	1
423777	Virtual_device	200912	1	0	0	0	1	1	0	0	21	20	1	20	19	1
423777	Virtual_device	201003	1	0	0	0	1	1	0	0	22	21	1	21	20	1
423777	Virtual_device	201203	1	0	0	0	1	1	0	0	23	22	1	22	21	1
423777	Virtual_device	201301	1	0	0	0	1	1	0	0	24	23	1	23	22	1
423777	Virtual_device	201302	1	0	0	0	1	1	0	0	25	24	1	24	23	1
423777	Virtual_device	201304	1	0	0	0	1	1	0	0	26	24	1	25	23	1
423777	Virtual_device	201306	1	0	0	0	1	1	0	0	27	25	1	26	24	1
423777	Virtual_device	201307	1	0	0	0	1	1	0	0	28	26	1	27	25	1
423777	Virtual_device	201604	4	1	0	0	4	2	1	0	32	30	2	29	27	1
32353	Virtual_machine	200111	1	0	0	0	1	1	0	0	1	1	0	1	1	0
32353	Virtual_machine	200112	5	0	0	0	4	4	0	0	6	5	0	6	5	0
32353	Virtual_machine	200202	3	0	0	0	3	3	0	0	9	6	0	9	6	0
32353	Virtual_machine	200203	4	0	0	0	2	2	0	0	13	8	0	13	7	0
32353	Virtual_machine	200207	2	0	0	0	2	0	0	0	15	10	0	13	7	0
32353	Virtual_machine	200209	1	0	0	0	1	0	0	0	16	11	0	13	7	0
32353	Virtual_machine	200212	2	0	0	0	2	1	0	0	18	13	0	14	8	0
32353	Virtual_machine	200302	1	0	0	0	1	0	0	0	19	14	0	14	8	0
32353	Virtual_machine	200303	1	0	0	0	1	1	0	0	20	15	0	15	9	0
32353	Virtual_machine	200305	1	0	0	0	1	0	0	0	21	16	0	15	9	0
32353	Virtual_machine	200306	2	0	0	0	2	2	0	0	23	18	0	17	11	0
32353	Virtual_machine	200307	1	0	0	0	1	0	0	0	24	19	0	17	11	0
32353	Virtual_machine	200309	1	0	0	0	1	1	0	0	25	20	0	18	12	0
32353	Virtual_machine	200310	14	0	0	0	4	1	0	0	39	24	0	25	13	0
32353	Virtual_machine	200311	1	0	0	0	1	1	0	0	40	25	0	26	14	0
32353	Virtual_machine	200312	3	0	0	0	3	3	0	0	43	26	0	29	15	0
32353	Virtual_machine	200403	1	0	0	0	1	0	0	0	44	27	0	29	15	0
32353	Virtual_machine	200404	1	0	0	0	1	0	0	0	45	28	0	29	15	0
32353	Virtual_machine	200405	7	0	0	0	5	3	0	0	52	33	0	32	18	0
32353	Virtual_machine	200406	4	0	0	0	3	2	0	0	56	36	0	34	20	0
32353	Virtual_machine	200407	6	1	0	0	5	2	1	0	62	41	1	36	22	0
32353	Virtual_machine	200408	4	0	0	0	3	2	0	0	66	44	1	38	24	0
32353	Virtual_machine	200409	5	0	0	0	3	0	0	0	71	47	1	38	24	0
32353	Virtual_machine	200410	11	2	0	0	8	2	2	0	82	54	3	43	26	0
32353	Virtual_machine	200411	1	0	0	0	1	1	0	0	83	55	3	44	27	0
32353	Virtual_machine	200412	5	0	0	0	4	2	0	0	88	59	3	47	29	0
32353	Virtual_machine	200501	3	0	0	0	3	0	0	0	91	62	3	47	29	0
32353	Virtual_machine	200503	12	1	0	0	5	2	1	0	103	67	4	51	31	0
32353	Virtual_machine	200505	2	0	0	0	2	1	0	0	105	69	4	52	32	0
32353	Virtual_machine	200506	4	0	0	0	4	4	0	0	109	73	4	56	36	0
32353	Virtual_machine	200507	10	0	0	0	4	3	0	0	119	77	4	65	39	0
32353	Virtual_machine	200508	3	0	0	0	2	1	0	0	122	79	4	66	40	0
32353	Virtual_machine	200509	11	0	0	0	7	4	0	0	133	84	4	72	42	0
32353	Virtual_machine	200510	14	1	0	0	10	4	1	0	147	94	5	79	46	0
32353	Virtual_machine	200511	16	3	0	0	10	5	1	0	163	102	8	86	49	0
32353	Virtual_machine	200512	12	1	0	0	9	4	1	0	175	110	9	90	52	0
32353	Virtual_machine	200601	16	1	0	0	12	6	1	0	191	121	10	97	57	0
32353	Virtual_machine	200602	30	1	0	0	20	7	1	0	221	138	11	105	62	0
32353	Virtual_machine	200603	11	0	0	0	11	4	0	0	232	148	11	109	65	0
32353	Virtual_machine	200604	18	1	0	0	13	7	1	0	250	160	12	116	71	0
32353	Virtual_machine	200605	26	1	0	0	12	5	1	0	276	171	13	130	75	0
32353	Virtual_machine	200606	13	0	0	0	10	8	0	0	289	179	13	140	81	0
32353	Virtual_machine	200607	24	1	0	0	12	8	1	0	313	187	14	160	85	0
32353	Virtual_machine	200608	9	1	0	0	8	5	1	0	322	194	15	166	89	0
32353	Virtual_machine	200609	11	0	0	0	7	4	0	0	333	199	15	171	92	0
32353	Virtual_machine	200610	11	0	0	0	9	6	0	0	344	206	15	178	97	0
32353	Virtual_machine	200611	13	1	0	0	9	3	1	0	357	213	16	182	99	0
32353	Virtual_machine	200612	12	1	0	0	11	7	1	0	369	224	17	189	106	0
32353	Virtual_machine	200701	24	3	0	0	17	9	3	0	393	240	20	203	114	0
32353	Virtual_machine	200702	16	2	0	0	14	7	2	0	409	253	22	211	120	1
32353	Virtual_machine	200703	19	3	0	0	15	9	3	0	428	267	25	222	128	2
32353	Virtual_machine	200704	13	3	0	0	11	8	2	0	441	275	28	232	133	2
32353	Virtual_machine	200705	12	2	0	0	10	3	2	0	453	283	30	235	134	2
32353	Virtual_machine	200706	11	4	0	0	8	4	3	0	464	290	34	240	137	2
32353	Virtual_machine	200707	14	0	0	0	9	3	0	0	478	299	34	247	140	2
32353	Virtual_machine	200708	8	1	0	0	8	4	1	0	486	305	35	251	142	2
32353	Virtual_machine	200709	11	1	0	0	9	4	1	0	497	314	36	256	146	2
32353	Virtual_machine	200710	11	1	0	0	8	6	1	0	508	321	37	265	151	3
32353	Virtual_machine	200711	19	2	0	0	13	5	2	0	527	333	39	276	155	3
32353	Virtual_machine	200712	14	3	0	0	9	6	2	0	541	342	42	285	161	5
32353	Virtual_machine	200801	4	1	0	0	4	1	1	0	545	346	43	286	162	5
32353	Virtual_machine	200802	21	2	0	0	17	9	2	0	566	360	45	296	169	5
32353	Virtual_machine	200803	10	1	0	0	7	3	1	0	576	366	46	299	171	5
32353	Virtual_machine	200804	13	1	0	0	10	5	1	0	589	373	47	305	173	5
32353	Virtual_machine	200805	13	4	0	0	9	6	2	0	602	381	51	314	178	6
32353	Virtual_machine	200806	12	2	0	0	8	4	2	0	614	387	53	320	180	6
32353	Virtual_machine	200807	3	0	0	0	3	3	0	0	617	389	53	323	182	6
32353	Virtual_machine	200808	17	3	0	0	13	7	3	0	634	400	56	333	187	7
32353	Virtual_machine	200809	10	1	0	0	8	4	1	0	644	407	57	338	190	7
32353	Virtual_machine	200810	17	1	0	0	11	7	1	0	661	416	58	349	195	7
32353	Virtual_machine	200811	15	3	0	0	12	8	3	0	676	424	61	359	199	7
32353	Virtual_machine	200812	9	1	0	0	8	4	1	0	685	431	62	364	202	8
32353	Virtual_machine	200901	26	2	0	0	6	4	1	0	711	434	64	388	203	9
32353	Virtual_machine	200902	8	1	0	0	6	3	1	0	719	438	65	391	204	10
32353	Virtual_machine	200903	6	0	0	0	6	2	0	0	725	442	65	393	204	10
32353	Virtual_machine	200904	4	1	0	0	4	3	1	0	729	444	66	396	205	10
32353	Virtual_machine	200905	46	7	0	0	21	14	7	0	775	462	73	422	216	11
32353	Virtual_machine	200906	5	0	0	0	4	3	0	0	780	465	73	426	218	11
32353	Virtual_machine	200907	7	1	0	0	6	4	1	0	787	468	74	430	219	11
32353	Virtual_machine	200908	10	1	0	0	8	4	1	0	797	475	75	436	222	11
32353	Virtual_machine	200909	12	1	0	0	9	4	1	0	809	482	76	441	224	11
32353	Virtual_machine	200910	14	5	0	0	10	6	3	0	823	490	81	449	228	11
32353	Virtual_machine	200911	7	2	0	0	6	2	2	0	830	494	83	451	228	11
32353	Virtual_machine	200912	9	1	0	0	7	3	1	0	839	500	84	454	230	11
32353	Virtual_machine	201001	13	4	0	0	11	6	3	0	852	509	88	462	234	12
32353	Virtual_machine	201002	12	2	0	0	9	5	2	0	864	517	90	469	238	12
32353	Virtual_machine	201003	8	1	0	0	5	4	1	0	872	519	91	475	239	12
32353	Virtual_machine	201004	7	2	0	0	6	5	2	0	879	523	93	480	242	13
32353	Virtual_machine	201005	15	0	0	0	4	4	0	0	894	526	93	495	245	13
32353	Virtual_machine	201006	9	2	0	0	9	5	2	0	903	535	95	500	250	13
32353	Virtual_machine	201008	10	2	0	0	7	2	2	0	913	541	97	505	252	14
32353	Virtual_machine	201009	5	2	0	0	3	2	1	0	918	544	99	508	254	14
32353	Virtual_machine	201010	3	0	0	0	3	1	0	0	921	547	99	509	255	14
32353	Virtual_machine	201011	6	2	0	0	6	4	2	0	927	551	101	513	257	15
32353	Virtual_machine	201012	8	0	0	0	4	1	0	0	935	555	101	518	258	15
32353	Virtual_machine	201101	15	2	0	0	11	4	2	0	950	565	103	523	261	15
32353	Virtual_machine	201102	10	6	1	0	8	3	5	1	960	570	109	527	261	16
32353	Virtual_machine	201103	4	0	0	0	4	2	0	0	964	574	109	529	263	16
32353	Virtual_machine	201104	11	1	0	0	7	4	1	0	975	579	110	536	265	16
32353	Virtual_machine	201106	1	0	0	0	1	0	0	0	976	580	110	536	265	16
32353	Virtual_machine	201107	6	0	0	0	4	1	0	0	982	584	110	537	266	16
32353	Virtual_machine	201108	9	1	0	0	9	3	1	0	991	592	111	540	268	16
32353	Virtual_machine	201109	9	1	0	0	9	3	1	0	1000	600	112	543	270	16
32353	Virtual_machine	201110	3	0	0	0	3	1	0	0	1003	603	112	544	271	16
32353	Virtual_machine	201111	8	1	0	0	5	3	1	0	1011	607	113	547	273	16
32353	Virtual_machine	201112	3	0	0	0	3	3	0	0	1014	610	113	550	276	16
32353	Virtual_machine	201201	4	0	0	0	4	3	0	0	1018	613	113	553	278	16
32353	Virtual_machine	201202	5	0	0	0	4	2	0	0	1023	617	113	555	280	16
32353	Virtual_machine	201203	3	0	0	0	3	1	0	0	1026	620	113	556	281	16
32353	Virtual_machine	201204	3	1	0	0	3	1	1	0	1029	622	114	557	281	16
32353	Virtual_machine	201205	1	0	0	0	1	0	0	0	1030	623	114	557	281	16
32353	Virtual_machine	201206	5	0	0	0	4	3	0	0	1035	627	114	561	284	16
32353	Virtual_machine	201207	13	3	0	0	8	5	2	0	1048	632	117	569	286	16
32353	Virtual_machine	201208	2	1	0	0	2	1	1	0	1050	634	118	570	287	16
32353	Virtual_machine	201209	5	2	0	0	4	2	2	0	1055	637	120	572	288	16
32353	Virtual_machine	201210	10	4	0	0	10	4	4	0	1065	645	124	576	290	17
32353	Virtual_machine	201211	13	3	0	0	12	6	3	0	1078	655	127	582	294	17
32353	Virtual_machine	201212	5	0	0	0	3	3	0	0	1083	658	127	587	297	17
32353	Virtual_machine	201301	4	0	0	0	4	2	0	0	1087	662	127	589	299	17
32353	Virtual_machine	201302	10	0	0	0	7	4	0	0	1097	668	127	594	302	17
32353	Virtual_machine	201303	9	2	0	0	7	5	1	0	1106	673	129	600	305	17
32353	Virtual_machine	201304	10	1	0	0	6	6	1	0	1116	677	130	610	308	18
32353	Virtual_machine	201305	5	0	0	0	4	1	0	0	1121	681	130	611	309	18
32353	Virtual_machine	201306	5	1	0	0	5	3	1	0	1126	686	131	614	312	18
32353	Virtual_machine	201307	4	0	0	0	4	3	0	0	1130	690	131	617	315	18
32353	Virtual_machine	201308	15	3	0	0	10	4	3	0	1145	700	134	623	319	19
32353	Virtual_machine	201309	2	0	0	0	2	1	0	0	1147	702	134	624	320	19
32353	Virtual_machine	201310	7	1	0	0	5	3	1	0	1154	707	135	627	323	19
32353	Virtual_machine	201311	9	1	0	0	6	4	1	0	1163	711	136	631	325	19
32353	Virtual_machine	201312	5	1	0	0	5	3	1	0	1168	716	137	634	328	19
32353	Virtual_machine	201401	8	2	0	0	8	5	2	0	1176	724	139	639	333	19
32353	Virtual_machine	201402	2	0	0	0	2	0	0	0	1178	726	139	639	333	19
32353	Virtual_machine	201403	17	4	0	0	8	5	3	0	1195	733	143	645	337	19
32353	Virtual_machine	201404	2	0	0	0	2	1	0	0	1197	735	143	646	338	19
32353	Virtual_machine	201405	4	0	0	0	4	1	0	0	1201	739	143	647	339	19
32353	Virtual_machine	201406	5	0	0	0	2	1	0	0	1206	741	143	649	340	19
32353	Virtual_machine	201407	2	1	0	0	2	1	1	0	1208	742	144	650	340	19
32353	Virtual_machine	201408	26	0	0	0	7	6	0	0	1234	748	144	675	344	19
32353	Virtual_machine	201409	10	3	0	0	7	3	2	0	1244	753	147	680	345	19
32353	Virtual_machine	201411	5	2	0	0	4	4	2	0	1249	756	149	685	348	21
32353	Virtual_machine	201501	8	1	0	0	4	3	1	0	1257	758	150	691	349	21
32353	Virtual_machine	201502	1	0	0	0	1	1	0	0	1258	759	150	692	350	21
32353	Virtual_machine	201503	10	3	0	0	7	3	2	0	1268	765	153	696	352	21
32353	Virtual_machine	201504	10	1	0	0	5	4	1	0	1278	769	154	705	355	22
32353	Virtual_machine	201505	8	0	0	0	3	3	0	0	1286	770	154	713	356	22
32353	Virtual_machine	201506	7	2	0	0	5	3	2	0	1293	773	156	716	357	22
32353	Virtual_machine	201507	22	2	0	0	7	6	2	0	1315	775	158	737	358	23
32353	Virtual_machine	201508	7	1	0	0	2	1	1	0	1322	776	159	743	358	23
32353	Virtual_machine	201509	2	0	0	0	2	2	0	0	1324	778	159	745	360	23
32353	Virtual_machine	201510	16	3	0	0	10	6	2	0	1340	786	162	756	364	24
32353	Virtual_machine	201511	9	4	0	0	7	3	2	0	1349	792	166	761	366	25
32353	Virtual_machine	201512	8	0	0	0	5	4	0	0	1357	795	166	768	368	25
32353	Virtual_machine	201601	5	1	0	0	3	2	1	0	1362	797	167	770	369	25
32353	Virtual_machine	201602	17	5	0	0	8	7	3	0	1379	802	172	780	373	26
32353	Virtual_machine	201603	1	0	0	0	1	1	0	0	1380	802	172	781	373	26
32353	Virtual_machine	201604	2	1	0	0	2	1	1	0	1382	804	173	782	374	26
32353	Virtual_machine	201605	4	0	0	0	3	3	0	0	1386	806	173	786	376	26
32353	Virtual_machine	201606	4	2	0	0	4	2	2	0	1390	808	175	788	376	26
32353	Virtual_machine	201607	5	0	0	0	3	3	0	0	1395	810	175	793	378	26
32353	Virtual_machine	201608	23	2	0	0	13	10	2	0	1418	817	177	813	382	28
32353	Virtual_machine	201609	9	3	0	0	8	5	3	0	1427	821	180	819	383	28
32353	Virtual_machine	201610	24	2	0	0	10	4	2	0	1451	829	182	827	385	28
32353	Virtual_machine	201611	2	0	0	0	2	1	0	0	1453	831	182	828	386	28
32353	Virtual_machine	201612	5	1	0	0	5	2	1	0	1458	835	183	830	386	28
32353	Virtual_machine	201701	5	2	0	0	5	3	2	0	1463	838	185	833	387	29
32353	Virtual_machine	201702	2	1	0	0	2	1	1	0	1465	839	186	834	387	29
32353	Virtual_machine	201703	14	4	0	0	11	8	4	0	1479	848	190	843	392	30
32353	Virtual_machine	201704	5	2	0	0	2	1	1	0	1484	850	192	845	393	30
32353	Virtual_machine	201705	6	2	0	0	4	3	2	0	1490	854	194	848	396	31
32353	Virtual_machine	201706	4	1	0	0	3	2	1	0	1494	856	195	850	397	31
32353	Virtual_machine	201707	2	0	0	0	2	2	0	0	1496	858	195	852	399	31
32353	Virtual_machine	201708	2	1	0	0	2	2	1	0	1498	859	196	854	399	32
32353	Virtual_machine	201709	5	1	0	0	4	2	1	0	1503	863	197	856	401	32
32353	Virtual_machine	201710	1	0	0	0	1	1	0	0	1504	864	197	857	402	32
32353	Virtual_machine	201711	4	2	0	0	4	3	2	0	1508	867	199	860	404	33
32353	Virtual_machine	201712	7	1	0	0	4	3	1	0	1515	869	200	866	405	34
32353	Virtual_machine	201801	6	0	0	0	3	3	0	0	1521	871	200	872	407	34
32353	Virtual_machine	201802	2	0	0	0	2	2	0	0	1523	873	200	874	409	34
32353	Virtual_machine	201803	8	2	0	0	7	4	2	0	1531	879	202	879	411	34
32353	Virtual_machine	201804	4	2	0	0	4	2	2	0	1535	883	204	881	413	34
32353	Virtual_machine	201806	6	1	0	0	4	4	1	0	1541	886	205	887	415	35
32353	Virtual_machine	201807	2	1	0	0	2	2	1	0	1543	887	206	889	416	36
147130	Virtual_private_network	200302	5	0	0	0	2	2	0	0	5	2	0	5	2	0
147130	Virtual_private_network	200305	2	0	0	0	1	1	0	0	7	3	0	7	3	0
147130	Virtual_private_network	200306	3	0	0	0	3	2	0	0	10	6	0	9	5	0
147130	Virtual_private_network	200309	4	1	0	0	4	3	1	0	14	10	1	12	8	1
147130	Virtual_private_network	200312	1	0	0	0	1	1	0	0	15	11	1	13	9	1
147130	Virtual_private_network	200401	1	0	0	0	1	1	0	0	16	12	1	14	10	1
147130	Virtual_private_network	200403	1	0	0	0	1	1	0	0	17	13	1	15	11	1
147130	Virtual_private_network	200404	4	0	0	0	3	1	0	0	21	16	1	17	12	1
147130	Virtual_private_network	200405	1	0	0	0	1	1	0	0	22	17	1	18	13	1
147130	Virtual_private_network	200406	1	0	0	0	1	0	0	0	23	18	1	18	13	1
147130	Virtual_private_network	200407	3	0	0	0	2	0	0	0	26	20	1	18	13	1
147130	Virtual_private_network	200408	1	0	0	0	1	0	0	0	27	21	1	18	13	1
147130	Virtual_private_network	200409	1	0	0	0	1	1	0	0	28	22	1	19	14	1
147130	Virtual_private_network	200410	1	0	0	0	1	1	0	0	29	23	1	20	15	1
147130	Virtual_private_network	200411	10	0	0	0	10	7	0	0	39	33	1	27	22	1
147130	Virtual_private_network	200412	4	0	0	0	3	2	0	0	43	36	1	30	24	1
147130	Virtual_private_network	200501	9	1	0	0	6	3	1	0	52	42	2	33	27	1
147130	Virtual_private_network	200502	8	0	0	0	6	2	0	0	60	48	2	35	29	1
147130	Virtual_private_network	200503	5	0	0	0	5	3	0	0	65	52	2	38	32	1
147130	Virtual_private_network	200504	14	0	0	0	13	5	0	0	79	64	2	44	37	1
147130	Virtual_private_network	200505	3	1	0	0	3	1	1	0	82	66	3	45	37	1
147130	Virtual_private_network	200506	10	1	0	0	6	2	1	0	92	71	4	47	38	1
147130	Virtual_private_network	200507	7	1	0	0	6	4	1	0	99	77	5	52	42	1
147130	Virtual_private_network	200508	6	1	0	0	5	2	1	0	105	80	6	54	42	1
147130	Virtual_private_network	200509	10	1	0	0	8	3	1	0	115	86	7	57	43	1
147130	Virtual_private_network	200510	11	0	0	0	11	2	0	0	126	97	7	59	45	1
147130	Virtual_private_network	200511	15	0	0	0	11	3	0	0	141	108	7	63	48	1
147130	Virtual_private_network	200512	15	2	0	0	14	7	2	0	156	120	9	70	54	1
147130	Virtual_private_network	200601	15	2	0	0	14	7	2	0	171	132	11	77	59	1
147130	Virtual_private_network	200602	21	2	0	0	14	6	2	0	192	145	13	87	64	1
147130	Virtual_private_network	200603	20	2	0	0	16	10	2	0	212	161	15	100	74	1
147130	Virtual_private_network	200604	30	4	0	0	22	12	4	0	242	178	19	118	83	1
147130	Virtual_private_network	200605	23	3	0	0	17	8	3	0	265	194	22	129	90	1
147130	Virtual_private_network	200606	29	4	0	0	22	8	4	0	294	213	26	141	95	1
147130	Virtual_private_network	200607	29	9	0	0	21	9	7	0	323	231	35	153	101	2
147130	Virtual_private_network	200608	23	2	0	0	16	7	2	0	346	246	37	164	107	2
147130	Virtual_private_network	200609	25	5	0	0	21	9	5	0	371	265	42	177	114	2
147130	Virtual_private_network	200610	40	5	0	0	24	8	3	0	411	287	47	194	120	2
147130	Virtual_private_network	200611	26	5	0	0	19	7	5	0	437	305	52	202	126	2
147130	Virtual_private_network	200612	31	6	0	0	24	9	5	0	468	328	58	215	134	2
147130	Virtual_private_network	200701	31	7	0	0	23	13	5	0	499	350	65	234	146	3
147130	Virtual_private_network	200702	49	8	0	0	28	13	3	0	548	376	73	259	157	5
147130	Virtual_private_network	200703	37	9	0	0	32	15	7	0	585	405	82	276	169	6
147130	Virtual_private_network	200704	57	16	0	0	41	12	9	0	642	444	98	297	180	6
147130	Virtual_private_network	200705	49	7	0	0	32	14	5	0	691	472	105	317	192	8
147130	Virtual_private_network	200706	52	8	0	0	33	15	6	0	743	500	113	345	204	10
147130	Virtual_private_network	200707	57	10	0	0	32	15	6	0	800	525	123	372	213	12
147130	Virtual_private_network	200708	101	13	0	0	45	14	7	0	901	569	136	432	226	16
147130	Virtual_private_network	200709	51	14	0	0	32	12	8	0	952	597	150	455	234	17
147130	Virtual_private_network	200710	43	12	0	0	29	13	8	0	995	619	162	474	241	18
147130	Virtual_private_network	200711	39	6	0	0	28	12	5	0	1034	642	168	489	248	18
147130	Virtual_private_network	200712	31	11	0	0	21	9	7	0	1065	659	179	502	253	20
147130	Virtual_private_network	200801	10	2	0	0	7	4	1	0	1075	665	181	507	256	20
147130	Virtual_private_network	200802	32	9	2	1	22	11	8	2	1107	686	190	519	266	22
147130	Virtual_private_network	200803	25	6	0	0	23	8	6	0	1132	707	196	527	272	23
147130	Virtual_private_network	200804	37	4	0	0	30	7	4	0	1169	736	200	534	278	23
147130	Virtual_private_network	200805	31	12	1	0	22	5	7	1	1200	755	212	543	281	25
147130	Virtual_private_network	200806	19	6	0	0	15	4	4	0	1219	768	218	549	283	25
147130	Virtual_private_network	200807	14	7	0	0	13	5	6	0	1233	780	225	555	287	25
147130	Virtual_private_network	200808	28	8	1	0	17	8	7	1	1261	796	233	566	294	27
147130	Virtual_private_network	200809	30	10	0	0	21	8	7	0	1291	813	243	577	298	27
147130	Virtual_private_network	200810	27	6	0	0	21	9	6	0	1318	829	249	586	302	27
147130	Virtual_private_network	200811	27	8	0	0	21	9	7	0	1345	845	257	598	307	27
147130	Virtual_private_network	200812	23	6	0	0	15	7	4	0	1368	858	263	611	312	27
147130	Virtual_private_network	200901	25	6	0	0	20	10	5	0	1393	874	269	623	318	29
147130	Virtual_private_network	200902	42	11	0	0	32	12	8	0	1435	902	280	641	326	29
147130	Virtual_private_network	200903	17	1	0	0	15	6	1	0	1452	915	281	648	330	29
147130	Virtual_private_network	200904	38	10	0	0	29	12	8	0	1490	937	291	666	336	29
147130	Virtual_private_network	200905	41	7	0	0	30	11	5	0	1531	964	298	684	344	29
147130	Virtual_private_network	200906	28	11	0	0	23	13	9	0	1559	981	309	700	351	31
147130	Virtual_private_network	200907	26	6	0	0	13	8	4	0	1585	990	315	720	355	33
147130	Virtual_private_network	200908	24	5	0	0	21	12	5	0	1609	1008	320	734	364	35
147130	Virtual_private_network	200909	35	11	3	1	14	7	5	2	1644	1019	331	760	368	41
147130	Virtual_private_network	200910	22	5	0	0	17	8	5	0	1666	1032	336	770	372	41
147130	Virtual_private_network	200911	29	5	0	0	22	7	4	0	1695	1050	341	781	375	41
147130	Virtual_private_network	200912	27	3	0	0	18	9	2	0	1722	1064	344	795	380	41
147130	Virtual_private_network	201001	9	0	0	0	6	2	0	0	1731	1069	344	798	381	41
147130	Virtual_private_network	201002	34	4	0	0	17	11	4	0	1765	1082	348	826	388	41
147130	Virtual_private_network	201003	23	4	0	0	15	9	4	0	1788	1095	352	839	395	41
147130	Virtual_private_network	201004	50	4	0	0	24	10	3	0	1838	1117	356	851	403	41
147130	Virtual_private_network	201005	35	4	0	0	24	8	4	0	1873	1140	360	864	410	42
147130	Virtual_private_network	201006	45	3	0	0	21	9	3	0	1918	1159	363	893	417	42
147130	Virtual_private_network	201007	39	13	0	0	26	11	9	0	1957	1181	376	909	424	42
147130	Virtual_private_network	201008	26	7	0	0	18	7	6	0	1983	1194	383	917	428	42
147130	Virtual_private_network	201009	12	3	0	0	12	5	3	0	1995	1203	386	922	431	42
147130	Virtual_private_network	201010	34	8	0	0	29	10	8	0	2029	1226	394	933	436	43
147130	Virtual_private_network	201011	18	5	0	0	16	7	5	0	2047	1239	399	940	441	43
147130	Virtual_private_network	201012	20	6	0	0	14	7	4	0	2067	1251	405	950	447	43
147130	Virtual_private_network	201101	17	5	0	0	14	7	4	0	2084	1261	410	958	451	43
147130	Virtual_private_network	201102	30	6	0	0	24	10	5	0	2114	1281	416	971	458	45
147130	Virtual_private_network	201103	27	3	0	0	19	11	3	0	2141	1296	419	985	465	46
147130	Virtual_private_network	201104	14	4	0	0	10	3	3	0	2155	1304	423	989	467	47
147130	Virtual_private_network	201105	21	5	0	0	14	8	4	0	2176	1312	428	999	470	49
147130	Virtual_private_network	201106	24	2	0	0	15	6	2	0	2200	1326	430	1010	475	50
147130	Virtual_private_network	201107	20	5	0	0	12	6	3	0	2220	1334	435	1022	477	52
147130	Virtual_private_network	201108	15	4	0	0	13	8	3	0	2235	1343	439	1032	481	53
147130	Virtual_private_network	201109	20	3	0	0	18	10	3	0	2255	1355	442	1042	486	54
147130	Virtual_private_network	201110	26	7	0	0	18	11	4	0	2281	1367	449	1058	491	56
147130	Virtual_private_network	201111	13	2	0	0	11	7	2	0	2294	1376	451	1067	496	57
147130	Virtual_private_network	201112	8	3	0	0	7	3	2	0	2302	1380	454	1071	496	57
147130	Virtual_private_network	201201	11	4	0	0	10	5	4	0	2313	1389	458	1076	500	57
147130	Virtual_private_network	201202	12	4	0	0	12	7	4	0	2325	1397	462	1083	503	57
147130	Virtual_private_network	201203	17	2	0	0	12	7	2	0	2342	1408	464	1090	509	57
147130	Virtual_private_network	201204	28	8	0	0	16	11	3	0	2370	1418	472	1111	515	60
147130	Virtual_private_network	201205	8	4	0	0	6	3	3	0	2378	1422	476	1115	516	60
147130	Virtual_private_network	201206	15	2	0	0	13	6	2	0	2393	1433	478	1123	520	61
147130	Virtual_private_network	201207	19	6	0	0	13	7	5	0	2412	1443	484	1132	524	61
147130	Virtual_private_network	201208	24	8	0	0	19	9	6	0	2436	1456	492	1143	527	61
147130	Virtual_private_network	201209	20	4	0	0	15	8	3	0	2456	1468	496	1154	532	62
147130	Virtual_private_network	201210	22	7	1	0	19	10	6	1	2478	1482	503	1167	537	66
147130	Virtual_private_network	201211	7	1	0	0	7	3	1	0	2485	1488	504	1170	539	66
147130	Virtual_private_network	201212	17	3	0	0	14	8	3	0	2502	1499	507	1179	544	68
147130	Virtual_private_network	201301	10	3	0	0	7	4	1	0	2512	1504	510	1185	546	68
147130	Virtual_private_network	201302	10	3	0	0	7	5	3	0	2522	1510	513	1191	550	68
147130	Virtual_private_network	201303	30	7	0	0	23	11	6	0	2552	1529	520	1206	557	69
147130	Virtual_private_network	201304	17	4	0	0	13	9	4	0	2569	1540	524	1219	564	71
147130	Virtual_private_network	201305	22	4	0	0	14	8	3	0	2591	1549	528	1229	567	72
147130	Virtual_private_network	201306	24	6	0	0	19	6	6	0	2615	1564	534	1235	570	72
147130	Virtual_private_network	201307	28	3	0	0	18	7	2	0	2643	1578	537	1245	573	72
147130	Virtual_private_network	201308	12	4	0	0	11	3	4	0	2655	1587	541	1248	574	72
147130	Virtual_private_network	201309	13	4	0	0	12	7	4	0	2668	1597	545	1255	579	72
147130	Virtual_private_network	201310	14	5	0	0	8	5	4	0	2682	1604	550	1264	583	73
147130	Virtual_private_network	201311	18	5	0	0	16	8	5	0	2700	1617	555	1274	588	73
147130	Virtual_private_network	201312	21	9	0	0	16	10	8	0	2721	1628	564	1287	593	76
147130	Virtual_private_network	201401	4	2	0	0	4	2	2	0	2725	1630	566	1289	593	76
147130	Virtual_private_network	201402	22	6	0	0	18	10	5	0	2747	1642	572	1301	597	77
147130	Virtual_private_network	201403	20	5	0	0	14	7	4	0	2767	1653	577	1311	601	79
147130	Virtual_private_network	201404	29	5	0	0	17	9	5	0	2796	1665	582	1325	605	80
147130	Virtual_private_network	201405	14	4	0	0	10	4	3	0	2810	1673	586	1331	607	81
147130	Virtual_private_network	201406	21	9	1	0	15	8	8	1	2831	1684	595	1342	611	85
147130	Virtual_private_network	201407	23	6	0	0	18	5	4	0	2854	1697	601	1350	612	85
147130	Virtual_private_network	201408	11	3	0	0	10	3	3	0	2865	1704	604	1353	612	85
147130	Virtual_private_network	201409	18	5	0	0	11	6	3	0	2883	1714	609	1364	617	85
147130	Virtual_private_network	201410	14	6	0	0	13	6	6	0	2897	1722	615	1370	618	85
147130	Virtual_private_network	201411	15	4	0	0	11	7	4	0	2912	1730	619	1379	622	87
147130	Virtual_private_network	201412	14	4	0	0	11	6	3	0	2926	1738	623	1388	625	88
147130	Virtual_private_network	201501	18	5	0	0	12	8	4	0	2944	1747	628	1399	630	91
147130	Virtual_private_network	201502	18	3	0	0	12	7	2	0	2962	1755	631	1408	631	92
147130	Virtual_private_network	201503	14	3	0	0	12	7	3	0	2976	1765	634	1416	636	92
147130	Virtual_private_network	201504	18	6	1	0	15	8	6	1	2994	1777	640	1425	641	93
147130	Virtual_private_network	201505	4	2	0	0	3	1	2	0	2998	1779	642	1426	641	93
147130	Virtual_private_network	201506	12	5	0	0	10	7	4	0	3010	1786	647	1435	645	95
147130	Virtual_private_network	201507	13	6	0	0	9	3	4	0	3023	1791	653	1440	645	95
147130	Virtual_private_network	201508	4	2	0	0	4	4	2	0	3027	1794	655	1444	648	97
147130	Virtual_private_network	201509	40	7	0	0	27	16	6	0	3067	1816	662	1471	659	101
147130	Virtual_private_network	201510	31	6	0	0	23	15	5	0	3098	1832	668	1492	666	104
147130	Virtual_private_network	201511	32	14	1	0	14	11	9	1	3130	1840	682	1509	671	106
147130	Virtual_private_network	201512	20	7	0	0	16	5	4	0	3150	1852	689	1517	672	107
147130	Virtual_private_network	201601	12	2	0	0	12	10	2	0	3162	1862	691	1527	678	109
147130	Virtual_private_network	201602	13	3	0	0	13	9	3	0	3175	1872	694	1536	683	110
147130	Virtual_private_network	201603	19	5	0	0	14	8	4	0	3194	1882	699	1546	687	111
147130	Virtual_private_network	201604	12	3	0	0	10	7	3	0	3206	1890	702	1555	691	113
147130	Virtual_private_network	201605	12	3	0	0	10	4	3	0	3218	1899	705	1559	694	113
147130	Virtual_private_network	201606	19	4	0	0	13	9	3	0	3237	1906	709	1570	696	114
147130	Virtual_private_network	201607	30	7	0	0	18	11	4	0	3267	1922	716	1592	705	118
147130	Virtual_private_network	201608	22	7	0	0	18	9	6	0	3289	1937	723	1605	710	120
147130	Virtual_private_network	201609	42	7	0	0	26	18	6	0	3331	1957	730	1625	719	122
147130	Virtual_private_network	201610	15	6	0	0	11	6	5	0	3346	1965	736	1635	722	123
147130	Virtual_private_network	201611	11	4	2	0	7	7	3	1	3357	1970	740	1646	726	127
147130	Virtual_private_network	201612	23	4	0	0	12	5	3	0	3380	1979	744	1662	728	128
147130	Virtual_private_network	201701	5	1	0	0	4	3	1	0	3385	1980	745	1665	728	128
147130	Virtual_private_network	201702	26	11	3	1	16	10	7	2	3411	1990	756	1681	732	133
147130	Virtual_private_network	201703	11	4	0	0	10	3	3	0	3422	1998	760	1685	733	133
147130	Virtual_private_network	201704	22	5	0	0	17	12	5	0	3444	2013	765	1700	743	135
147130	Virtual_private_network	201705	24	7	0	0	15	11	4	0	3468	2024	772	1720	750	139
147130	Virtual_private_network	201706	18	7	0	0	16	11	6	0	3486	2036	779	1733	756	141
147130	Virtual_private_network	201707	9	4	0	0	6	5	3	0	3495	2041	783	1739	759	143
147130	Virtual_private_network	201708	17	6	0	0	10	8	4	0	3512	2048	789	1750	762	146
147130	Virtual_private_network	201709	31	6	0	0	22	16	5	0	3543	2065	795	1774	771	147
147130	Virtual_private_network	201710	9	4	0	0	8	4	3	0	3552	2071	799	1779	773	147
147130	Virtual_private_network	201711	15	7	1	0	14	9	6	1	3567	2079	806	1789	776	149
147130	Virtual_private_network	201712	6	2	0	0	6	5	2	0	3573	2082	808	1794	777	151
147130	Virtual_private_network	201801	11	2	0	0	9	6	2	0	3584	2088	810	1801	780	152
147130	Virtual_private_network	201802	14	5	0	0	13	8	5	0	3598	2095	815	1809	781	154
147130	Virtual_private_network	201803	19	8	0	0	15	10	6	0	3617	2106	823	1823	787	158
147130	Virtual_private_network	201804	26	11	0	0	21	13	9	0	3643	2121	834	1838	793	161
147130	Virtual_private_network	201805	12	4	0	0	11	8	3	0	3655	2128	838	1847	797	162
147130	Virtual_private_network	201806	20	4	0	0	15	15	4	0	3675	2141	842	1867	809	166
147130	Virtual_private_network	201807	17	5	0	0	11	10	3	0	3692	2146	847	1881	812	168
32612	Virtual_reality	200111	1	0	0	0	1	1	0	0	1	1	0	1	1	0
32612	Virtual_reality	200202	1	0	0	0	1	1	0	0	2	2	0	2	2	0
32612	Virtual_reality	200206	1	0	0	0	1	1	0	0	3	3	0	3	2	0
32612	Virtual_reality	200207	1	0	0	0	1	0	0	0	4	4	0	3	2	0
32612	Virtual_reality	200208	1	0	0	0	1	1	0	0	5	5	0	4	3	0
32612	Virtual_reality	200209	4	0	0	0	3	1	0	0	9	8	0	5	4	0
32612	Virtual_reality	200210	2	0	0	0	1	0	0	0	11	9	0	5	4	0
32612	Virtual_reality	200301	1	0	0	0	1	1	0	0	12	10	0	6	5	0
32612	Virtual_reality	200302	3	0	0	0	1	1	0	0	15	11	0	9	6	0
32612	Virtual_reality	200303	3	0	0	0	3	2	0	0	18	14	0	11	8	0
32612	Virtual_reality	200305	1	0	0	0	1	1	0	0	19	15	0	12	9	0
32612	Virtual_reality	200306	5	0	0	0	4	1	0	0	24	19	0	13	10	0
32612	Virtual_reality	200309	1	0	0	0	1	1	0	0	25	20	0	14	11	0
32612	Virtual_reality	200310	2	0	0	0	2	2	0	0	27	22	0	16	13	0
32612	Virtual_reality	200312	2	0	0	0	1	0	0	0	29	23	0	16	13	0
32612	Virtual_reality	200401	1	0	0	0	1	1	0	0	30	24	0	17	14	0
32612	Virtual_reality	200404	1	0	0	0	1	0	0	0	31	25	0	17	14	0
32612	Virtual_reality	200406	1	0	0	0	1	0	0	0	32	26	0	17	14	0
32612	Virtual_reality	200407	3	0	0	0	3	1	0	0	35	29	0	18	15	0
32612	Virtual_reality	200408	3	0	0	0	3	3	0	0	38	32	0	21	18	0
32612	Virtual_reality	200409	4	0	0	0	4	3	0	0	42	36	0	24	21	0
32612	Virtual_reality	200410	1	0	0	0	1	0	0	0	43	37	0	24	21	0
32612	Virtual_reality	200411	4	0	0	0	3	2	0	0	47	40	0	27	23	0
32612	Virtual_reality	200412	14	0	0	0	6	3	0	0	61	46	0	35	26	0
32612	Virtual_reality	200501	7	1	0	0	5	4	1	0	68	50	1	39	29	0
32612	Virtual_reality	200502	7	0	0	0	5	0	0	0	75	55	1	39	29	0
32612	Virtual_reality	200503	5	0	0	0	4	2	0	0	80	59	1	42	31	0
32612	Virtual_reality	200504	11	1	0	0	7	5	1	0	91	66	2	49	36	1
32612	Virtual_reality	200505	1	0	0	0	1	0	0	0	92	67	2	49	36	1
32612	Virtual_reality	200506	10	3	0	0	9	7	3	0	102	74	5	56	41	1
32612	Virtual_reality	200507	3	1	0	0	2	1	1	0	105	75	6	57	41	1
32612	Virtual_reality	200508	8	2	0	0	5	2	1	0	113	79	8	60	42	1
32612	Virtual_reality	200509	7	0	0	0	4	3	0	0	120	82	8	65	44	1
32612	Virtual_reality	200510	10	0	0	0	7	4	0	0	130	89	8	72	48	1
32612	Virtual_reality	200511	18	5	0	0	17	7	5	0	148	106	13	80	55	1
32612	Virtual_reality	200512	21	3	0	0	15	6	3	0	169	119	16	89	59	1
32612	Virtual_reality	200601	75	2	0	0	17	7	2	0	244	135	18	151	65	1
32612	Virtual_reality	200602	60	10	0	0	27	13	9	0	304	160	28	185	76	1
32612	Virtual_reality	200603	37	2	0	0	22	7	2	0	341	180	30	196	81	1
32612	Virtual_reality	200604	18	1	0	0	14	7	1	0	359	193	31	203	87	1
32612	Virtual_reality	200605	28	7	1	0	21	8	6	1	387	213	38	213	94	3
32612	Virtual_reality	200606	34	2	0	0	25	13	2	0	421	235	40	229	105	3
32612	Virtual_reality	200607	36	1	0	0	22	10	1	0	457	256	41	242	114	3
32612	Virtual_reality	200608	31	1	0	0	25	15	1	0	488	277	42	261	125	3
32612	Virtual_reality	200609	25	2	0	0	21	7	2	0	513	298	44	270	132	3
32612	Virtual_reality	200610	42	6	0	0	29	9	6	0	555	327	50	283	141	4
32612	Virtual_reality	200611	74	8	0	0	33	13	6	0	629	358	58	302	153	4
32612	Virtual_reality	200612	88	9	0	0	41	20	7	0	717	397	67	328	171	4
32612	Virtual_reality	200701	42	3	0	0	34	14	3	0	759	426	70	344	182	4
32612	Virtual_reality	200702	62	10	0	0	37	20	7	0	821	458	80	375	199	5
32612	Virtual_reality	200703	3	0	0	0	3	3	0	0	824	461	80	378	202	5
32612	Virtual_reality	200704	44	9	0	0	34	20	8	0	868	493	89	406	220	5
32612	Virtual_reality	200705	35	6	0	0	21	13	2	0	903	512	95	428	231	10
32612	Virtual_reality	200706	71	21	0	0	42	22	14	0	974	549	116	462	249	11
32612	Virtual_reality	200707	24	5	0	0	14	7	4	0	998	562	121	471	255	11
32612	Virtual_reality	200708	53	5	0	0	23	11	4	0	1051	584	126	489	265	12
32612	Virtual_reality	200709	100	32	2	0	33	11	12	2	1151	611	158	527	272	16
32612	Virtual_reality	200710	70	17	1	0	31	19	10	1	1221	638	175	574	287	19
32612	Virtual_reality	200711	60	11	0	0	29	15	5	0	1281	663	186	600	298	20
32612	Virtual_reality	200712	53	10	0	0	23	15	7	0	1334	682	196	623	309	22
32612	Virtual_reality	200801	48	12	0	0	26	10	4	0	1382	704	208	647	315	25
32612	Virtual_reality	200802	46	5	0	0	22	7	3	0	1428	723	213	660	320	25
32612	Virtual_reality	200803	21	6	0	0	16	8	4	0	1449	736	219	670	325	25
32612	Virtual_reality	200804	30	7	0	0	21	11	7	0	1479	755	226	686	335	27
32612	Virtual_reality	200805	26	5	0	0	17	7	4	0	1505	768	231	697	339	27
32612	Virtual_reality	200806	37	12	0	0	23	14	10	0	1542	785	243	720	347	30
32612	Virtual_reality	200807	20	3	0	0	15	5	3	0	1562	798	246	726	350	31
32612	Virtual_reality	200808	38	10	0	0	24	15	6	0	1600	818	256	754	361	35
32612	Virtual_reality	200809	14	4	0	0	13	8	4	0	1614	827	260	763	365	36
32612	Virtual_reality	200810	20	4	0	0	17	9	4	0	1634	840	264	773	371	37
32612	Virtual_reality	200811	36	11	0	0	20	10	6	0	1670	857	275	788	378	38
32612	Virtual_reality	200812	14	2	0	0	8	3	1	0	1684	864	277	795	380	39
32612	Virtual_reality	200901	30	6	0	0	21	13	5	0	1714	882	283	814	391	41
32612	Virtual_reality	200902	38	12	0	0	24	15	8	0	1752	902	295	835	402	42
32612	Virtual_reality	200903	15	3	0	0	8	4	3	0	1767	910	298	839	406	42
32612	Virtual_reality	200904	20	6	0	0	15	10	5	0	1787	922	304	851	413	46
32612	Virtual_reality	200905	6	1	0	0	6	5	1	0	1793	927	305	856	417	46
32612	Virtual_reality	200906	22	2	0	0	11	3	2	0	1815	936	307	863	418	47
32612	Virtual_reality	200907	17	2	0	0	12	9	2	0	1832	945	309	877	424	48
32612	Virtual_reality	200908	21	3	0	0	15	10	2	0	1853	957	312	892	431	49
32612	Virtual_reality	200909	11	1	0	0	8	3	1	0	1864	963	313	895	432	49
32612	Virtual_reality	200910	15	4	0	0	13	9	4	0	1879	974	317	905	439	52
32612	Virtual_reality	200911	30	6	0	0	16	10	4	0	1909	985	323	927	444	53
32612	Virtual_reality	200912	16	2	0	0	12	5	2	0	1925	994	325	933	446	53
32612	Virtual_reality	201001	7	2	0	0	6	3	2	0	1932	998	327	936	447	53
32612	Virtual_reality	201002	23	4	0	0	13	5	2	0	1955	1008	331	946	450	55
32612	Virtual_reality	201003	40	7	0	0	26	15	6	0	1995	1028	338	962	459	55
32612	Virtual_reality	201004	28	6	0	0	18	10	5	0	2023	1041	344	979	464	55
32612	Virtual_reality	201005	18	3	0	0	11	4	2	0	2041	1050	347	987	466	55
32612	Virtual_reality	201006	20	5	0	0	11	6	4	0	2061	1057	352	995	468	55
32612	Virtual_reality	201007	7	1	0	0	7	4	1	0	2068	1064	353	999	472	55
32612	Virtual_reality	201008	46	9	2	1	25	16	8	2	2114	1083	362	1029	482	59
32612	Virtual_reality	201009	27	8	2	1	9	6	5	2	2141	1088	370	1048	485	60
32612	Virtual_reality	201010	7	1	0	0	6	2	1	0	2148	1093	371	1051	486	60
32612	Virtual_reality	201011	22	4	0	0	10	5	3	0	2170	1102	375	1057	490	60
32612	Virtual_reality	201012	23	6	0	0	16	8	5	0	2193	1113	381	1066	494	60
32612	Virtual_reality	201101	31	3	0	0	14	9	1	0	2224	1123	384	1089	499	61
32612	Virtual_reality	201102	8	1	0	0	7	3	1	0	2232	1129	385	1093	501	61
32612	Virtual_reality	201103	4	0	0	0	2	1	0	0	2236	1131	385	1096	502	61
32612	Virtual_reality	201104	28	2	0	0	18	9	2	0	2264	1147	387	1110	509	61
32612	Virtual_reality	201105	11	2	0	0	8	5	2	0	2275	1154	389	1118	513	62
32612	Virtual_reality	201106	4	2	0	0	4	2	2	0	2279	1156	391	1120	514	62
32612	Virtual_reality	201107	17	1	0	0	8	5	1	0	2296	1161	392	1131	516	62
32612	Virtual_reality	201108	15	0	0	0	7	4	0	0	2311	1168	392	1140	520	62
32612	Virtual_reality	201109	16	2	0	0	10	6	2	0	2327	1176	394	1151	524	62
32612	Virtual_reality	201110	6	1	0	0	6	5	1	0	2333	1182	395	1156	529	62
32612	Virtual_reality	201111	8	0	0	0	7	3	0	0	2341	1188	395	1159	531	62
32612	Virtual_reality	201112	7	3	0	0	5	2	1	0	2348	1192	398	1163	532	62
32612	Virtual_reality	201201	45	10	0	0	12	8	7	0	2393	1202	408	1175	538	62
32612	Virtual_reality	201202	23	5	0	0	15	10	4	0	2416	1214	413	1188	545	62
32612	Virtual_reality	201203	28	5	0	0	15	9	4	0	2444	1226	418	1209	551	64
32612	Virtual_reality	201204	3	0	0	0	2	1	0	0	2447	1228	418	1210	552	64
32612	Virtual_reality	201205	12	2	0	0	7	4	2	0	2459	1234	420	1217	555	64
32612	Virtual_reality	201206	3	0	0	0	3	2	0	0	2462	1237	420	1219	557	64
32612	Virtual_reality	201207	13	0	0	0	5	2	0	0	2475	1241	420	1221	558	64
32612	Virtual_reality	201208	5	0	0	0	4	2	0	0	2480	1245	420	1224	560	64
32612	Virtual_reality	201209	12	1	0	0	6	4	1	0	2492	1249	421	1230	562	65
32612	Virtual_reality	201210	3	1	0	0	3	1	1	0	2495	1251	422	1231	562	65
32612	Virtual_reality	201211	5	0	0	0	4	1	0	0	2500	1255	422	1232	563	65
32612	Virtual_reality	201212	12	4	1	0	8	4	3	1	2512	1261	426	1237	565	66
32612	Virtual_reality	201301	7	2	0	0	7	4	2	0	2519	1266	428	1241	567	66
32612	Virtual_reality	201302	17	5	0	0	8	5	3	0	2536	1272	433	1248	570	66
32612	Virtual_reality	201303	18	1	0	0	8	5	1	0	2554	1278	434	1263	573	66
32612	Virtual_reality	201304	11	1	0	0	9	5	1	0	2565	1285	435	1269	576	66
32612	Virtual_reality	201305	13	2	0	0	9	7	1	0	2578	1291	437	1280	579	67
32612	Virtual_reality	201306	12	1	0	0	9	3	1	0	2590	1299	438	1284	581	67
32612	Virtual_reality	201307	9	2	0	0	9	6	2	0	2599	1306	440	1290	585	68
32612	Virtual_reality	201308	9	3	0	0	8	6	3	0	2608	1312	443	1297	589	69
32612	Virtual_reality	201309	10	1	0	0	8	5	1	0	2618	1318	444	1303	592	70
32612	Virtual_reality	201310	16	2	0	0	9	4	2	0	2634	1326	446	1308	595	70
32612	Virtual_reality	201311	8	4	1	0	7	5	4	1	2642	1331	450	1313	598	72
32612	Virtual_reality	201312	13	2	0	0	8	3	2	0	2655	1338	452	1316	600	72
32612	Virtual_reality	201401	8	2	0	0	7	2	2	0	2663	1344	454	1318	601	72
32612	Virtual_reality	201402	16	3	0	0	13	5	2	0	2679	1355	457	1325	604	73
32612	Virtual_reality	201403	21	3	0	0	12	8	3	0	2700	1364	460	1333	610	75
32612	Virtual_reality	201404	22	3	0	0	14	7	3	0	2722	1376	463	1340	616	75
32612	Virtual_reality	201405	16	5	1	0	13	7	5	1	2738	1385	468	1347	619	76
32612	Virtual_reality	201406	11	0	0	0	6	5	0	0	2749	1391	468	1356	624	76
32612	Virtual_reality	201407	11	0	0	0	7	4	0	0	2760	1397	468	1361	627	76
32612	Virtual_reality	201408	16	2	0	0	12	8	2	0	2776	1405	470	1373	631	76
32612	Virtual_reality	201409	28	2	0	0	17	12	2	0	2804	1416	472	1396	637	78
32612	Virtual_reality	201410	2	0	0	0	2	2	0	0	2806	1418	472	1398	639	78
32612	Virtual_reality	201411	13	1	0	0	9	2	1	0	2819	1424	473	1400	639	78
32612	Virtual_reality	201412	27	4	0	0	15	9	3	0	2846	1435	477	1410	645	80
32612	Virtual_reality	201501	10	2	0	0	9	6	2	0	2856	1442	479	1416	649	81
32612	Virtual_reality	201502	24	1	0	0	18	10	1	0	2880	1456	480	1430	655	81
32612	Virtual_reality	201503	29	1	0	0	12	9	1	0	2909	1464	481	1454	660	81
32612	Virtual_reality	201504	20	2	0	0	10	6	1	0	2929	1474	483	1462	666	81
32612	Virtual_reality	201505	8	0	0	0	4	0	0	0	2937	1477	483	1462	666	81
32612	Virtual_reality	201506	12	2	0	0	11	8	2	0	2949	1486	485	1471	672	82
32612	Virtual_reality	201507	16	2	0	0	12	7	2	0	2965	1495	487	1479	676	83
32612	Virtual_reality	201508	11	1	0	0	10	7	1	0	2976	1503	488	1487	681	83
32612	Virtual_reality	201509	40	4	0	0	19	11	3	0	3016	1518	492	1506	687	84
32612	Virtual_reality	201510	34	7	0	0	26	12	6	0	3050	1542	499	1522	696	87
32612	Virtual_reality	201511	27	6	0	0	23	15	6	0	3077	1561	505	1540	705	90
32612	Virtual_reality	201512	41	2	0	0	19	12	2	0	3118	1578	507	1574	715	92
32612	Virtual_reality	201601	30	2	0	0	22	14	2	0	3148	1597	509	1595	726	92
32612	Virtual_reality	201602	30	4	0	0	21	14	4	0	3178	1613	513	1616	735	92
32612	Virtual_reality	201603	57	13	0	0	33	19	10	0	3235	1638	526	1645	746	92
32612	Virtual_reality	201604	29	7	0	0	23	16	5	0	3264	1657	533	1663	758	93
32612	Virtual_reality	201605	31	4	0	0	21	17	3	0	3295	1673	537	1685	769	93
32612	Virtual_reality	201606	53	10	0	0	33	22	10	0	3348	1696	547	1720	781	94
32612	Virtual_reality	201607	46	1	0	0	18	8	1	0	3394	1709	548	1754	784	94
32612	Virtual_reality	201608	34	8	1	0	20	15	6	1	3428	1726	556	1779	795	99
32612	Virtual_reality	201609	76	7	0	0	22	14	5	0	3504	1743	563	1846	803	103
32612	Virtual_reality	201610	102	20	0	0	31	16	5	0	3606	1767	583	1920	811	108
32612	Virtual_reality	201611	55	12	0	0	33	23	6	0	3661	1791	595	1957	824	114
32612	Virtual_reality	201612	41	9	0	0	27	16	5	0	3702	1812	604	1985	834	117
32612	Virtual_reality	201701	42	9	0	0	28	17	6	0	3744	1835	613	2007	845	118
32612	Virtual_reality	201702	63	16	0	0	34	16	8	0	3807	1864	629	2045	856	121
32612	Virtual_reality	201703	36	10	0	0	23	18	7	0	3843	1882	639	2073	866	126
32612	Virtual_reality	201704	169	12	0	0	44	34	11	0	4012	1918	651	2214	890	130
32612	Virtual_reality	201705	43	11	2	1	27	21	8	2	4055	1938	662	2247	904	137
32612	Virtual_reality	201706	47	13	0	0	31	17	10	0	4102	1963	675	2278	915	140
32612	Virtual_reality	201707	37	10	0	0	25	20	8	0	4139	1981	685	2305	925	144
32612	Virtual_reality	201708	18	6	0	0	13	11	5	0	4157	1989	691	2320	931	148
32612	Virtual_reality	201709	26	8	0	0	20	17	6	0	4183	2006	699	2342	945	153
32612	Virtual_reality	201710	37	13	0	0	27	21	11	0	4220	2026	712	2369	958	158
32612	Virtual_reality	201711	25	7	0	0	20	14	7	0	4245	2042	719	2388	967	160
32612	Virtual_reality	201712	37	11	0	0	29	21	11	0	4282	2062	730	2412	976	165
32612	Virtual_reality	201801	32	10	0	0	26	20	10	0	4314	2077	740	2438	984	169
32612	Virtual_reality	201802	57	12	0	0	30	26	11	0	4371	2098	752	2491	999	177
32612	Virtual_reality	201803	37	7	0	0	20	15	7	0	4408	2113	759	2521	1008	179
32612	Virtual_reality	201804	33	5	0	0	20	14	5	0	4441	2128	764	2548	1017	179
32612	Virtual_reality	201805	39	5	0	0	20	14	5	0	4480	2143	769	2579	1026	180
32612	Virtual_reality	201806	37	10	0	0	24	17	8	0	4517	2160	779	2609	1035	184
32612	Virtual_reality	201807	22	4	0	0	16	11	3	0	4539	2171	783	2624	1042	185
18311356	Virtualization	200808	7	0	0	0	4	4	0	0	7	4	0	7	4	0
18311356	Virtualization	200809	4	0	0	0	3	3	0	0	11	7	0	11	7	0
18311356	Virtualization	200810	1	0	0	0	1	0	0	0	12	8	0	11	7	0
18311356	Virtualization	200811	4	2	1	0	2	2	2	1	16	10	2	15	9	2
18311356	Virtualization	200812	3	0	0	0	2	2	0	0	19	12	2	18	11	2
18311356	Virtualization	200901	4	2	0	0	2	1	1	0	23	13	4	20	11	2
18311356	Virtualization	200902	5	1	0	0	4	3	1	0	28	17	5	24	14	2
18311356	Virtualization	200903	8	1	0	0	8	4	1	0	36	23	6	28	16	3
18311356	Virtualization	200904	1	0	0	0	1	1	0	0	37	24	6	29	17	3
18311356	Virtualization	200905	7	1	0	0	5	4	1	0	44	29	7	35	21	4
18311356	Virtualization	200906	7	0	0	0	6	4	0	0	51	35	7	40	25	4
18311356	Virtualization	200907	9	1	0	0	6	4	1	0	60	41	8	47	29	5
18311356	Virtualization	200908	11	0	0	0	4	4	0	0	71	44	8	58	32	5
18311356	Virtualization	200909	11	1	0	0	7	4	1	0	82	50	9	65	35	5
18311356	Virtualization	200911	14	1	0	0	5	4	1	0	96	52	10	76	36	5
18311356	Virtualization	201001	6	0	0	0	3	3	0	0	102	54	10	82	38	5
18311356	Virtualization	201002	2	0	0	0	2	1	0	0	104	56	10	83	39	5
18311356	Virtualization	201003	5	1	0	0	4	2	1	0	109	60	11	85	41	5
18311356	Virtualization	201004	3	1	0	0	3	2	1	0	112	62	12	87	42	5
18311356	Virtualization	201006	4	0	0	0	3	2	0	0	116	65	12	90	44	5
18311356	Virtualization	201007	1	0	0	0	1	1	0	0	117	66	12	91	45	5
18311356	Virtualization	201008	6	2	0	0	6	2	2	0	123	72	14	93	47	5
18311356	Virtualization	201009	1	0	0	0	1	1	0	0	124	73	14	94	48	5
18311356	Virtualization	201010	4	0	0	0	4	3	0	0	128	75	14	97	49	5
18311356	Virtualization	201011	5	0	0	0	2	2	0	0	133	76	14	102	50	5
18311356	Virtualization	201012	3	0	0	0	2	1	0	0	136	78	14	103	51	5
18311356	Virtualization	201101	2	1	0	0	2	1	1	0	138	80	15	104	52	5
18311356	Virtualization	201102	19	3	0	0	13	8	2	0	157	92	18	116	59	5
18311356	Virtualization	201103	14	3	0	0	8	5	2	0	171	100	21	125	64	5
18311356	Virtualization	201104	12	5	0	0	11	8	4	0	183	109	26	134	70	8
18311356	Virtualization	201105	11	2	0	0	7	4	1	0	194	115	28	142	73	9
18311356	Virtualization	201106	9	4	0	0	8	4	4	0	203	121	32	146	75	9
18311356	Virtualization	201107	2	1	0	0	2	1	1	0	205	122	33	147	75	9
18311356	Virtualization	201108	9	1	0	0	7	5	1	0	214	127	34	154	78	10
18311356	Virtualization	201109	3	0	0	0	3	1	0	0	217	130	34	155	79	10
18311356	Virtualization	201110	6	3	0	0	5	2	2	0	223	134	37	158	80	10
18311356	Virtualization	201111	2	1	0	0	2	1	1	0	225	135	38	159	80	10
18311356	Virtualization	201112	7	2	0	0	6	5	2	0	232	138	40	165	82	12
18311356	Virtualization	201201	13	2	0	0	9	4	2	0	245	145	42	170	84	12
18311356	Virtualization	201202	15	1	0	0	6	4	1	0	260	150	43	183	87	13
18311356	Virtualization	201203	10	2	0	0	8	5	2	0	270	158	45	189	92	14
18311356	Virtualization	201204	4	1	0	0	4	1	1	0	274	162	46	190	93	14
18311356	Virtualization	201205	8	1	0	0	6	3	1	0	282	167	47	195	95	14
18311356	Virtualization	201206	5	0	0	0	3	2	0	0	287	169	47	199	96	14
18311356	Virtualization	201207	7	1	0	0	5	3	1	0	294	173	48	203	98	15
18311356	Virtualization	201208	6	1	0	0	4	3	1	0	300	177	49	207	101	16
18311356	Virtualization	201209	14	3	0	0	14	6	3	0	314	190	52	213	106	16
18311356	Virtualization	201210	2	0	0	0	2	2	0	0	316	192	52	215	108	16
18311356	Virtualization	201211	6	1	0	0	6	2	1	0	322	197	53	217	109	16
18311356	Virtualization	201212	27	2	0	0	13	7	2	0	349	209	55	230	115	16
18311356	Virtualization	201301	8	1	0	0	7	3	1	0	357	216	56	233	118	16
18311356	Virtualization	201302	6	0	0	0	5	2	0	0	363	220	56	236	119	16
18311356	Virtualization	201303	14	2	0	0	10	6	2	0	377	228	58	246	123	16
18311356	Virtualization	201305	3	1	0	0	3	2	1	0	380	229	59	248	123	16
18311356	Virtualization	201306	1	0	0	0	1	0	0	0	381	230	59	248	123	16
18311356	Virtualization	201307	8	2	0	0	4	3	1	0	389	233	61	255	125	17
18311356	Virtualization	201308	4	0	0	0	2	2	0	0	393	234	61	259	126	17
18311356	Virtualization	201309	19	4	2	1	6	3	2	2	412	239	65	273	128	20
18311356	Virtualization	201310	6	2	0	0	5	3	2	0	418	243	67	277	130	20
18311356	Virtualization	201311	3	1	0	0	3	1	1	0	421	245	68	278	130	20
18311356	Virtualization	201312	8	2	0	0	5	3	2	0	429	250	70	282	133	20
18311356	Virtualization	201401	5	1	0	0	4	2	1	0	434	253	71	285	134	20
18311356	Virtualization	201402	5	2	0	0	5	3	2	0	439	257	73	288	136	20
18311356	Virtualization	201403	2	0	0	0	1	0	0	0	441	258	73	288	136	20
18311356	Virtualization	201404	4	1	0	0	4	2	1	0	445	262	74	290	138	20
18311356	Virtualization	201405	14	0	0	0	4	4	0	0	459	264	74	304	140	20
18311356	Virtualization	201406	2	1	0	0	2	1	1	0	461	265	75	305	140	20
18311356	Virtualization	201409	4	1	0	0	4	3	1	0	465	267	76	308	141	20
18311356	Virtualization	201410	4	0	0	0	3	1	0	0	469	269	76	309	141	20
18311356	Virtualization	201411	4	1	0	0	3	2	1	0	473	270	77	312	141	20
18311356	Virtualization	201412	6	0	0	0	3	2	0	0	479	271	77	317	141	20
18311356	Virtualization	201501	21	1	0	0	4	3	1	0	500	272	78	337	141	21
18311356	Virtualization	201502	7	2	0	0	5	3	2	0	507	275	80	342	142	22
18311356	Virtualization	201503	1	0	0	0	1	1	0	0	508	276	80	343	143	22
18311356	Virtualization	201504	12	2	0	0	7	4	2	0	520	280	82	352	144	22
18311356	Virtualization	201505	5	1	0	0	4	3	1	0	525	282	83	355	145	22
18311356	Virtualization	201506	6	0	0	0	2	1	0	0	531	283	83	356	145	22
18311356	Virtualization	201507	1	0	0	0	1	1	0	0	532	284	83	357	146	22
18311356	Virtualization	201508	2	0	0	0	1	1	0	0	534	284	83	359	146	22
18311356	Virtualization	201509	3	0	0	0	2	2	0	0	537	285	83	362	147	22
18311356	Virtualization	201510	8	1	0	0	6	5	1	0	545	290	84	369	151	23
18311356	Virtualization	201512	6	3	0	0	5	3	2	0	551	293	87	373	152	24
18311356	Virtualization	201601	3	0	0	0	2	1	0	0	554	295	87	374	153	24
18311356	Virtualization	201602	4	0	0	0	3	3	0	0	558	297	87	378	155	24
18311356	Virtualization	201604	2	0	0	0	1	0	0	0	560	298	87	378	155	24
18311356	Virtualization	201605	6	1	0	0	3	1	1	0	566	301	88	379	156	24
18311356	Virtualization	201607	5	2	0	0	4	4	2	0	571	304	90	384	158	26
18311356	Virtualization	201609	3	1	0	0	3	2	1	0	574	306	91	386	159	26
18311356	Virtualization	201610	9	4	1	0	5	4	4	1	583	309	95	392	161	29
18311356	Virtualization	201611	2	0	0	0	1	0	0	0	585	310	95	392	161	29
18311356	Virtualization	201612	15	3	0	0	7	5	3	0	600	315	98	397	163	31
18311356	Virtualization	201701	3	0	0	0	2	1	0	0	603	316	98	398	163	31
18311356	Virtualization	201702	17	2	0	0	6	2	1	0	620	321	100	402	164	31
18311356	Virtualization	201703	1	0	0	0	1	1	0	0	621	322	100	403	164	31
18311356	Virtualization	201704	11	4	0	0	8	6	3	0	632	328	104	410	166	34
18311356	Virtualization	201706	6	2	0	0	5	3	2	0	638	332	106	413	168	34
18311356	Virtualization	201707	3	0	0	0	2	2	0	0	641	333	106	416	169	34
18311356	Virtualization	201709	2	0	0	0	1	1	0	0	643	334	106	418	169	34
18311356	Virtualization	201710	6	2	0	0	4	3	2	0	649	337	108	422	171	35
18311356	Virtualization	201711	2	0	0	0	2	0	0	0	651	339	108	422	171	35
18311356	Virtualization	201801	2	1	0	0	2	2	1	0	653	340	109	424	172	36
18311356	Virtualization	201802	1	0	0	0	1	1	0	0	654	341	109	425	173	36
18311356	Virtualization	201806	2	1	0	0	2	1	1	0	656	342	110	426	173	36
18311356	Virtualization	201807	1	0	0	0	1	1	0	0	657	343	110	427	174	36
2133133	Visible_light_communication	200510	2	0	0	0	2	2	0	0	2	2	0	2	2	0
2133133	Visible_light_communication	200512	1	0	0	0	1	1	0	0	3	3	0	3	3	0
2133133	Visible_light_communication	200603	1	0	0	0	1	1	0	0	4	4	0	4	4	0
2133133	Visible_light_communication	200609	1	0	0	0	1	1	0	0	5	4	0	5	4	0
2133133	Visible_light_communication	200611	1	0	0	0	1	1	0	0	6	4	0	6	4	0
2133133	Visible_light_communication	200705	1	0	0	0	1	1	0	0	7	5	0	7	5	0
2133133	Visible_light_communication	200706	2	0	0	0	1	1	0	0	9	6	0	9	6	0
2133133	Visible_light_communication	200711	1	0	0	0	1	1	0	0	10	6	0	10	6	0
2133133	Visible_light_communication	200802	1	0	0	0	1	1	0	0	11	7	0	11	7	0
2133133	Visible_light_communication	200803	3	0	0	0	3	2	0	0	14	10	0	13	9	0
2133133	Visible_light_communication	200810	1	0	0	0	1	1	0	0	15	10	0	14	9	0
2133133	Visible_light_communication	200902	7	0	0	0	5	4	0	0	22	13	0	20	11	0
2133133	Visible_light_communication	200912	1	0	0	0	1	1	0	0	23	14	0	21	12	0
2133133	Visible_light_communication	201001	5	2	0	0	3	1	1	0	28	17	2	23	13	0
2133133	Visible_light_communication	201002	12	0	0	0	7	4	0	0	40	23	2	30	17	0
2133133	Visible_light_communication	201003	2	0	0	0	2	1	0	0	42	23	2	31	17	0
2133133	Visible_light_communication	201006	2	1	0	0	2	1	1	0	44	25	3	32	18	0
2133133	Visible_light_communication	201007	1	0	0	0	1	1	0	0	45	26	3	33	19	0
2133133	Visible_light_communication	201011	1	0	0	0	1	1	0	0	46	27	3	34	20	0
2133133	Visible_light_communication	201101	2	0	0	0	1	1	0	0	48	28	3	36	21	0
2133133	Visible_light_communication	201102	3	0	0	0	3	3	0	0	51	30	3	39	23	0
2133133	Visible_light_communication	201105	2	0	0	0	1	1	0	0	53	31	3	41	24	0
2133133	Visible_light_communication	201106	2	0	0	0	1	1	0	0	55	32	3	43	25	0
2133133	Visible_light_communication	201107	5	0	0	0	2	2	0	0	60	34	3	48	27	0
2133133	Visible_light_communication	201108	5	2	0	0	4	3	2	0	65	38	5	51	30	0
2133133	Visible_light_communication	201111	2	0	0	0	1	1	0	0	67	39	5	53	31	0
2133133	Visible_light_communication	201112	2	0	0	0	2	2	0	0	69	41	5	55	33	0
2133133	Visible_light_communication	201201	1	0	0	0	1	0	0	0	70	42	5	55	33	0
2133133	Visible_light_communication	201203	1	0	0	0	1	1	0	0	71	43	5	56	34	0
2133133	Visible_light_communication	201204	1	0	0	0	1	1	0	0	72	44	5	57	35	0
2133133	Visible_light_communication	201205	5	0	0	0	4	4	0	0	77	48	5	62	39	0
2133133	Visible_light_communication	201206	1	0	0	0	1	1	0	0	78	49	5	63	40	0
2133133	Visible_light_communication	201207	2	0	0	0	2	1	0	0	80	51	5	64	41	0
2133133	Visible_light_communication	201208	1	0	0	0	1	1	0	0	81	51	5	65	41	0
2133133	Visible_light_communication	201209	1	0	0	0	1	0	0	0	82	52	5	65	41	0
2133133	Visible_light_communication	201210	5	0	0	0	2	2	0	0	87	53	5	70	42	0
2133133	Visible_light_communication	201211	2	0	0	0	2	2	0	0	89	55	5	72	44	0
2133133	Visible_light_communication	201302	2	0	0	0	2	1	0	0	91	57	5	73	45	0
2133133	Visible_light_communication	201303	2	0	0	0	2	2	0	0	93	58	5	75	46	0
2133133	Visible_light_communication	201305	4	0	0	0	1	1	0	0	97	59	5	79	47	0
2133133	Visible_light_communication	201306	1	0	0	0	1	0	0	0	98	60	5	79	47	0
2133133	Visible_light_communication	201310	1	0	0	0	1	0	0	0	99	61	5	79	47	0
2133133	Visible_light_communication	201311	1	0	0	0	1	0	0	0	100	62	5	79	47	0
2133133	Visible_light_communication	201312	5	0	0	0	5	5	0	0	105	67	5	84	52	0
2133133	Visible_light_communication	201401	4	1	0	0	4	4	1	0	109	70	6	88	55	1
2133133	Visible_light_communication	201402	3	0	0	0	2	1	0	0	112	72	6	90	56	1
2133133	Visible_light_communication	201404	6	0	0	0	5	5	0	0	118	77	6	96	61	1
2133133	Visible_light_communication	201405	3	0	0	0	2	1	0	0	121	79	6	97	62	1
2133133	Visible_light_communication	201406	1	0	0	0	1	1	0	0	122	80	6	98	63	1
2133133	Visible_light_communication	201407	3	0	0	0	2	2	0	0	125	80	6	101	63	1
2133133	Visible_light_communication	201408	3	0	0	0	3	2	0	0	128	83	6	103	65	1
2133133	Visible_light_communication	201409	1	0	0	0	1	1	0	0	129	84	6	104	66	1
2133133	Visible_light_communication	201410	1	0	0	0	1	0	0	0	130	85	6	104	66	1
2133133	Visible_light_communication	201411	5	1	0	0	3	2	1	0	135	88	7	106	68	1
2133133	Visible_light_communication	201502	1	0	0	0	1	1	0	0	136	89	7	107	69	1
2133133	Visible_light_communication	201503	1	0	0	0	1	1	0	0	137	90	7	108	70	1
2133133	Visible_light_communication	201504	4	2	0	0	4	2	2	0	141	93	9	110	71	1
2133133	Visible_light_communication	201506	1	1	0	0	1	0	1	0	142	94	10	110	71	2
2133133	Visible_light_communication	201508	1	0	0	0	1	1	0	0	143	95	10	111	72	2
2133133	Visible_light_communication	201509	1	0	0	0	1	1	0	0	144	96	10	112	73	2
2133133	Visible_light_communication	201512	6	0	0	0	2	1	0	0	150	98	10	113	74	2
2133133	Visible_light_communication	201601	6	1	0	0	4	3	1	0	156	102	11	118	77	2
2133133	Visible_light_communication	201603	1	0	0	0	1	1	0	0	157	103	11	119	78	2
2133133	Visible_light_communication	201605	2	0	0	0	2	2	0	0	159	104	11	121	79	2
2133133	Visible_light_communication	201606	1	0	0	0	1	1	0	0	160	105	11	122	80	2
2133133	Visible_light_communication	201607	1	0	0	0	1	0	0	0	161	106	11	122	80	2
2133133	Visible_light_communication	201608	2	0	0	0	2	2	0	0	163	107	11	124	81	2
2133133	Visible_light_communication	201609	2	1	0	0	2	1	1	0	165	109	12	125	82	2
2133133	Visible_light_communication	201610	1	0	0	0	1	1	0	0	166	110	12	126	83	2
2133133	Visible_light_communication	201611	2	0	0	0	1	1	0	0	168	111	12	128	84	2
2133133	Visible_light_communication	201701	6	2	0	0	6	4	2	0	174	114	14	132	85	2
2133133	Visible_light_communication	201705	2	1	0	0	2	2	1	0	176	116	15	134	86	3
2133133	Visible_light_communication	201707	3	0	0	0	2	2	0	0	179	118	15	137	88	3
2133133	Visible_light_communication	201709	1	0	0	0	1	1	0	0	180	119	15	138	89	3
2133133	Visible_light_communication	201710	6	0	0	0	3	3	0	0	186	122	15	144	92	3
2133133	Visible_light_communication	201712	2	0	0	0	1	1	0	0	188	123	15	146	93	3
2133133	Visible_light_communication	201802	1	0	0	0	1	1	0	0	189	124	15	147	94	3
2133133	Visible_light_communication	201803	1	0	0	0	1	1	0	0	190	125	15	148	95	3
2133133	Visible_light_communication	201804	3	0	0	0	3	1	0	0	193	127	15	149	95	3
2133133	Visible_light_communication	201806	6	0	0	0	3	2	0	0	199	129	15	154	96	3
2133133	Visible_light_communication	201807	5	0	0	0	3	1	0	0	204	132	15	155	97	3
41435368	VyOS	201401	12	0	0	0	4	4	0	0	12	4	0	12	4	0
41435368	VyOS	201402	11	0	0	0	6	5	0	0	23	9	0	22	8	0
41435368	VyOS	201404	3	0	0	0	2	2	0	0	26	10	0	25	9	0
41435368	VyOS	201405	1	0	0	0	1	1	0	0	27	10	0	26	9	0
41435368	VyOS	201407	3	0	0	0	2	1	0	0	30	11	0	28	9	0
41435368	VyOS	201410	4	0	0	0	2	2	0	0	34	13	0	32	11	0
41435368	VyOS	201411	9	0	0	0	5	3	0	0	43	18	0	37	14	0
41435368	VyOS	201501	2	0	0	0	1	1	0	0	45	19	0	39	15	0
41435368	VyOS	201502	2	0	0	0	1	1	0	0	47	20	0	41	16	0
41435368	VyOS	201503	3	0	0	0	2	2	0	0	50	21	0	44	17	0
41435368	VyOS	201504	1	0	0	0	1	1	0	0	51	22	0	45	18	0
41435368	VyOS	201508	7	0	0	0	4	4	0	0	58	25	0	52	21	0
41435368	VyOS	201509	1	0	0	0	1	1	0	0	59	25	0	53	21	0
41435368	VyOS	201511	1	0	0	0	1	1	0	0	60	26	0	54	21	0
41435368	VyOS	201512	2	0	0	0	1	0	0	0	62	27	0	54	21	0
41435368	VyOS	201601	2	0	0	0	2	1	0	0	64	29	0	55	22	0
41435368	VyOS	201602	1	0	0	0	1	1	0	0	65	30	0	56	23	0
41435368	VyOS	201606	3	0	0	0	2	1	0	0	68	32	0	57	24	0
41435368	VyOS	201609	2	0	0	0	1	1	0	0	70	33	0	59	25	0
41435368	VyOS	201612	3	0	0	0	1	0	0	0	73	34	0	59	25	0
41435368	VyOS	201709	2	0	0	0	2	0	0	0	75	36	0	59	25	0
41435368	VyOS	201711	4	0	0	0	3	2	0	0	79	38	0	61	26	0
41435368	VyOS	201802	2	0	0	0	1	1	0	0	81	38	0	63	26	0
41435368	VyOS	201803	6	2	1	0	3	3	2	1	87	41	2	69	29	2
41435368	VyOS	201806	3	0	0	0	2	2	0	0	90	43	2	72	30	2
41435368	VyOS	201807	5	0	0	0	2	2	0	0	95	45	2	77	32	2
4059023	Web_search_engine	200708	1	0	0	0	1	1	0	0	1	1	0	1	1	0
4059023	Web_search_engine	200709	18	0	0	0	5	4	0	0	19	6	0	16	5	0
4059023	Web_search_engine	200710	13	1	0	0	4	2	1	0	32	10	1	27	7	0
4059023	Web_search_engine	200711	11	3	0	0	10	6	3	0	43	19	4	34	12	2
4059023	Web_search_engine	200712	29	1	0	0	13	9	1	0	72	31	5	56	20	3
4059023	Web_search_engine	200801	2	0	0	0	2	2	0	0	74	33	5	58	22	3
4059023	Web_search_engine	200802	40	10	0	0	21	15	9	0	114	53	15	85	36	7
4059023	Web_search_engine	200803	73	21	0	0	37	20	12	0	187	87	36	126	53	8
4059023	Web_search_engine	200804	97	35	1	0	42	25	15	1	284	123	71	197	72	23
4059023	Web_search_engine	200805	68	22	2	1	47	24	16	2	352	164	93	234	90	30
4059023	Web_search_engine	200806	52	15	2	1	31	18	10	2	404	187	108	265	100	33
4059023	Web_search_engine	200807	51	14	0	0	26	13	3	0	455	210	122	292	110	37
4059023	Web_search_engine	200808	58	18	1	0	37	21	13	1	513	241	140	326	125	44
4059023	Web_search_engine	200809	1	0	0	0	1	1	0	0	514	241	140	327	125	44
4059023	Web_search_engine	200810	52	21	0	0	36	18	11	0	566	273	161	356	139	46
4059023	Web_search_engine	200811	47	10	0	0	22	9	4	0	613	290	171	379	144	47
4059023	Web_search_engine	200812	59	22	0	0	34	17	11	0	672	320	193	407	157	50
4059023	Web_search_engine	200901	15	2	0	0	9	8	2	0	687	326	195	420	162	52
4059023	Web_search_engine	200902	5	1	0	0	4	4	1	0	692	329	196	425	165	53
4059023	Web_search_engine	200903	13	2	0	0	9	9	1	0	705	334	198	438	170	55
4059023	Web_search_engine	200904	59	14	5	3	27	16	9	2	764	355	212	475	180	60
4059023	Web_search_engine	200905	53	15	0	0	25	12	3	0	817	378	227	502	190	66
4059023	Web_search_engine	200906	34	11	0	0	22	13	4	0	851	395	238	523	198	70
4059023	Web_search_engine	200907	42	10	0	0	30	17	7	0	893	421	248	547	211	71
4059023	Web_search_engine	200908	40	11	0	0	26	18	8	0	933	441	259	574	223	75
4059023	Web_search_engine	200909	58	11	0	0	36	17	8	0	991	472	270	604	235	77
4059023	Web_search_engine	200910	54	17	1	0	42	25	13	1	1045	503	287	637	250	85
4059023	Web_search_engine	200911	144	35	0	0	54	39	14	0	1189	546	322	754	279	106
4059023	Web_search_engine	200912	65	16	0	0	35	23	10	0	1254	573	338	804	294	113
4059023	Web_search_engine	201001	48	10	0	0	30	14	6	0	1302	593	348	823	299	116
4059023	Web_search_engine	201002	46	8	0	0	26	10	5	0	1348	614	356	848	304	118
4059023	Web_search_engine	201003	4	0	0	0	3	3	0	0	1352	617	356	852	307	118
4059023	Web_search_engine	201004	8	0	0	0	7	7	0	0	1360	622	356	860	312	118
4059023	Web_search_engine	201005	6	1	0	0	4	4	1	0	1366	625	357	866	315	119
4059023	Web_search_engine	201006	5	1	0	0	4	4	1	0	1371	628	358	871	318	120
4059023	Web_search_engine	201007	15	2	0	0	8	8	1	0	1386	635	360	886	325	122
4059023	Web_search_engine	201008	19	5	0	0	18	14	5	0	1405	648	365	901	334	124
4059023	Web_search_engine	201009	29	7	0	0	24	14	5	0	1434	664	372	919	341	125
4059023	Web_search_engine	201010	54	18	0	0	33	17	10	0	1488	691	390	952	352	130
4059023	Web_search_engine	201011	38	14	0	0	21	10	5	0	1526	707	404	974	358	135
4059023	Web_search_engine	201012	63	14	0	0	36	20	9	0	1589	738	418	1004	373	139
4059023	Web_search_engine	201101	26	5	0	0	17	9	3	0	1615	753	423	1018	380	141
4059023	Web_search_engine	201102	52	14	0	0	31	15	8	0	1667	779	437	1049	391	145
4059023	Web_search_engine	201103	25	9	0	0	14	10	4	0	1692	789	446	1069	397	151
4059023	Web_search_engine	201104	37	8	0	0	22	11	6	0	1729	803	454	1084	400	151
4059023	Web_search_engine	201105	30	6	0	0	12	9	3	0	1759	813	460	1108	407	154
4059023	Web_search_engine	201106	56	19	0	0	32	21	11	0	1815	837	479	1149	420	163
4059023	Web_search_engine	201107	40	12	0	0	28	15	7	0	1855	854	491	1171	425	166
4059023	Web_search_engine	201108	13	1	0	0	7	5	1	0	1868	859	492	1179	428	167
4059023	Web_search_engine	201109	13	0	0	0	10	7	0	0	1881	868	492	1186	434	167
4059023	Web_search_engine	201110	27	8	0	0	21	14	7	0	1908	883	500	1203	442	169
4059023	Web_search_engine	201111	12	2	0	0	11	6	2	0	1920	891	502	1209	445	170
4059023	Web_search_engine	201112	45	7	0	0	20	9	6	0	1965	908	509	1224	451	171
4059023	Web_search_engine	201201	30	7	0	0	20	12	4	0	1995	925	516	1239	460	173
4059023	Web_search_engine	201202	29	7	0	0	26	12	5	0	2024	947	523	1254	468	174
4059023	Web_search_engine	201203	42	16	0	0	24	14	8	0	2066	967	539	1278	478	177
4059023	Web_search_engine	201204	22	6	0	0	16	8	4	0	2088	980	545	1288	483	178
4059023	Web_search_engine	201205	32	7	0	0	20	9	4	0	2120	997	552	1306	489	180
4059023	Web_search_engine	201206	31	10	1	0	23	13	7	1	2151	1014	562	1324	497	184
4059023	Web_search_engine	201207	28	10	0	0	19	9	6	0	2179	1027	572	1339	500	185
4059023	Web_search_engine	201208	20	8	0	0	17	10	6	0	2199	1040	580	1351	506	188
4059023	Web_search_engine	201209	18	7	0	0	15	8	5	0	2217	1049	587	1361	508	188
4059023	Web_search_engine	201210	25	9	0	0	18	8	5	0	2242	1061	596	1374	510	188
4059023	Web_search_engine	201211	20	6	1	0	11	5	4	1	2262	1071	602	1386	514	190
4059023	Web_search_engine	201212	20	6	0	0	15	10	5	0	2282	1081	608	1401	519	192
4059023	Web_search_engine	201301	34	10	2	1	18	10	6	2	2316	1092	618	1420	522	194
4059023	Web_search_engine	201302	27	9	0	0	21	13	8	0	2343	1107	627	1434	529	197
4059023	Web_search_engine	201303	14	1	0	0	8	6	1	0	2357	1114	628	1446	534	197
4059023	Web_search_engine	201304	49	6	0	0	17	11	4	0	2406	1127	634	1464	541	198
4059023	Web_search_engine	201305	27	5	0	0	21	12	4	0	2433	1143	639	1478	548	200
4059023	Web_search_engine	201306	28	8	0	0	23	10	6	0	2461	1162	647	1490	554	201
4059023	Web_search_engine	201307	28	10	1	0	22	12	9	1	2489	1180	657	1505	562	204
4059023	Web_search_engine	201308	28	6	0	0	19	12	6	0	2517	1193	663	1523	568	206
4059023	Web_search_engine	201309	8	2	0	0	6	4	2	0	2525	1198	665	1529	571	206
4059023	Web_search_engine	201310	31	11	2	1	21	13	8	2	2556	1214	676	1550	579	212
4059023	Web_search_engine	201311	11	3	0	0	10	4	3	0	2567	1222	679	1554	581	213
4059023	Web_search_engine	201312	13	3	0	0	11	7	3	0	2580	1230	682	1561	585	213
4059023	Web_search_engine	201401	14	2	0	0	9	3	2	0	2594	1238	684	1564	587	213
4059023	Web_search_engine	201402	16	4	0	0	14	11	4	0	2610	1248	688	1577	594	214
4059023	Web_search_engine	201403	22	6	0	0	15	10	5	0	2632	1259	694	1589	600	217
4059023	Web_search_engine	201404	36	10	0	0	27	15	9	0	2668	1280	704	1607	610	218
4059023	Web_search_engine	201405	35	10	0	0	20	14	5	0	2703	1294	714	1635	618	221
4059023	Web_search_engine	201406	12	2	0	0	8	5	2	0	2715	1301	716	1643	622	223
4059023	Web_search_engine	201407	49	10	0	0	27	17	6	0	2764	1322	726	1681	633	227
4059023	Web_search_engine	201408	15	2	0	0	10	7	2	0	2779	1329	728	1689	637	228
4059023	Web_search_engine	201409	37	10	0	0	24	15	7	0	2816	1346	738	1714	645	233
4059023	Web_search_engine	201410	23	2	0	0	12	10	2	0	2839	1354	740	1727	651	235
4059023	Web_search_engine	201411	17	7	0	0	14	10	6	0	2856	1364	747	1740	657	239
4059023	Web_search_engine	201412	24	9	1	0	16	12	9	1	2880	1377	756	1759	666	244
4059023	Web_search_engine	201501	19	6	1	0	13	12	6	1	2899	1386	762	1776	674	250
4059023	Web_search_engine	201502	14	3	0	0	10	6	2	0	2913	1393	765	1783	677	251
4059023	Web_search_engine	201503	12	3	0	0	11	7	3	0	2925	1401	768	1791	680	252
4059023	Web_search_engine	201504	11	3	0	0	10	7	3	0	2936	1410	771	1799	686	254
4059023	Web_search_engine	201505	17	7	0	0	11	5	4	0	2953	1417	778	1807	687	255
4059023	Web_search_engine	201506	18	5	0	0	14	6	4	0	2971	1426	783	1814	688	256
4059023	Web_search_engine	201507	12	4	0	0	10	8	4	0	2983	1432	787	1824	692	258
4059023	Web_search_engine	201508	20	7	0	0	16	12	7	0	3003	1441	794	1838	697	261
4059023	Web_search_engine	201509	17	6	0	0	10	7	4	0	3020	1449	800	1850	702	264
4059023	Web_search_engine	201510	18	4	0	0	13	10	4	0	3038	1459	804	1865	709	266
4059023	Web_search_engine	201511	26	1	0	0	16	10	1	0	3064	1469	805	1884	713	267
4059023	Web_search_engine	201512	19	6	0	0	16	12	5	0	3083	1480	811	1899	719	271
4059023	Web_search_engine	201601	23	5	0	0	16	13	3	0	3106	1489	816	1916	725	273
4059023	Web_search_engine	201602	16	7	0	0	15	9	7	0	3122	1498	823	1926	728	275
4059023	Web_search_engine	201603	11	4	0	0	11	5	4	0	3133	1505	827	1931	729	276
4059023	Web_search_engine	201604	23	10	0	0	20	17	9	0	3156	1520	837	1951	741	283
4059023	Web_search_engine	201605	12	2	0	0	10	5	2	0	3168	1529	839	1956	745	283
4059023	Web_search_engine	201606	21	6	0	0	15	11	5	0	3189	1540	845	1970	752	287
4059023	Web_search_engine	201607	6	1	0	0	6	3	1	0	3195	1545	846	1973	753	288
4059023	Web_search_engine	201608	14	6	0	0	10	6	4	0	3209	1552	852	1983	755	290
4059023	Web_search_engine	201609	11	4	0	0	8	4	2	0	3220	1558	856	1989	756	290
4059023	Web_search_engine	201610	25	6	0	0	16	10	4	0	3245	1568	862	2001	759	292
4059023	Web_search_engine	201611	42	14	0	0	26	18	10	0	3287	1587	876	2030	769	298
4059023	Web_search_engine	201612	17	4	0	0	14	12	4	0	3304	1595	880	2045	774	301
4059023	Web_search_engine	201701	22	5	0	0	19	13	5	0	3326	1608	885	2061	781	303
4059023	Web_search_engine	201702	18	4	0	0	11	7	3	0	3344	1617	889	2075	785	304
4059023	Web_search_engine	201703	16	9	2	1	12	8	7	2	3360	1624	898	2084	788	308
4059023	Web_search_engine	201704	23	6	0	0	16	11	6	0	3383	1635	904	2097	794	311
4059023	Web_search_engine	201705	7	3	0	0	7	6	3	0	3390	1639	907	2103	797	313
4059023	Web_search_engine	201706	13	2	0	0	10	6	2	0	3403	1647	909	2112	801	313
4059023	Web_search_engine	201707	26	10	0	0	21	13	7	0	3429	1664	919	2128	809	316
4059023	Web_search_engine	201708	13	4	0	0	9	6	3	0	3442	1672	923	2136	814	318
4059023	Web_search_engine	201709	5	2	0	0	4	2	1	0	3447	1674	925	2139	814	318
4059023	Web_search_engine	201710	17	9	3	1	11	7	5	2	3464	1682	934	2151	817	323
4059023	Web_search_engine	201711	14	7	0	0	11	9	6	0	3478	1690	941	2163	823	328
4059023	Web_search_engine	201712	14	5	0	0	13	9	5	0	3492	1701	946	2172	829	330
4059023	Web_search_engine	201801	21	4	0	0	10	7	3	0	3513	1711	950	2182	836	330
4059023	Web_search_engine	201802	20	6	0	0	17	12	5	0	3533	1724	956	2196	843	332
4059023	Web_search_engine	201803	32	9	0	0	25	21	8	0	3565	1745	965	2223	858	336
4059023	Web_search_engine	201804	19	4	0	0	14	10	3	0	3584	1756	969	2236	865	338
4059023	Web_search_engine	201805	5	1	0	0	4	3	1	0	3589	1758	970	2239	866	339
4059023	Web_search_engine	201806	33	15	5	4	22	16	9	2	3622	1775	985	2262	876	348
4059023	Web_search_engine	201807	12	2	0	0	9	8	2	0	3634	1783	987	2273	882	349
471844	WiMAX	200309	1	0	0	0	1	1	0	0	1	1	0	1	1	0
471844	WiMAX	200402	1	0	0	0	1	1	0	0	2	2	0	2	2	0
471844	WiMAX	200403	17	0	0	0	3	3	0	0	19	5	0	19	5	0
471844	WiMAX	200404	2	0	0	0	2	1	0	0	21	7	0	20	6	0
471844	WiMAX	200405	5	0	0	0	4	3	0	0	26	10	0	24	8	0
471844	WiMAX	200406	4	0	0	0	2	1	0	0	30	11	0	27	8	0
471844	WiMAX	200407	8	0	0	0	5	2	0	0	38	14	0	32	8	0
471844	WiMAX	200408	6	1	0	0	3	2	1	0	44	16	1	34	9	0
471844	WiMAX	200409	5	1	0	0	4	3	1	0	49	19	2	38	11	0
471844	WiMAX	200410	8	0	0	0	8	4	0	0	57	25	2	42	13	0
471844	WiMAX	200411	12	2	0	0	11	3	2	0	69	33	4	46	13	0
471844	WiMAX	200412	23	1	0	0	18	10	1	0	92	49	5	59	21	0
471844	WiMAX	200501	14	3	0	0	10	6	3	0	106	58	8	66	26	0
471844	WiMAX	200502	25	2	0	0	15	2	1	0	131	71	10	70	26	0
471844	WiMAX	200503	6	1	0	0	6	1	1	0	137	77	11	71	27	0
471844	WiMAX	200504	7	0	0	0	4	0	0	0	144	81	11	71	27	0
471844	WiMAX	200505	54	4	0	0	34	8	3	0	198	112	15	83	32	1
471844	WiMAX	200506	22	1	0	0	13	8	1	0	220	123	16	98	38	1
471844	WiMAX	200507	22	3	0	0	15	5	3	0	242	136	19	103	41	1
471844	WiMAX	200508	40	2	0	0	27	8	1	0	282	162	21	113	49	1
471844	WiMAX	200509	36	2	0	0	28	8	1	0	318	188	23	125	56	1
471844	WiMAX	200510	42	1	0	0	27	9	1	0	360	212	24	136	64	1
471844	WiMAX	200511	45	2	0	0	33	13	2	0	405	243	26	158	76	1
471844	WiMAX	200512	47	9	0	0	31	13	8	0	452	270	35	176	86	1
471844	WiMAX	200601	43	6	0	0	34	15	5	0	495	299	41	194	97	2
471844	WiMAX	200602	42	4	0	0	33	13	4	0	537	330	45	208	108	2
471844	WiMAX	200603	38	2	0	0	30	13	2	0	575	356	47	224	118	2
471844	WiMAX	200604	58	4	0	0	41	15	3	0	633	394	51	243	130	2
471844	WiMAX	200605	50	3	0	0	34	12	2	0	683	424	54	260	139	2
471844	WiMAX	200606	60	3	0	0	41	20	3	0	743	463	57	291	157	2
471844	WiMAX	200607	25	1	0	0	20	10	1	0	768	479	58	303	165	2
471844	WiMAX	200608	28	4	0	0	20	11	4	0	796	496	62	319	173	4
471844	WiMAX	200609	64	9	0	0	49	26	8	0	860	536	71	353	190	6
471844	WiMAX	200610	62	2	0	0	35	15	1	0	922	567	73	387	202	6
471844	WiMAX	200611	75	7	0	0	46	13	5	0	997	608	80	408	211	7
471844	WiMAX	200612	122	8	0	0	61	24	7	0	1119	663	88	468	230	8
471844	WiMAX	200701	86	9	0	0	52	17	6	0	1205	710	97	509	244	10
471844	WiMAX	200702	90	6	0	0	53	15	4	0	1295	756	103	535	254	10
471844	WiMAX	200703	44	9	0	0	31	14	8	0	1339	781	112	558	262	10
471844	WiMAX	200704	67	6	0	0	47	20	6	0	1406	825	118	587	279	10
471844	WiMAX	200705	80	8	0	0	46	12	6	0	1486	869	126	610	289	11
471844	WiMAX	200706	62	4	0	0	31	9	4	0	1548	896	130	632	295	12
471844	WiMAX	200707	51	4	0	0	32	11	4	0	1599	925	134	645	303	12
471844	WiMAX	200708	39	7	0	0	29	12	5	0	1638	951	141	661	312	12
471844	WiMAX	200709	58	8	0	0	40	15	4	0	1696	984	149	686	322	13
471844	WiMAX	200710	57	7	0	0	36	15	6	0	1753	1012	156	710	330	13
471844	WiMAX	200711	75	17	1	0	39	10	7	1	1828	1044	173	736	336	15
471844	WiMAX	200712	55	11	1	0	35	14	7	1	1883	1073	184	767	344	17
471844	WiMAX	200801	62	11	0	0	41	18	10	0	1945	1107	195	793	356	19
471844	WiMAX	200802	53	9	2	0	32	12	5	1	1998	1134	204	819	363	24
471844	WiMAX	200803	33	5	0	0	24	11	3	0	2031	1155	209	834	372	25
471844	WiMAX	200804	84	6	0	0	22	12	3	0	2115	1175	215	900	382	27
471844	WiMAX	200805	49	6	0	0	29	10	6	0	2164	1199	221	922	387	27
471844	WiMAX	200806	98	8	0	0	33	18	4	0	2262	1223	229	993	398	28
471844	WiMAX	200807	71	12	0	0	43	14	9	0	2333	1256	241	1026	404	29
471844	WiMAX	200808	59	12	1	0	36	18	8	1	2392	1285	253	1053	415	30
471844	WiMAX	200809	64	10	0	0	40	25	6	0	2456	1316	263	1095	433	32
471844	WiMAX	200810	57	12	0	0	32	14	5	0	2513	1343	275	1119	443	34
471844	WiMAX	200811	41	7	0	0	27	11	5	0	2554	1364	282	1138	448	34
471844	WiMAX	200812	50	11	0	0	30	14	9	0	2604	1388	293	1156	457	35
471844	WiMAX	200901	45	13	0	0	27	14	9	0	2649	1408	306	1179	465	37
471844	WiMAX	200902	59	14	0	0	34	18	9	0	2708	1430	320	1206	472	38
471844	WiMAX	200903	74	18	0	0	41	18	5	0	2782	1465	338	1243	484	40
471844	WiMAX	200904	90	9	0	0	38	12	6	0	2872	1499	347	1268	492	40
471844	WiMAX	200905	42	3	0	0	31	18	3	0	2914	1525	350	1295	506	41
471844	WiMAX	200906	18	4	0	0	14	7	4	0	2932	1537	354	1302	511	42
471844	WiMAX	200907	20	3	0	0	14	9	3	0	2952	1547	357	1316	516	42
471844	WiMAX	200908	31	6	0	0	16	5	3	0	2983	1561	363	1325	519	43
471844	WiMAX	200909	25	7	0	0	19	8	5	0	3008	1576	370	1337	523	44
471844	WiMAX	200910	26	3	0	0	18	10	3	0	3034	1591	373	1353	530	45
471844	WiMAX	200911	34	4	0	0	17	8	4	0	3068	1604	377	1364	534	46
471844	WiMAX	200912	31	8	0	0	18	10	4	0	3099	1617	385	1385	539	50
471844	WiMAX	201001	12	4	0	0	12	8	4	0	3111	1625	389	1393	543	52
471844	WiMAX	201002	24	5	0	0	18	10	3	0	3135	1637	394	1406	547	52
471844	WiMAX	201003	28	5	0	0	22	14	4	0	3163	1653	399	1421	555	52
471844	WiMAX	201004	30	4	0	0	23	10	2	0	3193	1674	403	1436	563	52
471844	WiMAX	201005	50	3	0	0	23	7	3	0	3243	1693	406	1466	567	52
471844	WiMAX	201006	47	5	0	0	31	13	4	0	3290	1717	411	1488	575	52
471844	WiMAX	201007	24	2	0	0	13	8	2	0	3314	1727	413	1503	580	53
471844	WiMAX	201008	30	6	0	0	20	6	4	0	3344	1745	419	1511	584	53
471844	WiMAX	201009	22	3	0	0	18	9	3	0	3366	1760	422	1523	590	53
471844	WiMAX	201010	25	7	0	0	17	8	6	0	3391	1774	429	1532	595	53
471844	WiMAX	201011	25	5	2	1	17	12	4	2	3416	1785	434	1548	601	54
471844	WiMAX	201012	21	2	0	0	17	6	2	0	3437	1799	436	1554	604	54
471844	WiMAX	201101	22	7	1	0	15	6	6	1	3459	1809	443	1562	605	55
471844	WiMAX	201102	20	4	0	0	13	6	2	0	3479	1821	447	1573	610	56
471844	WiMAX	201103	12	2	0	0	11	5	2	0	3491	1830	449	1578	613	56
471844	WiMAX	201104	12	2	0	0	12	7	2	0	3503	1841	451	1585	619	56
471844	WiMAX	201105	9	2	0	0	6	1	1	0	3512	1845	453	1587	619	56
471844	WiMAX	201106	4	0	0	0	3	2	0	0	3516	1848	453	1590	621	56
471844	WiMAX	201107	11	3	0	0	11	7	3	0	3527	1857	456	1597	626	56
471844	WiMAX	201108	7	0	0	0	6	2	0	0	3534	1863	456	1599	628	56
471844	WiMAX	201109	20	2	0	0	7	4	2	0	3554	1867	458	1616	629	57
471844	WiMAX	201110	16	1	0	0	11	6	1	0	3570	1876	459	1625	633	57
471844	WiMAX	201111	7	2	0	0	7	4	2	0	3577	1881	461	1629	635	57
471844	WiMAX	201112	19	1	0	0	10	5	1	0	3596	1891	462	1638	640	57
471844	WiMAX	201201	7	2	0	0	6	3	2	0	3603	1896	464	1641	642	57
471844	WiMAX	201202	5	1	0	0	3	1	1	0	3608	1898	465	1642	642	57
471844	WiMAX	201203	12	4	1	0	9	6	4	1	3620	1905	469	1650	646	58
471844	WiMAX	201204	11	2	0	0	7	4	2	0	3631	1910	471	1654	648	58
471844	WiMAX	201205	10	0	0	0	8	5	0	0	3641	1916	471	1660	651	58
471844	WiMAX	201206	9	1	0	0	8	1	1	0	3650	1924	472	1662	652	58
471844	WiMAX	201207	6	1	0	0	6	3	1	0	3656	1929	473	1665	654	58
471844	WiMAX	201208	2	0	0	0	2	1	0	0	3658	1930	473	1666	655	58
471844	WiMAX	201209	13	1	0	0	10	7	1	0	3671	1939	474	1676	661	58
471844	WiMAX	201210	4	1	0	0	4	2	1	0	3675	1942	475	1678	662	58
471844	WiMAX	201211	19	5	0	0	14	9	4	0	3694	1952	480	1689	667	60
471844	WiMAX	201212	7	1	0	0	6	4	1	0	3701	1958	481	1694	671	60
471844	WiMAX	201301	21	4	0	0	15	8	4	0	3722	1969	485	1707	675	61
471844	WiMAX	201302	9	2	0	0	8	5	1	0	3731	1975	487	1713	678	61
471844	WiMAX	201303	10	3	0	0	6	3	2	0	3741	1980	490	1717	680	61
471844	WiMAX	201304	13	3	0	0	11	6	3	0	3754	1987	493	1723	682	61
471844	WiMAX	201305	7	2	0	0	7	4	2	0	3761	1991	495	1727	683	61
471844	WiMAX	201306	5	0	0	0	4	2	0	0	3766	1994	495	1729	684	61
471844	WiMAX	201307	3	1	0	0	3	1	1	0	3769	1996	496	1730	684	61
471844	WiMAX	201308	4	2	0	0	4	2	2	0	3773	1999	498	1732	685	61
471844	WiMAX	201309	7	1	0	0	5	3	1	0	3780	2001	499	1736	685	61
471844	WiMAX	201310	3	0	0	0	3	1	0	0	3783	2004	499	1737	686	61
471844	WiMAX	201311	2	0	0	0	2	2	0	0	3785	2006	499	1739	688	61
471844	WiMAX	201312	4	0	0	0	3	1	0	0	3789	2009	499	1740	689	61
471844	WiMAX	201401	4	0	0	0	4	2	0	0	3793	2012	499	1742	690	61
471844	WiMAX	201402	4	1	0	0	4	3	1	0	3797	2015	500	1745	692	61
471844	WiMAX	201403	8	3	0	0	8	5	3	0	3805	2021	503	1750	695	61
471844	WiMAX	201404	7	1	0	0	5	2	1	0	3812	2024	504	1752	695	61
471844	WiMAX	201405	4	1	0	0	4	1	1	0	3816	2027	505	1753	695	61
471844	WiMAX	201406	2	1	0	0	2	1	1	0	3818	2028	506	1754	695	61
471844	WiMAX	201407	9	1	0	0	4	2	1	0	3827	2031	507	1759	696	61
471844	WiMAX	201408	2	1	0	0	2	1	1	0	3829	2032	508	1760	696	61
471844	WiMAX	201409	7	2	0	0	6	5	2	0	3836	2037	510	1765	699	63
471844	WiMAX	201410	4	2	0	0	4	2	2	0	3840	2039	512	1767	700	63
471844	WiMAX	201411	2	0	0	0	2	1	0	0	3842	2041	512	1768	701	63
471844	WiMAX	201412	5	1	0	0	5	3	1	0	3847	2044	513	1771	702	63
471844	WiMAX	201501	1	0	0	0	1	1	0	0	3848	2045	513	1772	703	63
471844	WiMAX	201502	5	2	0	0	5	4	2	0	3853	2049	515	1776	706	64
471844	WiMAX	201503	2	0	0	0	2	1	0	0	3855	2051	515	1777	707	64
471844	WiMAX	201504	1	0	0	0	1	0	0	0	3856	2052	515	1777	707	64
471844	WiMAX	201505	7	0	0	0	2	1	0	0	3863	2054	515	1780	708	64
471844	WiMAX	201506	3	0	0	0	1	0	0	0	3866	2055	515	1780	708	64
471844	WiMAX	201507	2	0	0	0	1	1	0	0	3868	2055	515	1782	708	64
471844	WiMAX	201508	8	2	0	0	6	3	2	0	3876	2058	517	1785	708	64
471844	WiMAX	201509	8	0	0	0	5	3	0	0	3884	2063	517	1788	711	64
471844	WiMAX	201510	1	0	0	0	1	1	0	0	3885	2064	517	1789	712	64
471844	WiMAX	201511	6	1	0	0	4	1	1	0	3891	2067	518	1790	712	64
471844	WiMAX	201601	6	2	0	0	6	5	2	0	3897	2072	520	1795	716	65
471844	WiMAX	201602	4	2	0	0	4	2	2	0	3901	2075	522	1797	717	65
471844	WiMAX	201603	8	2	0	0	6	4	2	0	3909	2079	524	1803	719	65
471844	WiMAX	201604	7	0	0	0	5	4	0	0	3916	2082	524	1808	721	65
471844	WiMAX	201605	3	1	0	0	3	3	1	0	3919	2084	525	1811	723	66
471844	WiMAX	201606	2	0	0	0	2	2	0	0	3921	2086	525	1813	725	66
471844	WiMAX	201607	3	0	0	0	1	0	0	0	3924	2087	525	1813	725	66
471844	WiMAX	201608	2	0	0	0	2	0	0	0	3926	2089	525	1813	725	66
471844	WiMAX	201609	4	0	0	0	4	3	0	0	3930	2092	525	1816	726	66
471844	WiMAX	201610	6	1	0	0	5	3	1	0	3936	2095	526	1820	727	66
471844	WiMAX	201611	6	0	0	0	5	4	0	0	3942	2098	526	1824	729	66
471844	WiMAX	201612	1	1	0	0	1	0	1	0	3943	2099	527	1824	729	67
471844	WiMAX	201701	3	0	0	0	3	3	0	0	3946	2101	527	1827	731	67
471844	WiMAX	201703	7	1	0	0	5	3	1	0	3953	2103	528	1831	731	67
471844	WiMAX	201704	3	0	0	0	3	3	0	0	3956	2105	528	1834	733	67
471844	WiMAX	201705	1	0	0	0	1	1	0	0	3957	2105	528	1835	733	67
471844	WiMAX	201706	2	0	0	0	1	1	0	0	3959	2106	528	1837	734	67
471844	WiMAX	201707	1	0	0	0	1	1	0	0	3960	2107	528	1838	735	67
471844	WiMAX	201708	1	0	0	0	1	1	0	0	3961	2108	528	1839	736	67
471844	WiMAX	201709	2	1	0	0	2	2	1	0	3963	2109	529	1841	737	68
471844	WiMAX	201712	1	0	0	0	1	1	0	0	3964	2110	529	1842	738	68
471844	WiMAX	201802	2	0	0	0	2	1	0	0	3966	2112	529	1843	739	68
471844	WiMAX	201804	2	1	0	0	2	2	1	0	3968	2113	530	1845	739	69
471844	WiMAX	201805	2	1	0	0	2	1	1	0	3970	2114	531	1846	739	69
471844	WiMAX	201807	4	1	0	0	3	2	1	0	3974	2117	532	1849	740	70
185868	Wireless	200303	6	0	0	0	4	3	0	0	6	4	0	4	3	0
185868	Wireless	200305	1	0	0	0	1	1	0	0	7	5	0	5	4	0
185868	Wireless	200306	2	0	0	0	1	0	0	0	9	5	0	5	4	0
185868	Wireless	200308	2	1	0	0	2	2	1	0	11	7	1	7	6	1
185868	Wireless	200311	4	0	0	0	2	1	0	0	15	9	1	8	7	1
185868	Wireless	200312	1	0	0	0	1	0	0	0	16	10	1	8	7	1
185868	Wireless	200401	2	0	0	0	1	0	0	0	18	11	1	8	7	1
185868	Wireless	200402	2	0	0	0	2	1	0	0	20	13	1	9	8	1
185868	Wireless	200403	3	0	0	0	2	2	0	0	23	15	1	12	10	1
185868	Wireless	200404	1	0	0	0	1	1	0	0	24	16	1	13	11	1
185868	Wireless	200405	2	0	0	0	2	2	0	0	26	18	1	15	13	1
185868	Wireless	200406	3	0	0	0	2	2	0	0	29	20	1	18	15	1
185868	Wireless	200407	3	0	0	0	3	0	0	0	32	23	1	18	15	1
185868	Wireless	200408	1	0	0	0	1	1	0	0	33	24	1	19	16	1
185868	Wireless	200409	1	0	0	0	1	0	0	0	34	25	1	19	16	1
185868	Wireless	200410	2	0	0	0	2	1	0	0	36	27	1	20	17	1
185868	Wireless	200411	1	0	0	0	1	0	0	0	37	28	1	20	17	1
185868	Wireless	200412	5	1	0	0	5	4	1	0	42	33	2	24	21	1
185868	Wireless	200501	8	0	0	0	5	3	0	0	50	38	2	29	24	1
185868	Wireless	200502	6	1	0	0	5	3	1	0	56	43	3	32	27	1
185868	Wireless	200503	15	5	0	0	10	7	5	0	71	51	8	41	32	2
185868	Wireless	200504	5	0	0	0	4	1	0	0	76	55	8	42	33	2
185868	Wireless	200506	2	1	0	0	2	1	1	0	78	56	9	43	33	2
185868	Wireless	200507	8	0	0	0	4	2	0	0	86	60	9	46	35	2
185868	Wireless	200508	9	0	0	0	7	3	0	0	95	67	9	49	38	2
185868	Wireless	200509	5	1	0	0	5	1	1	0	100	71	10	50	38	2
185868	Wireless	200510	9	3	0	0	7	4	3	0	109	77	13	55	41	2
185868	Wireless	200511	2	0	0	0	2	1	0	0	111	79	13	56	42	2
185868	Wireless	200512	16	1	0	0	9	3	1	0	127	88	14	59	45	2
185868	Wireless	200601	10	1	0	0	8	5	1	0	137	95	15	64	50	3
185868	Wireless	200602	12	3	0	0	12	8	3	0	149	107	18	72	58	3
185868	Wireless	200603	31	8	1	0	20	11	6	1	180	126	26	92	68	6
185868	Wireless	200604	14	1	0	0	11	8	1	0	194	136	27	101	75	6
185868	Wireless	200605	7	0	0	0	6	3	0	0	201	141	27	104	78	6
185868	Wireless	200606	26	6	0	0	11	3	4	0	227	150	33	109	80	6
185868	Wireless	200607	5	1	0	0	5	1	1	0	232	155	34	110	81	6
185868	Wireless	200608	17	2	0	0	12	8	2	0	249	164	36	118	87	7
185868	Wireless	200609	22	6	0	0	17	8	5	0	271	177	42	128	92	7
185868	Wireless	200610	12	3	0	0	11	5	2	0	283	187	45	134	97	7
185868	Wireless	200611	23	4	0	0	16	11	4	0	306	200	49	150	105	10
185868	Wireless	200612	22	5	1	0	17	8	5	1	328	215	54	158	111	11
185868	Wireless	200701	76	3	0	0	18	12	2	0	404	230	57	220	120	11
185868	Wireless	200702	17	4	0	0	10	7	3	0	421	238	61	233	125	13
185868	Wireless	200703	13	5	0	0	8	4	2	0	434	245	66	240	128	15
185868	Wireless	200704	7	2	0	0	5	2	2	0	441	250	68	242	130	15
185868	Wireless	200705	45	5	0	0	20	9	5	0	486	268	73	271	137	15
185868	Wireless	200706	19	4	0	0	12	8	3	0	505	277	77	285	142	16
185868	Wireless	200707	42	5	0	0	16	9	4	0	547	289	82	314	147	16
185868	Wireless	200708	20	5	0	0	13	8	2	0	567	298	87	328	151	18
185868	Wireless	200709	28	3	0	0	16	10	2	0	595	310	90	348	157	19
185868	Wireless	200710	27	6	0	0	18	7	5	0	622	326	96	359	162	19
185868	Wireless	200711	27	7	0	0	14	5	3	0	649	338	103	372	165	20
185868	Wireless	200712	24	8	0	0	18	6	3	0	673	354	111	383	169	20
185868	Wireless	200801	16	4	0	0	12	6	2	0	689	364	115	391	173	20
185868	Wireless	200802	16	6	0	0	12	7	5	0	705	375	121	400	179	22
185868	Wireless	200803	61	9	0	0	25	14	7	0	766	395	130	430	188	26
185868	Wireless	200804	26	6	0	0	15	9	5	0	792	406	136	449	193	27
185868	Wireless	200805	23	4	0	0	20	10	4	0	815	423	140	460	200	27
185868	Wireless	200806	10	2	0	0	8	4	2	0	825	429	142	465	202	27
185868	Wireless	200807	8	3	0	0	7	2	2	0	833	435	145	468	203	27
185868	Wireless	200808	17	3	0	0	8	4	3	0	850	442	148	476	206	27
185868	Wireless	200809	45	17	0	0	27	16	11	0	895	465	165	503	218	29
185868	Wireless	200810	36	13	0	0	25	15	11	0	931	485	178	522	229	32
185868	Wireless	200811	18	5	0	0	15	10	5	0	949	498	183	535	237	33
185868	Wireless	200812	9	1	0	0	7	4	1	0	958	503	184	539	239	33
185868	Wireless	200901	29	11	0	0	15	9	7	0	987	516	195	556	246	37
185868	Wireless	200902	21	6	0	0	16	8	3	0	1008	531	201	567	253	37
185868	Wireless	200903	19	7	0	0	16	5	4	0	1027	544	208	575	255	37
185868	Wireless	200904	29	10	0	0	21	10	7	0	1056	560	218	591	260	38
185868	Wireless	200905	12	4	0	0	10	5	4	0	1068	567	222	597	262	38
185868	Wireless	200906	28	9	0	0	18	10	7	0	1096	581	231	614	268	39
185868	Wireless	200907	15	5	0	0	14	5	5	0	1111	593	236	619	271	39
185868	Wireless	200908	20	5	0	0	16	7	4	0	1131	607	241	627	276	40
185868	Wireless	200909	15	5	0	0	14	8	5	0	1146	618	246	636	281	40
185868	Wireless	200910	20	4	0	0	14	7	3	0	1166	629	250	645	285	41
185868	Wireless	200911	34	10	0	0	18	10	6	0	1200	643	260	666	291	42
185868	Wireless	200912	24	8	0	0	13	5	4	0	1224	653	268	675	293	42
185868	Wireless	201001	6	1	0	0	6	3	1	0	1230	658	269	678	295	42
185868	Wireless	201002	16	6	0	0	14	7	4	0	1246	671	275	687	301	43
185868	Wireless	201003	21	7	0	0	14	4	3	0	1267	683	282	695	303	43
185868	Wireless	201004	17	6	0	0	11	4	1	0	1284	693	288	704	306	44
185868	Wireless	201005	28	8	1	0	19	9	6	1	1312	709	296	717	312	45
185868	Wireless	201006	11	4	0	0	10	3	3	0	1323	717	300	721	313	46
185868	Wireless	201007	48	17	2	1	21	15	11	2	1371	735	317	748	325	52
185868	Wireless	201008	10	4	0	0	7	3	2	0	1381	740	321	753	326	52
185868	Wireless	201009	17	3	0	0	13	7	3	0	1398	751	324	761	331	52
185868	Wireless	201010	15	7	0	0	13	6	5	0	1413	761	331	769	334	52
185868	Wireless	201011	20	8	0	0	17	9	7	0	1433	773	339	779	338	52
185868	Wireless	201012	29	11	0	0	16	7	4	0	1462	788	350	798	344	53
185868	Wireless	201101	18	6	0	0	12	8	4	0	1480	797	356	810	349	55
185868	Wireless	201102	12	6	0	0	12	7	6	0	1492	807	362	817	354	56
185868	Wireless	201103	4	1	0	0	4	2	1	0	1496	809	363	819	354	56
185868	Wireless	201104	10	4	0	0	9	6	4	0	1506	815	367	826	357	57
185868	Wireless	201105	24	4	0	0	10	6	3	0	1530	822	371	845	360	58
185868	Wireless	201106	10	3	0	0	10	6	3	0	1540	831	374	851	365	59
185868	Wireless	201107	6	1	0	0	6	2	1	0	1546	837	375	853	367	59
185868	Wireless	201108	4	1	0	0	4	3	1	0	1550	840	376	856	369	59
185868	Wireless	201109	11	2	0	0	9	6	2	0	1561	847	378	864	373	59
185868	Wireless	201110	16	2	0	0	7	4	2	0	1577	852	380	875	375	59
185868	Wireless	201111	14	3	0	0	10	6	3	0	1591	861	383	882	380	59
185868	Wireless	201112	8	2	0	0	6	4	1	0	1599	866	385	888	383	59
185868	Wireless	201201	3	0	0	0	2	0	0	0	1602	868	385	888	383	59
185868	Wireless	201202	39	28	18	14	14	7	8	2	1641	881	413	905	389	70
185868	Wireless	201203	20	9	1	0	14	6	7	1	1661	892	422	913	392	72
185868	Wireless	201204	19	4	0	0	13	9	4	0	1680	902	426	924	398	73
185868	Wireless	201205	8	3	0	0	7	4	3	0	1688	906	429	928	399	73
185868	Wireless	201206	14	3	0	0	9	5	3	0	1702	912	432	934	401	73
185868	Wireless	201207	6	2	0	0	6	4	2	0	1708	916	434	938	403	73
185868	Wireless	201208	19	7	0	0	12	7	4	0	1727	925	441	949	407	74
185868	Wireless	201209	5	0	0	0	4	3	0	0	1732	928	441	953	409	74
185868	Wireless	201210	6	2	0	0	6	2	2	0	1738	933	443	955	410	74
185868	Wireless	201211	45	11	0	0	15	9	7	0	1783	944	454	970	415	75
185868	Wireless	201212	14	4	0	0	10	5	4	0	1797	951	458	979	417	75
185868	Wireless	201301	7	1	0	0	3	2	1	0	1804	954	459	982	419	75
185868	Wireless	201302	18	7	0	0	13	5	3	0	1822	965	466	991	422	75
185868	Wireless	201303	7	3	0	0	6	3	2	0	1829	969	469	995	423	75
185868	Wireless	201304	13	5	0	0	10	6	4	0	1842	977	474	1002	427	75
185868	Wireless	201305	4	1	0	0	4	3	1	0	1846	981	475	1005	430	75
185868	Wireless	201306	11	2	0	0	5	3	1	0	1857	984	477	1014	431	77
185868	Wireless	201307	14	5	0	0	9	4	4	0	1871	989	482	1019	431	77
185868	Wireless	201308	1	0	0	0	1	0	0	0	1872	990	482	1019	431	77
185868	Wireless	201309	4	0	0	0	3	2	0	0	1876	992	482	1022	432	77
185868	Wireless	201310	4	1	0	0	4	1	1	0	1880	995	483	1023	432	77
185868	Wireless	201311	15	4	0	0	10	6	3	0	1895	1002	487	1034	435	78
185868	Wireless	201312	16	3	0	0	8	5	3	0	1911	1008	490	1046	438	78
185868	Wireless	201401	5	1	0	0	5	2	1	0	1916	1012	491	1048	439	78
185868	Wireless	201402	4	2	0	0	4	2	2	0	1920	1014	493	1050	439	78
185868	Wireless	201403	3	1	0	0	3	1	1	0	1923	1016	494	1051	439	78
185868	Wireless	201404	4	1	0	0	3	2	1	0	1927	1018	495	1054	440	78
185868	Wireless	201405	4	1	0	0	4	2	1	0	1931	1020	496	1056	440	78
185868	Wireless	201406	6	2	0	0	6	5	2	0	1937	1025	498	1061	444	79
185868	Wireless	201407	7	3	0	0	7	4	3	0	1944	1030	501	1065	446	80
185868	Wireless	201408	8	0	0	0	3	2	0	0	1952	1033	501	1068	448	80
185868	Wireless	201409	5	2	0	0	4	2	2	0	1957	1035	503	1070	448	80
185868	Wireless	201410	2	1	0	0	2	1	1	0	1959	1037	504	1071	449	80
185868	Wireless	201411	7	2	0	0	5	3	1	0	1966	1041	506	1075	451	81
185868	Wireless	201412	8	2	0	0	6	4	2	0	1974	1045	508	1079	453	81
185868	Wireless	201501	1	0	0	0	1	0	0	0	1975	1046	508	1079	453	81
185868	Wireless	201502	9	2	0	0	8	5	2	0	1984	1052	510	1085	456	82
185868	Wireless	201503	3	1	0	0	3	2	1	0	1987	1054	511	1087	457	83
185868	Wireless	201505	9	4	0	0	8	6	4	0	1996	1061	515	1094	462	86
185868	Wireless	201506	7	0	0	0	4	3	0	0	2003	1064	515	1097	464	86
185868	Wireless	201507	12	6	1	0	9	5	5	1	2015	1070	521	1103	466	87
185868	Wireless	201508	5	2	0	0	5	3	2	0	2020	1073	523	1106	467	87
185868	Wireless	201510	6	1	0	0	3	2	1	0	2026	1075	524	1109	468	87
185868	Wireless	201511	1	0	0	0	1	1	0	0	2027	1076	524	1110	469	87
185868	Wireless	201512	9	4	0	0	8	4	3	0	2036	1082	528	1115	471	87
185868	Wireless	201601	21	2	0	0	14	9	2	0	2057	1092	530	1128	476	87
185868	Wireless	201602	8	1	0	0	7	7	1	0	2065	1097	531	1136	481	88
185868	Wireless	201603	4	1	0	0	4	3	1	0	2069	1101	532	1139	483	89
185868	Wireless	201604	2	1	0	0	2	1	1	0	2071	1102	533	1140	483	89
185868	Wireless	201605	2	1	0	0	2	1	1	0	2073	1104	534	1141	484	89
185868	Wireless	201606	5	1	0	0	4	2	1	0	2078	1107	535	1143	485	89
185868	Wireless	201607	3	1	0	0	3	2	1	0	2081	1109	536	1145	486	89
185868	Wireless	201608	2	1	0	0	2	1	1	0	2083	1110	537	1146	486	89
185868	Wireless	201609	7	2	0	0	6	5	2	0	2090	1114	539	1151	489	90
185868	Wireless	201610	4	2	0	0	3	1	1	0	2094	1116	541	1153	489	90
185868	Wireless	201611	2	1	0	0	2	1	1	0	2096	1117	542	1154	489	90
185868	Wireless	201612	10	2	0	0	5	4	1	0	2106	1120	544	1163	491	91
185868	Wireless	201701	6	1	0	0	5	4	1	0	2112	1124	545	1168	494	91
185868	Wireless	201702	3	0	0	0	3	1	0	0	2115	1127	545	1169	494	91
185868	Wireless	201703	9	3	0	0	8	6	3	0	2124	1131	548	1175	495	93
185868	Wireless	201705	7	2	0	0	7	4	2	0	2131	1136	550	1179	497	93
185868	Wireless	201706	1	0	0	0	1	1	0	0	2132	1137	550	1180	498	93
185868	Wireless	201707	1	0	0	0	1	1	0	0	2133	1138	550	1181	499	93
185868	Wireless	201708	3	1	0	0	3	2	1	0	2136	1140	551	1183	500	94
185868	Wireless	201709	6	0	0	0	5	2	0	0	2142	1145	551	1185	502	94
185868	Wireless	201710	3	1	0	0	3	2	1	0	2145	1146	552	1187	502	94
185868	Wireless	201801	4	2	0	0	4	3	2	0	2149	1149	554	1190	503	95
185868	Wireless	201802	5	1	0	0	5	4	1	0	2154	1154	555	1194	506	96
185868	Wireless	201803	5	2	0	0	5	3	2	0	2159	1158	557	1197	508	96
185868	Wireless	201804	4	2	0	0	4	3	2	0	2163	1162	559	1200	510	97
185868	Wireless	201805	2	1	0	0	2	1	1	0	2165	1164	560	1201	511	97
185868	Wireless	201806	2	0	0	0	1	1	0	0	2167	1165	560	1203	511	97
185868	Wireless	201807	5	0	0	0	2	2	0	0	2172	1167	560	1208	513	97
713497	Wireless_mesh_network	200407	8	0	0	0	6	2	0	0	8	6	0	2	2	0
713497	Wireless_mesh_network	200408	1	0	0	0	1	0	0	0	9	7	0	2	2	0
713497	Wireless_mesh_network	200409	10	0	0	0	6	3	0	0	19	13	0	6	5	0
713497	Wireless_mesh_network	200412	3	0	0	0	1	1	0	0	22	14	0	9	6	0
713497	Wireless_mesh_network	200501	4	0	0	0	4	1	0	0	26	18	0	10	7	0
713497	Wireless_mesh_network	200502	3	0	0	0	2	1	0	0	29	20	0	11	8	0
713497	Wireless_mesh_network	200503	2	0	0	0	2	1	0	0	31	22	0	12	9	0
713497	Wireless_mesh_network	200504	7	0	0	0	5	2	0	0	38	27	0	15	11	0
713497	Wireless_mesh_network	200505	3	0	0	0	3	2	0	0	41	29	0	17	12	0
713497	Wireless_mesh_network	200506	1	0	0	0	1	1	0	0	42	30	0	18	13	0
713497	Wireless_mesh_network	200507	6	0	0	0	4	2	0	0	48	33	0	20	14	0
713497	Wireless_mesh_network	200508	2	0	0	0	1	0	0	0	50	34	0	20	14	0
713497	Wireless_mesh_network	200509	6	0	0	0	4	0	0	0	56	38	0	20	14	0
713497	Wireless_mesh_network	200510	4	0	0	0	3	1	0	0	60	40	0	21	15	0
713497	Wireless_mesh_network	200511	9	0	0	0	6	0	0	0	69	45	0	21	15	0
713497	Wireless_mesh_network	200512	5	0	0	0	3	0	0	0	74	48	0	21	15	0
713497	Wireless_mesh_network	200601	10	0	0	0	8	3	0	0	84	55	0	24	17	0
713497	Wireless_mesh_network	200602	11	0	0	0	8	1	0	0	95	63	0	25	18	0
713497	Wireless_mesh_network	200603	17	0	0	0	13	7	0	0	112	76	0	32	25	0
713497	Wireless_mesh_network	200604	4	0	0	0	4	0	0	0	116	80	0	32	25	0
713497	Wireless_mesh_network	200605	5	0	0	0	5	2	0	0	121	85	0	34	27	0
713497	Wireless_mesh_network	200606	4	0	0	0	4	2	0	0	125	89	0	36	29	0
713497	Wireless_mesh_network	200607	24	1	0	0	7	3	1	0	149	95	1	39	31	0
713497	Wireless_mesh_network	200608	18	3	0	0	10	6	1	0	167	103	4	52	35	3
713497	Wireless_mesh_network	200609	7	0	0	0	3	2	0	0	174	106	4	56	37	3
713497	Wireless_mesh_network	200610	3	0	0	0	3	0	0	0	177	109	4	56	37	3
713497	Wireless_mesh_network	200611	8	1	0	0	6	4	1	0	185	115	5	61	41	3
713497	Wireless_mesh_network	200612	12	2	0	0	6	1	1	0	197	121	7	63	42	3
713497	Wireless_mesh_network	200701	8	2	0	0	6	2	2	0	205	127	9	65	44	3
713497	Wireless_mesh_network	200702	2	0	0	0	1	1	0	0	207	128	9	67	45	3
713497	Wireless_mesh_network	200703	20	0	0	0	10	6	0	0	227	138	9	79	51	3
713497	Wireless_mesh_network	200704	13	0	0	0	9	5	0	0	240	146	9	87	55	3
713497	Wireless_mesh_network	200705	10	1	0	0	7	2	1	0	250	152	10	89	57	3
713497	Wireless_mesh_network	200706	2	0	0	0	1	0	0	0	252	153	10	89	57	3
713497	Wireless_mesh_network	200707	6	0	0	0	5	2	0	0	258	158	10	91	59	3
713497	Wireless_mesh_network	200708	9	0	0	0	6	2	0	0	267	163	10	94	61	3
713497	Wireless_mesh_network	200709	25	0	0	0	3	2	0	0	292	165	10	117	62	3
713497	Wireless_mesh_network	200710	15	0	0	0	5	2	0	0	307	170	10	128	64	3
713497	Wireless_mesh_network	200711	5	0	0	0	4	3	0	0	312	173	10	132	66	3
713497	Wireless_mesh_network	200712	11	1	0	0	8	3	1	0	323	179	11	137	68	4
713497	Wireless_mesh_network	200801	24	0	0	0	13	8	0	0	347	191	11	150	75	4
713497	Wireless_mesh_network	200802	1	0	0	0	1	1	0	0	348	191	11	151	75	4
713497	Wireless_mesh_network	200803	4	0	0	0	4	2	0	0	352	194	11	153	76	4
713497	Wireless_mesh_network	200804	5	0	0	0	3	1	0	0	357	196	11	156	76	4
713497	Wireless_mesh_network	200805	3	0	0	0	3	3	0	0	360	199	11	159	79	4
713497	Wireless_mesh_network	200806	28	0	0	0	12	5	0	0	388	209	11	176	82	4
713497	Wireless_mesh_network	200807	30	5	1	0	16	7	4	1	418	222	16	184	87	5
713497	Wireless_mesh_network	200808	7	1	0	0	6	2	1	0	425	227	17	186	88	5
713497	Wireless_mesh_network	200809	6	0	0	0	6	3	0	0	431	232	17	189	90	5
713497	Wireless_mesh_network	200810	10	3	0	0	6	4	2	0	441	237	20	197	93	8
713497	Wireless_mesh_network	200811	4	1	0	0	4	2	1	0	445	241	21	199	95	8
713497	Wireless_mesh_network	200812	2	0	0	0	1	1	0	0	447	241	21	201	95	8
713497	Wireless_mesh_network	200901	8	1	0	0	4	3	1	0	455	244	22	208	97	8
713497	Wireless_mesh_network	200902	4	2	0	0	4	2	2	0	459	247	24	210	98	8
713497	Wireless_mesh_network	200903	22	0	0	0	5	2	0	0	481	251	24	229	99	8
713497	Wireless_mesh_network	200904	5	0	0	0	2	1	0	0	486	252	24	232	99	8
713497	Wireless_mesh_network	200905	5	1	0	0	4	3	1	0	491	255	25	236	101	8
713497	Wireless_mesh_network	200906	4	0	0	0	3	2	0	0	495	258	25	239	103	8
713497	Wireless_mesh_network	200908	4	0	0	0	2	1	0	0	499	260	25	242	104	8
713497	Wireless_mesh_network	200909	2	0	0	0	2	2	0	0	501	262	25	244	106	8
713497	Wireless_mesh_network	200910	5	1	0	0	5	2	1	0	506	267	26	246	108	8
713497	Wireless_mesh_network	200911	6	1	0	0	5	3	1	0	512	270	27	249	109	9
713497	Wireless_mesh_network	200912	8	2	0	0	5	2	2	0	520	274	29	252	110	9
713497	Wireless_mesh_network	201001	7	1	0	0	4	3	1	0	527	276	30	258	111	10
713497	Wireless_mesh_network	201002	7	2	0	0	7	3	2	0	534	281	32	261	112	10
713497	Wireless_mesh_network	201003	2	1	0	0	2	2	1	0	536	282	33	263	113	11
713497	Wireless_mesh_network	201004	3	1	0	0	2	2	1	0	539	283	34	266	114	12
713497	Wireless_mesh_network	201005	3	0	0	0	3	2	0	0	542	286	34	268	116	12
713497	Wireless_mesh_network	201006	4	0	0	0	4	1	0	0	546	290	34	269	117	12
713497	Wireless_mesh_network	201007	3	0	0	0	2	0	0	0	549	292	34	269	117	12
713497	Wireless_mesh_network	201009	3	0	0	0	2	1	0	0	552	293	34	271	117	12
713497	Wireless_mesh_network	201010	4	0	0	0	3	1	0	0	556	295	34	272	117	12
713497	Wireless_mesh_network	201011	1	0	0	0	1	1	0	0	557	295	34	273	117	12
713497	Wireless_mesh_network	201012	1	0	0	0	1	1	0	0	558	296	34	274	118	12
713497	Wireless_mesh_network	201101	8	1	0	0	6	5	1	0	566	300	35	280	121	12
713497	Wireless_mesh_network	201102	4	0	0	0	3	3	0	0	570	303	35	284	124	12
713497	Wireless_mesh_network	201103	2	0	0	0	2	1	0	0	572	305	35	285	125	12
713497	Wireless_mesh_network	201104	4	0	0	0	3	2	0	0	576	307	35	288	126	12
713497	Wireless_mesh_network	201105	1	0	0	0	1	0	0	0	577	308	35	288	126	12
713497	Wireless_mesh_network	201106	5	2	0	0	5	3	2	0	582	312	37	291	128	12
713497	Wireless_mesh_network	201107	6	0	0	0	4	3	0	0	588	315	37	294	130	12
713497	Wireless_mesh_network	201108	2	0	0	0	2	2	0	0	590	316	37	296	131	12
713497	Wireless_mesh_network	201109	3	1	0	0	3	2	1	0	593	319	38	298	133	12
713497	Wireless_mesh_network	201111	2	0	0	0	2	2	0	0	595	321	38	300	135	12
713497	Wireless_mesh_network	201112	2	0	0	0	2	1	0	0	597	323	38	301	136	12
713497	Wireless_mesh_network	201201	4	1	0	0	4	3	1	0	601	326	39	304	138	12
713497	Wireless_mesh_network	201202	8	2	0	0	6	3	2	0	609	330	41	308	139	12
713497	Wireless_mesh_network	201204	2	0	0	0	2	2	0	0	611	332	41	310	141	12
713497	Wireless_mesh_network	201205	1	0	0	0	1	1	0	0	612	332	41	311	141	12
713497	Wireless_mesh_network	201206	13	5	0	0	7	4	4	0	625	339	46	316	145	12
713497	Wireless_mesh_network	201207	2	0	0	0	2	2	0	0	627	341	46	318	147	12
713497	Wireless_mesh_network	201208	3	1	0	0	2	2	1	0	630	342	47	321	148	13
713497	Wireless_mesh_network	201209	5	0	0	0	4	2	0	0	635	345	47	324	149	13
713497	Wireless_mesh_network	201210	1	0	0	0	1	1	0	0	636	345	47	325	149	13
713497	Wireless_mesh_network	201211	8	1	0	0	8	3	1	0	644	351	48	328	150	13
713497	Wireless_mesh_network	201212	2	0	0	0	2	1	0	0	646	352	48	329	150	13
713497	Wireless_mesh_network	201304	3	0	0	0	3	1	0	0	649	355	48	330	151	13
713497	Wireless_mesh_network	201307	6	0	0	0	3	3	0	0	655	356	48	336	152	13
713497	Wireless_mesh_network	201309	2	0	0	0	1	1	0	0	657	357	48	338	153	13
713497	Wireless_mesh_network	201310	3	1	0	0	3	2	1	0	660	360	49	340	155	13
713497	Wireless_mesh_network	201311	2	1	0	0	2	2	1	0	662	361	50	342	156	14
713497	Wireless_mesh_network	201312	5	2	0	0	3	2	1	0	667	363	52	346	157	16
713497	Wireless_mesh_network	201401	1	0	0	0	1	1	0	0	668	364	52	347	158	16
713497	Wireless_mesh_network	201402	5	1	0	0	5	4	1	0	673	368	53	351	161	16
713497	Wireless_mesh_network	201404	1	0	0	0	1	1	0	0	674	369	53	352	162	16
713497	Wireless_mesh_network	201405	1	0	0	0	1	0	0	0	675	370	53	352	162	16
713497	Wireless_mesh_network	201406	2	0	0	0	2	2	0	0	677	372	53	354	164	16
713497	Wireless_mesh_network	201407	2	0	0	0	2	1	0	0	679	374	53	355	165	16
713497	Wireless_mesh_network	201408	1	0	0	0	1	1	0	0	680	375	53	356	166	16
713497	Wireless_mesh_network	201409	2	0	0	0	1	0	0	0	682	376	53	356	166	16
713497	Wireless_mesh_network	201501	4	0	0	0	3	1	0	0	686	379	53	357	167	16
713497	Wireless_mesh_network	201502	2	0	0	0	2	2	0	0	688	381	53	359	169	16
713497	Wireless_mesh_network	201503	2	1	0	0	2	1	1	0	690	383	54	360	170	16
713497	Wireless_mesh_network	201504	5	0	0	0	2	1	0	0	695	385	54	362	170	16
713497	Wireless_mesh_network	201506	4	0	0	0	4	3	0	0	699	389	54	365	173	16
713497	Wireless_mesh_network	201507	3	1	0	0	3	3	1	0	702	392	55	368	176	17
713497	Wireless_mesh_network	201508	1	0	0	0	1	1	0	0	703	393	55	369	177	17
713497	Wireless_mesh_network	201509	2	0	0	0	1	1	0	0	705	394	55	371	178	17
713497	Wireless_mesh_network	201510	2	1	0	0	2	1	1	0	707	395	56	372	178	17
713497	Wireless_mesh_network	201601	12	4	0	0	4	1	1	0	719	398	60	378	178	17
713497	Wireless_mesh_network	201602	3	0	0	0	2	2	0	0	722	400	60	381	180	17
713497	Wireless_mesh_network	201603	4	2	0	0	4	2	2	0	726	402	62	383	180	17
713497	Wireless_mesh_network	201604	4	0	0	0	4	2	0	0	730	406	62	385	182	17
713497	Wireless_mesh_network	201605	1	0	0	0	1	0	0	0	731	407	62	385	182	17
713497	Wireless_mesh_network	201608	2	0	0	0	1	0	0	0	733	408	62	385	182	17
713497	Wireless_mesh_network	201609	2	0	0	0	1	0	0	0	735	409	62	385	182	17
713497	Wireless_mesh_network	201611	5	0	0	0	4	2	0	0	740	411	62	387	182	17
713497	Wireless_mesh_network	201612	10	0	0	0	7	6	0	0	750	416	62	395	186	17
713497	Wireless_mesh_network	201701	1	0	0	0	1	1	0	0	751	417	62	396	187	17
713497	Wireless_mesh_network	201702	3	0	0	0	3	3	0	0	754	420	62	399	190	17
713497	Wireless_mesh_network	201703	1	0	0	0	1	0	0	0	755	421	62	399	190	17
713497	Wireless_mesh_network	201704	1	0	0	0	1	1	0	0	756	422	62	400	191	17
713497	Wireless_mesh_network	201705	1	0	0	0	1	1	0	0	757	423	62	401	192	17
713497	Wireless_mesh_network	201706	10	0	0	0	5	2	0	0	767	427	62	403	193	17
713497	Wireless_mesh_network	201707	1	0	0	0	1	0	0	0	768	428	62	403	193	17
713497	Wireless_mesh_network	201708	7	0	0	0	4	4	0	0	775	431	62	410	196	17
713497	Wireless_mesh_network	201709	1	0	0	0	1	1	0	0	776	432	62	411	196	17
713497	Wireless_mesh_network	201710	2	1	0	0	2	1	1	0	778	434	63	412	197	17
713497	Wireless_mesh_network	201711	2	0	0	0	2	2	0	0	780	436	63	414	198	17
713497	Wireless_mesh_network	201712	3	1	0	0	3	2	1	0	783	439	64	416	200	17
713497	Wireless_mesh_network	201801	2	0	0	0	2	1	0	0	785	441	64	417	201	17
713497	Wireless_mesh_network	201804	2	0	0	0	2	2	0	0	787	442	64	419	201	17
713497	Wireless_mesh_network	201805	3	0	0	0	3	1	0	0	790	445	64	420	202	17
713497	Wireless_mesh_network	201806	3	1	0	0	3	3	1	0	793	447	65	423	204	18
713497	Wireless_mesh_network	201807	2	0	0	0	2	2	0	0	795	449	65	425	206	18
33149	World_Wide_Web_Consortium	200109	1	0	0	0	1	1	0	0	1	1	0	1	1	0
33149	World_Wide_Web_Consortium	200201	2	0	0	0	2	2	0	0	3	3	0	3	3	0
33149	World_Wide_Web_Consortium	200202	2	0	0	0	1	1	0	0	5	4	0	5	3	0
33149	World_Wide_Web_Consortium	200204	1	0	0	0	1	1	0	0	6	5	0	6	3	0
33149	World_Wide_Web_Consortium	200212	3	0	0	0	2	1	0	0	9	7	0	7	4	0
33149	World_Wide_Web_Consortium	200302	2	0	0	0	1	0	0	0	11	8	0	7	4	0
33149	World_Wide_Web_Consortium	200303	4	0	0	0	3	3	0	0	15	11	0	11	7	0
33149	World_Wide_Web_Consortium	200304	5	0	0	0	2	1	0	0	20	12	0	14	7	0
33149	World_Wide_Web_Consortium	200305	1	0	0	0	1	1	0	0	21	13	0	15	8	0
33149	World_Wide_Web_Consortium	200306	1	0	0	0	1	0	0	0	22	14	0	15	8	0
33149	World_Wide_Web_Consortium	200308	3	0	0	0	2	1	0	0	25	16	0	16	9	0
33149	World_Wide_Web_Consortium	200311	2	0	0	0	2	1	0	0	27	18	0	17	10	0
33149	World_Wide_Web_Consortium	200312	2	0	0	0	2	2	0	0	29	20	0	19	12	0
33149	World_Wide_Web_Consortium	200401	2	0	0	0	2	2	0	0	31	21	0	21	13	0
33149	World_Wide_Web_Consortium	200402	1	0	0	0	1	1	0	0	32	22	0	22	14	0
33149	World_Wide_Web_Consortium	200403	1	0	0	0	1	1	0	0	33	23	0	23	15	0
33149	World_Wide_Web_Consortium	200404	6	0	0	0	5	5	0	0	39	28	0	29	20	0
33149	World_Wide_Web_Consortium	200405	2	0	0	0	2	0	0	0	41	30	0	29	20	0
33149	World_Wide_Web_Consortium	200407	1	0	0	0	1	1	0	0	42	31	0	30	21	0
33149	World_Wide_Web_Consortium	200408	2	0	0	0	2	1	0	0	44	33	0	31	22	0
33149	World_Wide_Web_Consortium	200409	3	0	0	0	1	1	0	0	47	34	0	34	23	0
33149	World_Wide_Web_Consortium	200410	6	0	0	0	5	3	0	0	53	39	0	37	26	0
33149	World_Wide_Web_Consortium	200411	2	0	0	0	2	2	0	0	55	41	0	39	28	0
33149	World_Wide_Web_Consortium	200412	2	0	0	0	2	2	0	0	57	43	0	41	30	0
33149	World_Wide_Web_Consortium	200501	7	0	0	0	6	4	0	0	64	49	0	45	34	0
33149	World_Wide_Web_Consortium	200502	3	0	0	0	3	1	0	0	67	52	0	46	35	0
33149	World_Wide_Web_Consortium	200503	6	0	0	0	6	4	0	0	73	58	0	50	39	0
33149	World_Wide_Web_Consortium	200504	3	0	0	0	2	1	0	0	76	60	0	52	40	0
33149	World_Wide_Web_Consortium	200505	5	0	0	0	4	3	0	0	81	64	0	55	43	0
33149	World_Wide_Web_Consortium	200506	7	2	0	0	6	4	2	0	88	70	2	59	47	0
33149	World_Wide_Web_Consortium	200507	7	1	0	0	7	6	1	0	95	76	3	65	52	0
33149	World_Wide_Web_Consortium	200508	8	0	0	0	6	4	0	0	103	82	3	71	56	0
33149	World_Wide_Web_Consortium	200509	19	1	0	0	9	7	1	0	122	90	4	88	62	0
33149	World_Wide_Web_Consortium	200510	6	0	0	0	5	5	0	0	128	93	4	94	65	0
33149	World_Wide_Web_Consortium	200511	15	0	0	0	8	5	0	0	143	100	4	104	69	0
33149	World_Wide_Web_Consortium	200512	7	2	0	0	6	5	2	0	150	105	6	110	73	1
33149	World_Wide_Web_Consortium	200601	2	0	0	0	2	2	0	0	152	107	6	112	75	1
33149	World_Wide_Web_Consortium	200602	4	1	0	0	4	3	1	0	156	110	7	115	77	1
33149	World_Wide_Web_Consortium	200603	3	0	0	0	3	3	0	0	159	113	7	118	80	1
33149	World_Wide_Web_Consortium	200604	9	0	0	0	6	5	0	0	168	117	7	126	83	1
33149	World_Wide_Web_Consortium	200605	4	1	0	0	4	3	1	0	172	121	8	129	86	2
33149	World_Wide_Web_Consortium	200606	15	1	0	0	11	5	1	0	187	131	9	137	90	2
33149	World_Wide_Web_Consortium	200607	9	1	0	0	7	6	1	0	196	137	10	144	95	2
33149	World_Wide_Web_Consortium	200608	11	0	0	0	6	3	0	0	207	142	10	150	97	2
33149	World_Wide_Web_Consortium	200609	16	1	0	0	9	6	1	0	223	151	11	156	103	2
33149	World_Wide_Web_Consortium	200610	7	1	0	0	6	3	1	0	230	157	12	160	106	3
33149	World_Wide_Web_Consortium	200611	4	0	0	0	3	2	0	0	234	160	12	162	108	3
33149	World_Wide_Web_Consortium	200612	17	3	0	0	15	7	3	0	251	173	15	170	113	3
33149	World_Wide_Web_Consortium	200701	15	1	0	0	10	6	1	0	266	181	16	178	117	3
33149	World_Wide_Web_Consortium	200702	9	1	0	0	9	6	1	0	275	190	17	184	123	3
33149	World_Wide_Web_Consortium	200703	25	5	0	0	12	5	2	0	300	201	22	193	127	3
33149	World_Wide_Web_Consortium	200704	7	1	0	0	7	4	1	0	307	208	23	197	131	3
33149	World_Wide_Web_Consortium	200705	11	3	0	0	9	7	3	0	318	216	26	205	137	6
33149	World_Wide_Web_Consortium	200706	5	0	0	0	4	1	0	0	323	220	26	206	138	6
33149	World_Wide_Web_Consortium	200707	3	0	0	0	2	1	0	0	326	221	26	208	138	6
33149	World_Wide_Web_Consortium	200708	10	2	0	0	4	2	2	0	336	224	28	210	139	6
33149	World_Wide_Web_Consortium	200709	2	0	0	0	2	2	0	0	338	226	28	212	141	6
33149	World_Wide_Web_Consortium	200710	5	0	0	0	5	2	0	0	343	231	28	214	143	6
33149	World_Wide_Web_Consortium	200711	8	0	0	0	4	2	0	0	351	234	28	217	145	6
33149	World_Wide_Web_Consortium	200712	8	2	0	0	8	4	2	0	359	242	30	221	149	6
33149	World_Wide_Web_Consortium	200801	29	0	0	0	5	1	0	0	388	247	30	246	150	6
33149	World_Wide_Web_Consortium	200802	10	1	0	0	8	6	1	0	398	254	31	253	155	6
33149	World_Wide_Web_Consortium	200803	12	2	0	0	9	7	2	0	410	262	33	260	161	6
33149	World_Wide_Web_Consortium	200804	6	0	0	0	6	3	0	0	416	267	33	263	163	6
33149	World_Wide_Web_Consortium	200805	4	0	0	0	2	1	0	0	420	269	33	265	164	6
33149	World_Wide_Web_Consortium	200806	5	0	0	0	5	4	0	0	425	273	33	269	167	6
33149	World_Wide_Web_Consortium	200807	15	3	0	0	10	5	3	0	440	282	36	277	171	7
33149	World_Wide_Web_Consortium	200808	8	1	0	0	7	5	1	0	448	288	37	282	175	7
33149	World_Wide_Web_Consortium	200809	7	2	0	0	6	4	2	0	455	293	39	287	178	7
33149	World_Wide_Web_Consortium	200810	8	1	0	0	4	2	1	0	463	296	40	293	179	7
33149	World_Wide_Web_Consortium	200811	10	3	0	0	7	5	2	0	473	303	43	299	184	7
33149	World_Wide_Web_Consortium	200812	12	1	0	0	6	3	1	0	485	308	44	307	186	7
33149	World_Wide_Web_Consortium	200901	4	0	0	0	4	3	0	0	489	312	44	310	189	7
33149	World_Wide_Web_Consortium	200902	10	4	0	0	4	3	2	0	499	315	48	315	191	8
33149	World_Wide_Web_Consortium	200903	2	1	0	0	2	1	1	0	501	317	49	316	192	8
33149	World_Wide_Web_Consortium	200904	6	2	0	0	5	2	1	0	507	320	51	319	192	8
33149	World_Wide_Web_Consortium	200905	1	0	0	0	1	1	0	0	508	321	51	320	193	8
33149	World_Wide_Web_Consortium	200906	5	1	0	0	5	4	1	0	513	324	52	324	195	8
33149	World_Wide_Web_Consortium	200907	4	0	0	0	3	2	0	0	517	327	52	326	197	8
33149	World_Wide_Web_Consortium	200908	2	0	0	0	1	0	0	0	519	328	52	326	197	8
33149	World_Wide_Web_Consortium	200909	3	0	0	0	2	2	0	0	522	328	52	329	197	8
33149	World_Wide_Web_Consortium	200910	21	4	0	0	12	9	3	0	543	338	56	344	204	9
33149	World_Wide_Web_Consortium	200911	10	2	0	0	5	4	2	0	553	342	58	352	207	9
33149	World_Wide_Web_Consortium	201002	2	0	0	0	1	1	0	0	555	343	58	354	208	9
33149	World_Wide_Web_Consortium	201003	2	0	0	0	2	2	0	0	557	345	58	356	210	9
33149	World_Wide_Web_Consortium	201004	8	2	0	0	7	4	1	0	565	351	60	361	213	10
33149	World_Wide_Web_Consortium	201005	6	2	0	0	6	4	2	0	571	355	62	365	215	10
33149	World_Wide_Web_Consortium	201006	2	1	0	0	2	1	1	0	573	356	63	366	215	10
33149	World_Wide_Web_Consortium	201007	8	2	0	0	7	5	1	0	581	361	65	372	218	11
33149	World_Wide_Web_Consortium	201008	14	2	0	0	7	3	2	0	595	365	67	377	218	11
33149	World_Wide_Web_Consortium	201009	13	2	0	0	7	5	1	0	608	371	69	388	222	11
33149	World_Wide_Web_Consortium	201010	11	1	0	0	8	7	1	0	619	376	70	397	226	11
33149	World_Wide_Web_Consortium	201011	6	2	0	0	4	2	1	0	625	379	72	400	227	12
33149	World_Wide_Web_Consortium	201012	4	0	0	0	1	1	0	0	629	380	72	404	228	12
33149	World_Wide_Web_Consortium	201101	6	0	0	0	4	3	0	0	635	381	72	409	228	12
33149	World_Wide_Web_Consortium	201102	7	1	0	0	5	3	1	0	642	385	73	413	230	12
33149	World_Wide_Web_Consortium	201103	9	3	2	1	6	3	2	2	651	390	76	417	232	13
33149	World_Wide_Web_Consortium	201104	2	0	0	0	2	1	0	0	653	391	76	418	232	13
33149	World_Wide_Web_Consortium	201105	7	2	0	0	6	4	2	0	660	395	78	423	234	13
33149	World_Wide_Web_Consortium	201107	2	0	0	0	2	2	0	0	662	397	78	425	236	13
33149	World_Wide_Web_Consortium	201108	13	3	0	0	9	4	3	0	675	405	81	431	239	13
33149	World_Wide_Web_Consortium	201109	17	2	0	0	6	5	1	0	692	409	83	445	242	14
33149	World_Wide_Web_Consortium	201110	5	0	0	0	4	4	0	0	697	412	83	450	245	14
33149	World_Wide_Web_Consortium	201201	4	1	0	0	4	3	1	0	701	415	84	453	247	15
33149	World_Wide_Web_Consortium	201202	18	4	0	0	12	8	2	0	719	425	88	466	253	15
33149	World_Wide_Web_Consortium	201203	4	1	0	0	3	1	1	0	723	428	89	467	254	15
33149	World_Wide_Web_Consortium	201204	2	0	0	0	2	1	0	0	725	429	89	468	254	15
33149	World_Wide_Web_Consortium	201205	7	0	0	0	6	3	0	0	732	434	89	472	256	15
33149	World_Wide_Web_Consortium	201206	2	1	0	0	2	2	1	0	734	436	90	474	258	16
33149	World_Wide_Web_Consortium	201207	3	0	0	0	1	1	0	0	737	437	90	477	259	16
33149	World_Wide_Web_Consortium	201208	3	0	0	0	2	1	0	0	740	439	90	478	260	16
33149	World_Wide_Web_Consortium	201209	9	3	0	0	7	4	3	0	749	442	93	482	260	16
33149	World_Wide_Web_Consortium	201210	4	2	0	0	3	1	1	0	753	444	95	484	260	16
33149	World_Wide_Web_Consortium	201211	27	8	0	0	11	8	4	0	780	452	103	496	265	17
33149	World_Wide_Web_Consortium	201301	1	0	0	0	1	0	0	0	781	453	103	496	265	17
33149	World_Wide_Web_Consortium	201302	6	3	0	0	6	4	3	0	787	457	106	500	267	18
33149	World_Wide_Web_Consortium	201303	13	0	0	0	6	3	0	0	800	462	106	505	269	18
33149	World_Wide_Web_Consortium	201304	3	0	0	0	3	2	0	0	803	465	106	507	270	18
33149	World_Wide_Web_Consortium	201305	3	1	0	0	3	1	1	0	806	467	107	508	270	18
33149	World_Wide_Web_Consortium	201306	6	0	0	0	5	4	0	0	812	472	107	513	274	18
33149	World_Wide_Web_Consortium	201307	6	1	0	0	5	3	1	0	818	476	108	516	276	18
33149	World_Wide_Web_Consortium	201308	1	0	0	0	1	0	0	0	819	477	108	516	276	18
33149	World_Wide_Web_Consortium	201309	4	2	0	0	3	1	1	0	823	479	110	518	276	18
33149	World_Wide_Web_Consortium	201310	4	1	0	0	4	3	1	0	827	482	111	521	278	18
33149	World_Wide_Web_Consortium	201311	7	1	0	0	6	3	1	0	834	486	112	525	279	18
33149	World_Wide_Web_Consortium	201312	17	6	0	0	9	5	5	0	851	494	118	534	283	19
33149	World_Wide_Web_Consortium	201401	3	0	0	0	2	2	0	0	854	496	118	537	285	19
33149	World_Wide_Web_Consortium	201402	8	2	0	0	8	5	2	0	862	502	120	542	288	19
33149	World_Wide_Web_Consortium	201403	11	5	0	0	8	6	5	0	873	509	125	548	293	20
33149	World_Wide_Web_Consortium	201404	3	1	0	0	3	2	1	0	876	512	126	550	295	20
33149	World_Wide_Web_Consortium	201405	4	2	0	0	4	2	2	0	880	515	128	552	296	20
33149	World_Wide_Web_Consortium	201406	8	2	0	0	6	4	1	0	888	519	130	558	298	20
33149	World_Wide_Web_Consortium	201407	2	1	0	0	2	1	1	0	890	519	131	559	298	20
33149	World_Wide_Web_Consortium	201408	4	1	0	0	3	1	1	0	894	521	132	560	298	20
33149	World_Wide_Web_Consortium	201409	11	1	0	0	4	3	1	0	905	524	133	569	300	21
33149	World_Wide_Web_Consortium	201410	2	1	0	0	2	2	1	0	907	526	134	571	302	22
33149	World_Wide_Web_Consortium	201411	9	3	0	0	7	4	3	0	916	531	137	575	304	23
33149	World_Wide_Web_Consortium	201412	1	0	0	0	1	0	0	0	917	532	137	575	304	23
33149	World_Wide_Web_Consortium	201501	2	0	0	0	2	1	0	0	919	534	137	576	305	23
33149	World_Wide_Web_Consortium	201502	8	3	0	0	6	4	3	0	927	539	140	581	308	25
33149	World_Wide_Web_Consortium	201503	5	1	0	0	5	4	1	0	932	542	141	585	310	25
33149	World_Wide_Web_Consortium	201504	6	0	0	0	2	0	0	0	938	544	141	585	310	25
33149	World_Wide_Web_Consortium	201506	11	4	0	0	10	6	4	0	949	551	145	592	313	25
33149	World_Wide_Web_Consortium	201508	2	1	0	0	2	1	1	0	951	552	146	593	313	25
33149	World_Wide_Web_Consortium	201509	4	0	0	0	3	2	0	0	955	555	146	595	315	25
33149	World_Wide_Web_Consortium	201510	8	2	0	0	7	6	2	0	963	561	148	602	319	26
33149	World_Wide_Web_Consortium	201511	8	1	0	0	5	2	1	0	971	565	149	604	320	26
33149	World_Wide_Web_Consortium	201601	20	2	0	0	11	3	2	0	991	575	151	607	322	26
33149	World_Wide_Web_Consortium	201602	1	0	0	0	1	1	0	0	992	576	151	608	322	26
33149	World_Wide_Web_Consortium	201603	6	3	0	0	6	4	3	0	998	579	154	612	323	27
33149	World_Wide_Web_Consortium	201604	7	1	0	0	7	5	1	0	1005	584	155	617	326	27
33149	World_Wide_Web_Consortium	201605	11	1	0	0	5	3	1	0	1016	588	156	621	328	27
33149	World_Wide_Web_Consortium	201606	3	0	0	0	2	1	0	0	1019	590	156	622	328	27
33149	World_Wide_Web_Consortium	201607	5	1	0	0	5	4	1	0	1024	593	157	626	330	28
33149	World_Wide_Web_Consortium	201608	2	0	0	0	1	1	0	0	1026	594	157	628	331	28
33149	World_Wide_Web_Consortium	201609	2	0	0	0	2	2	0	0	1028	594	157	630	331	28
33149	World_Wide_Web_Consortium	201610	11	3	0	0	7	4	3	0	1039	598	160	634	331	28
33149	World_Wide_Web_Consortium	201612	5	2	0	0	5	2	2	0	1044	602	162	636	332	29
33149	World_Wide_Web_Consortium	201701	8	2	0	0	6	3	2	0	1052	608	164	639	335	30
33149	World_Wide_Web_Consortium	201702	13	5	0	0	10	5	4	0	1065	616	169	645	337	32
33149	World_Wide_Web_Consortium	201703	10	3	0	0	8	3	3	0	1075	623	172	648	339	32
33149	World_Wide_Web_Consortium	201704	10	5	0	0	9	6	4	0	1085	629	177	655	340	34
33149	World_Wide_Web_Consortium	201705	1	0	0	0	1	1	0	0	1086	630	177	656	341	34
33149	World_Wide_Web_Consortium	201707	2	1	0	0	2	2	1	0	1088	631	178	658	342	35
33149	World_Wide_Web_Consortium	201708	13	3	0	0	9	7	3	0	1101	638	181	667	347	36
33149	World_Wide_Web_Consortium	201709	10	3	0	0	8	4	2	0	1111	643	184	672	349	37
33149	World_Wide_Web_Consortium	201710	7	0	0	0	5	4	0	0	1118	647	184	676	352	37
33149	World_Wide_Web_Consortium	201712	3	1	0	0	3	2	1	0	1121	649	185	678	353	37
33149	World_Wide_Web_Consortium	201802	4	1	0	0	4	3	1	0	1125	652	186	681	355	37
33149	World_Wide_Web_Consortium	201803	12	1	0	0	6	4	1	0	1137	657	187	691	358	37
33149	World_Wide_Web_Consortium	201804	1	0	0	0	1	1	0	0	1138	657	187	692	358	37
33149	World_Wide_Web_Consortium	201805	4	2	0	0	4	2	2	0	1142	661	189	694	360	37
33149	World_Wide_Web_Consortium	201806	3	0	0	0	3	2	0	0	1145	664	189	696	362	37
33149	World_Wide_Web_Consortium	201807	8	3	0	0	6	3	3	0	1153	668	192	699	363	37
23800106	YANG	200908	2	0	0	0	2	2	0	0	2	2	0	2	2	0
23800106	YANG	200910	8	1	0	0	5	5	1	0	10	7	1	10	7	1
23800106	YANG	200911	1	0	0	0	1	1	0	0	11	8	1	11	8	1
23800106	YANG	201003	1	0	0	0	1	0	0	0	12	9	1	11	8	1
23800106	YANG	201004	1	0	0	0	1	1	0	0	13	9	1	12	8	1
23800106	YANG	201012	1	0	0	0	1	1	0	0	14	10	1	13	9	1
23800106	YANG	201101	1	0	0	0	1	1	0	0	15	11	1	14	10	1
23800106	YANG	201109	1	0	0	0	1	0	0	0	16	12	1	14	10	1
23800106	YANG	201110	1	0	0	0	1	1	0	0	17	13	1	15	11	1
23800106	YANG	201111	1	0	0	0	1	0	0	0	18	14	1	15	11	1
23800106	YANG	201204	2	0	0	0	2	0	0	0	20	16	1	15	11	1
23800106	YANG	201206	1	0	0	0	1	1	0	0	21	17	1	16	12	1
23800106	YANG	201208	1	0	0	0	1	1	0	0	22	18	1	17	13	1
23800106	YANG	201303	1	0	0	0	1	0	0	0	23	19	1	17	13	1
23800106	YANG	201305	1	0	0	0	1	1	0	0	24	19	1	18	13	1
23800106	YANG	201307	1	0	0	0	1	1	0	0	25	20	1	19	14	1
23800106	YANG	201310	2	0	0	0	1	0	0	0	27	21	1	19	14	1
23800106	YANG	201311	1	0	0	0	1	1	0	0	28	22	1	20	15	1
23800106	YANG	201405	2	0	0	0	2	2	0	0	30	24	1	22	17	1
23800106	YANG	201407	1	0	0	0	1	1	0	0	31	25	1	23	18	1
23800106	YANG	201408	3	0	0	0	1	1	0	0	34	26	1	26	19	1
23800106	YANG	201409	1	0	0	0	1	1	0	0	35	26	1	27	19	1
23800106	YANG	201412	1	0	0	0	1	1	0	0	36	27	1	28	20	1
23800106	YANG	201503	1	0	0	0	1	1	0	0	37	27	1	29	20	1
23800106	YANG	201505	3	1	0	0	3	1	1	0	40	30	2	30	21	1
23800106	YANG	201506	2	0	0	0	2	2	0	0	42	32	2	32	23	1
23800106	YANG	201509	2	0	0	0	1	1	0	0	44	32	2	34	23	1
23800106	YANG	201510	1	0	0	0	1	1	0	0	45	32	2	35	23	1
23800106	YANG	201511	1	0	0	0	1	0	0	0	46	33	2	35	23	1
23800106	YANG	201512	1	1	0	0	1	0	1	0	47	34	3	35	23	1
23800106	YANG	201603	2	0	0	0	2	2	0	0	49	36	3	37	25	1
23800106	YANG	201605	4	0	0	0	1	1	0	0	53	37	3	41	26	1
23800106	YANG	201606	1	0	0	0	1	1	0	0	54	37	3	42	26	1
23800106	YANG	201607	1	0	0	0	1	1	0	0	55	37	3	43	26	1
23800106	YANG	201608	13	0	0	0	4	4	0	0	68	40	3	56	29	1
23800106	YANG	201609	7	0	0	0	2	2	0	0	75	41	3	63	30	1
23800106	YANG	201610	5	0	0	0	3	3	0	0	80	42	3	68	31	1
23800106	YANG	201611	4	1	0	0	4	1	1	0	84	46	4	69	32	1
23800106	YANG	201612	2	0	0	0	2	2	0	0	86	47	4	71	33	1
23800106	YANG	201702	2	0	0	0	2	2	0	0	88	48	4	73	34	1
23800106	YANG	201703	1	0	0	0	1	1	0	0	89	48	4	74	34	1
23800106	YANG	201706	5	1	0	0	4	3	1	0	94	51	5	78	35	1
23800106	YANG	201707	1	0	0	0	1	1	0	0	95	51	5	79	35	1
23800106	YANG	201708	2	0	0	0	2	2	0	0	97	52	5	81	36	1
23800106	YANG	201709	1	0	0	0	1	1	0	0	98	52	5	82	36	1
23800106	YANG	201710	1	0	0	0	1	0	0	0	99	53	5	82	36	1
23800106	YANG	201712	2	0	0	0	2	2	0	0	101	54	5	84	37	1
23800106	YANG	201801	3	0	0	0	3	1	0	0	104	56	5	85	37	1
23800106	YANG	201802	3	0	0	0	3	3	0	0	107	58	5	88	38	1
23800106	YANG	201803	1	0	0	0	1	0	0	0	108	59	5	88	38	1
23800106	YANG	201806	8	0	0	0	1	1	0	0	116	59	5	96	38	1
23800106	YANG	201807	2	1	0	0	2	0	1	0	118	61	6	96	38	1
